Open Time,Open Price,High Price,Low Price,Close Price,Volume,Number of Trades,Taker Buy Base Volume,SMA 3,SMA 7,SMA 20,EMA 3,EMA 7,EMA 20,RSI 14,Bollinger Band Upper 20,Bollinger Band Lower 20,"MACD Line (12,26)",MACD Signal Line (9),MACD Histogram,Current True Range,ATR 14,On-Balance Volume,Momentum 10,Rate of Change 14,Williams %R 14,Stochastic %K,Stochastic %D,Percent Change,Last Day Open Price,Last Day High Price,Last Day Low Price,Last Day Close Price,Last Day Volume,Last Day Number of Trades,Last Day Taker Buy Base Volume,Last Day Percent Change,Last Day RSI 14,Last Day Bollinger Band Upper 20,Last Day Bollinger Band Lower 20,"Last Day MACD Line (12,26)",Last Day MACD Signal Line (9),Last Day MACD Histogram,Last Day True Range,Last Day ATR 14,Last Day On-Balance Volume,Last Day Momentum 10,Last Day Rate of Change 14,Last Day Williams %R 14,Last Day Stochastic %K,Last Day Stochastic %D,Last Day SMA 3,Last Day EMA 3,Last Day SMA 7,Last Day EMA 7,Last Day SMA 20,Last Day EMA 20,Last 3 Days Total Trades,Last 3 Days Avg Taker Buy Base Volume,Last 7 Days Total Trades,Last 7 Days Avg Taker Buy Base Volume
2019-02-28,0.33,0.489,0.301,0.3554,153340418.22,100546.0,70635427.88,,,,0.3554,0.3554,0.3554,,,,0.0,0.0,0.0,0.188,,-153340418.22,,,,,,7.696969696969689,,,,,,,,,,,,,,,,,,,,,,,,,,,,,,,,
2019-03-01,0.3554,0.4768,0.3502,0.4426,122476704.43,115815.0,61332783.24,,,,0.399,0.3772,0.36370476190476186,,,,0.006956125356125387,0.0013912250712250773,0.005564900284900309,0.1266,,-30863713.78999999,,,,,,24.53573438379291,0.33,0.489,0.301,0.3554,153340418.22,100546.0,70635427.88,7.696969696969689,,,,0.0,0.0,0.0,0.188,,-153340418.22,,,,,,,0.3554,,0.3554,,0.3554,,,,
2019-03-02,0.443,0.4431,0.3801,0.4026,50660886.62,52610.0,22505018.94,0.40020000000000006,,,0.40080000000000005,0.38355,0.36740907029478453,,,,0.009135925844757753,0.0029401652259316126,0.00619576061882614,0.063,,-81524600.41,,,,,,-9.119638826185101,0.3554,0.4768,0.3502,0.4426,122476704.43,115815.0,61332783.24,24.53573438379291,,,,0.006956125356125387,0.0013912250712250773,0.005564900284900309,0.1266,,-30863713.78999999,,,,,,,0.399,,0.3772,,0.36370476190476186,,,,
2019-03-03,0.402,0.429,0.3537,0.3639,41110679.59,45189.0,18442064.83,0.40303333333333335,,,0.38235,0.37863749999999996,0.3670748731238527,,,,0.00765245413819049,0.003882623008383388,0.0037698311298071017,0.07529999999999998,,-122635280.0,,,,,,-9.477611940298512,0.443,0.4431,0.3801,0.4026,50660886.62,52610.0,22505018.94,-9.119638826185101,,,,0.009135925844757753,0.0029401652259316126,0.00619576061882614,0.063,,-81524600.41,,,,,,0.40020000000000006,0.40080000000000005,,0.38355,,0.36740907029478453,268971.0,51491076.68666667,,
2019-03-04,0.3639,0.3782,0.3226,0.3309,66614590.51,48163.0,32961625.27,0.36579999999999996,,,0.356625,0.36670312499999996,0.3636296471120572,,,,0.003770503893578636,0.0038601991854224377,-8.969529184380161e-05,0.05559999999999998,,-189249870.51,,,,,,-9.06842539159109,0.402,0.429,0.3537,0.3639,41110679.59,45189.0,18442064.83,-9.477611940298512,,,,0.00765245413819049,0.003882623008383388,0.0037698311298071017,0.07529999999999998,,-122635280.0,,,,,,0.40303333333333335,0.38235,,0.37863749999999996,,0.3670748731238527,213614.0,34093289.00333334,,
2019-03-05,0.3309,0.3456,0.305,0.3137,61152467.51,58231.0,27160004.97,0.33616666666666667,,,0.33516250000000003,0.35345234375,0.35887444262519463,,,,-0.0006859585931524026,0.00295096762970747,-0.0036369262228598724,0.040600000000000025,,-250402338.01999998,,,,,,-5.197944998488984,0.3639,0.3782,0.3226,0.3309,66614590.51,48163.0,32961625.27,-9.06842539159109,,,,0.003770503893578636,0.0038601991854224377,-8.969529184380161e-05,0.05559999999999998,,-189249870.51,,,,,,0.36579999999999996,0.356625,,0.36670312499999996,,0.3636296471120572,145962.0,24636236.346666664,,
2019-03-06,0.3136,0.3299,0.3061,0.31,30721731.0,48360.0,14154713.55,0.3182,0.35987142857142856,,0.32258125000000004,0.34258925781250005,0.3542197338037475,,,,-0.004464828534686327,0.0014678083968287107,-0.005932636931515038,0.023800000000000043,,-281124069.02,,,,,,-1.1479591836734668,0.3309,0.3456,0.305,0.3137,61152467.51,58231.0,27160004.97,-5.197944998488984,,,,-0.0006859585931524026,0.00295096762970747,-0.0036369262228598724,0.040600000000000025,,-250402338.01999998,,,,,,0.33616666666666667,0.33516250000000003,,0.35345234375,,0.35887444262519463,151583.0,26187898.356666666,,
2019-03-07,0.31,0.366,0.3075,0.3478,73918772.24,68866.0,36064340.7,0.3238333333333333,0.35878571428571426,,0.335190625,0.343891943359375,0.35360833058434293,,,,-0.004359215770535552,0.0003024035633558583,-0.00466161933389141,0.058499999999999996,,-207205296.77999997,,,,,,12.193548387096774,0.3136,0.3299,0.3061,0.31,30721731.0,48360.0,14154713.55,-1.1479591836734668,,,,-0.004464828534686327,0.0014678083968287107,-0.005932636931515038,0.023800000000000043,,-281124069.02,,,,,,0.3182,0.32258125000000004,0.35987142857142856,0.34258925781250005,,0.3542197338037475,154754.0,24758781.263333336,468914.0,35313091.24
2019-03-08,0.3476,0.3504,0.28,0.2875,46682378.21,43305.0,18812707.95,0.3151,0.3366285714285714,,0.31134531249999997,0.3297939575195312,0.3473122991001198,,,,-0.009037049465055236,-0.0015654870423263607,-0.0074715624227288755,0.07039999999999996,,-253887674.98999998,,,,,,-17.289988492520152,0.31,0.366,0.3075,0.3478,73918772.24,68866.0,36064340.7,12.193548387096774,,,,-0.004359215770535552,0.0003024035633558583,-0.00466161933389141,0.058499999999999996,,-207205296.77999997,,,,,,0.3238333333333333,0.335190625,0.35878571428571426,0.343891943359375,,0.35360833058434293,175457.0,25793019.74,437234.0,30374364.5
2019-03-09,0.2873,0.2956,0.2675,0.2678,37817821.7,32068.0,16272362.67,0.3010333333333333,0.3173714285714286,,0.28957265624999995,0.3142954681396484,0.3397396991858227,,,,-0.014170542536658337,-0.004086498141192756,-0.01008404439546558,0.02809999999999996,,-291705496.69,,,,,,-6.7873303167420875,0.3476,0.3504,0.28,0.2875,46682378.21,43305.0,18812707.95,-17.289988492520152,,,,-0.009037049465055236,-0.0015654870423263607,-0.0074715624227288755,0.07039999999999996,,-253887674.98999998,,,,,,0.3151,0.31134531249999997,0.3366285714285714,0.3297939575195312,,0.3473122991001198,160531.0,23010587.400000002,364724.0,24300068.029999997
2019-03-10,0.2678,0.2679,0.238,0.255,42782586.81,35875.0,19855065.35,0.2701,0.3018142857142857,,0.272286328125,0.29947160110473636,0.33166925164431577,,,,-0.0190521049997473,-0.007079619512903665,-0.011972485486843633,0.029900000000000038,,-334488083.5,-0.10039999999999999,,,,,-4.779686333084383,0.2873,0.2956,0.2675,0.2678,37817821.7,32068.0,16272362.67,-6.7873303167420875,,,,-0.014170542536658337,-0.004086498141192756,-0.01008404439546558,0.02809999999999996,,-291705496.69,,,,,,0.3010333333333333,0.28957265624999995,0.3173714285714286,0.3142954681396484,,0.3397396991858227,144239.0,23716470.44,344182.0,23409688.562857144
2019-03-11,0.2548,0.2768,0.2138,0.2173,42628057.43,34997.0,19655916.03,0.2467,0.2855857142857143,,0.24479316406249998,0.27892870082855226,0.32077694196390477,,,,-0.025666980376814197,-0.010797091685685772,-0.014869888691128425,0.063,,-377116140.93,-0.2253,,,,,-14.717425431711156,0.2678,0.2679,0.238,0.255,42782586.81,35875.0,19855065.35,-4.779686333084383,,,,-0.0190521049997473,-0.007079619512903665,-0.011972485486843633,0.029900000000000038,,-334488083.5,-0.10039999999999999,,,,,0.2701,0.272286328125,0.3018142857142857,0.29947160110473636,,0.33166925164431577,111248.0,18313378.65666667,334868.0,23611545.78
2019-03-12,0.2173,0.2414,0.2087,0.2202,34036963.2,23287.0,14978463.52,0.23083333333333333,0.27222857142857143,,0.23249658203125,0.2642465256214142,0.31119818558639006,,,,-0.03032573481324191,-0.014702820311197,-0.01562291450204491,0.03270000000000001,,-343079177.73,-0.1824,,,,,1.3345605154164812,0.2548,0.2768,0.2138,0.2173,42628057.43,34997.0,19655916.03,-14.717425431711156,,,,-0.025666980376814197,-0.010797091685685772,-0.014869888691128425,0.063,,-377116140.93,-0.2253,,,,,0.2467,0.24479316406249998,0.2855857142857143,0.27892870082855226,,0.32077694196390477,102940.0,18594448.01666667,321702.0,21710730.174285714
2019-03-13,0.2206,0.2583,0.2206,0.2456,49772747.64,37274.0,23399922.86,0.2277,0.26302857142857144,,0.23904829101562503,0.2595848942160607,0.3049507393400672,36.81556195965418,,,-0.031603952849608485,-0.0180830468188793,-0.013520906030729186,0.037699999999999984,0.0638,-293306430.09000003,-0.11829999999999999,,-86.83553335711737,13.164466642882633,,11.332728921124218,0.2173,0.2414,0.2087,0.2202,34036963.2,23287.0,14978463.52,1.3345605154164812,,,,-0.03032573481324191,-0.014702820311197,-0.01562291450204491,0.03270000000000001,,-343079177.73,-0.1824,,,,,0.23083333333333333,0.23249658203125,0.27222857142857143,0.2642465256214142,,0.31119818558639006,94159.0,18163148.3,286758.0,19970509.967142858
2019-03-14,0.2454,0.268,0.224,0.2293,57242839.99,39249.0,30074912.81,0.23170000000000002,0.24609999999999999,,0.23417414550781251,0.2520136706620455,0.2977459070219656,35.428703489715744,,,-0.0335455316205554,-0.02117554377921452,-0.012369987841340881,0.04400000000000001,0.05351428571428572,-350549270.08000004,-0.10160000000000002,-35.48114800225098,-92.31629988810145,7.683700111898547,,-6.560717196414019,0.2206,0.2583,0.2206,0.2456,49772747.64,37274.0,23399922.86,11.332728921124218,36.81556195965418,,,-0.031603952849608485,-0.0180830468188793,-0.013520906030729186,0.037699999999999984,0.0638,-293306430.09000003,-0.11829999999999999,,-86.83553335711737,13.164466642882633,,0.2277,0.23904829101562503,0.26302857142857144,0.2595848942160607,,0.3049507393400672,95558.0,19344767.470000003,275672.0,21291254.154285718
2019-03-15,0.2295,0.2415,0.2295,0.2323,19695949.18,21217.0,9450081.03,0.23573333333333335,0.23821428571428574,,0.23323707275390626,0.2470852529965341,0.2915129634960641,19.827833572453372,,,-0.034445110069353635,-0.023829457037242346,-0.010615653032111289,0.011999999999999983,0.045328571428571426,-330853320.90000004,-0.08139999999999997,-47.51468594667871,-89.93174061433447,10.068259385665533,10.305475380148904,1.220043572984748,0.2454,0.268,0.224,0.2293,57242839.99,39249.0,30074912.81,-6.560717196414019,35.428703489715744,,,-0.0335455316205554,-0.02117554377921452,-0.012369987841340881,0.04400000000000001,0.05351428571428572,-350549270.08000004,-0.10160000000000002,-35.48114800225098,-92.31629988810145,7.683700111898547,,0.23170000000000002,0.23417414550781251,0.24609999999999999,0.2520136706620455,,0.2977459070219656,99810.0,22817766.396666665,246055.0,20435621.598571427
2019-03-16,0.2329,0.236,0.2211,0.2283,16714026.23,18138.0,7235651.23,0.22996666666666665,0.2325714285714286,,0.23076853637695313,0.24238893974740056,0.2854926812583437,22.111999999999995,,,-0.03507645945152488,-0.026078857520098853,-0.008997601931426024,0.014899999999999997,0.041892857142857134,-347567347.13000005,-0.0817,-43.2935916542474,-91.1030413073082,8.896958692691786,8.882972730085289,-1.9750966079862573,0.2295,0.2415,0.2295,0.2323,19695949.18,21217.0,9450081.03,1.220043572984748,19.827833572453372,,,-0.034445110069353635,-0.023829457037242346,-0.010615653032111289,0.011999999999999983,0.045328571428571426,-330853320.90000004,-0.08139999999999997,-47.51468594667871,-89.93174061433447,10.068259385665533,10.305475380148904,0.23573333333333335,0.23323707275390626,0.23821428571428574,0.2470852529965341,,0.2915129634960641,97740.0,20974972.233333338,223967.0,19098103.467142858
2019-03-17,0.2283,0.2399,0.227,0.2361,16432052.55,18819.0,8636534.18,0.23223333333333337,0.22987142857142856,,0.23343426818847657,0.2408167048105504,0.2807886163765967,27.30823863636364,,,-0.034549152449504905,-0.027772916505980065,-0.00677623594352484,0.012899999999999995,0.03743571428571429,-331135294.58000004,-0.1117,-35.119538334707336,-83.834808259587,16.165191740412986,11.710136606256768,3.4165571616294352,0.2329,0.236,0.2211,0.2283,16714026.23,18138.0,7235651.23,-1.9750966079862573,22.111999999999995,,,-0.03507645945152488,-0.026078857520098853,-0.008997601931426024,0.014899999999999997,0.041892857142857134,-347567347.13000005,-0.0817,-43.2935916542474,-91.1030413073082,8.896958692691786,8.882972730085289,0.22996666666666665,0.23076853637695313,0.2325714285714286,0.24238893974740056,,0.2854926812583437,78604.0,15586881.69,210037.0,17807144.69
2019-03-18,0.236,0.2392,0.2253,0.2278,28554545.69,16502.0,14003672.69,0.23073333333333332,0.23137142857142856,,0.23061713409423829,0.2375625286079128,0.2757420814835875,29.933826391592063,,,-0.03440440591003624,-0.029099214386791302,-0.005305191523244938,0.013899999999999996,0.03445714285714286,-359689840.27000004,-0.059699999999999975,-31.157449380477487,-87.85759694850603,12.142403051493964,12.401517828199578,-3.4745762711864345,0.2283,0.2399,0.227,0.2361,16432052.55,18819.0,8636534.18,3.4165571616294352,27.30823863636364,,,-0.034549152449504905,-0.027772916505980065,-0.00677623594352484,0.012899999999999995,0.03743571428571429,-331135294.58000004,-0.1117,-35.119538334707336,-83.834808259587,16.165191740412986,11.710136606256768,0.23223333333333337,0.23343426818847657,0.22987142857142856,0.2408167048105504,,0.2807886163765967,58174.0,8440755.480000002,192981.0,16204497.379999999
2019-03-19,0.2278,0.2335,0.2107,0.2174,51788431.46,24606.0,25799281.04,0.2271,0.23097142857142858,0.28657499999999997,0.22400856704711913,0.2325218964559346,0.27018569277086485,30.747700919632152,0.4228123142331927,0.15033768576680723,-0.03472855712942641,-0.030225082935318327,-0.004503474194108081,0.022800000000000015,0.033185714285714284,-411478271.73,-0.05039999999999997,-30.698119222186794,-94.46916719643991,5.530832803560084,11.27947586515568,-4.565408252853377,0.236,0.2392,0.2253,0.2278,28554545.69,16502.0,14003672.69,-3.4745762711864345,29.933826391592063,,,-0.03440440591003624,-0.029099214386791302,-0.005305191523244938,0.013899999999999996,0.03445714285714286,-359689840.27000004,-0.059699999999999975,-31.157449380477487,-87.85759694850603,12.142403051493964,12.401517828199578,0.23073333333333332,0.23061713409423829,0.23137142857142856,0.2375625286079128,,0.2757420814835875,53459.0,9958619.366666669,174486.0,15397034.045714285
2019-03-20,0.2175,0.2233,0.2127,0.2199,36760892.86,15994.0,19053311.03,0.2217,0.2273,0.2798,0.22195428352355956,0.22936642234195095,0.2653965791736396,31.900361591000404,0.41509969852535755,0.1445003014746424,-0.03438732452775861,-0.031057531253806385,-0.0033297932739522265,0.010599999999999998,0.032242857142857136,-374717378.87,-0.03509999999999999,-29.06451612903226,-92.87984742530196,7.120152574698039,8.264462809917363,1.1034482758620752,0.2278,0.2335,0.2107,0.2174,51788431.46,24606.0,25799281.04,-4.565408252853377,30.747700919632152,0.4228123142331927,0.15033768576680723,-0.03472855712942641,-0.030225082935318327,-0.004503474194108081,0.022800000000000015,0.033185714285714284,-411478271.73,-0.05039999999999997,-30.698119222186794,-94.46916719643991,5.530832803560084,11.27947586515568,0.2271,0.22400856704711913,0.23097142857142858,0.2325218964559346,0.28657499999999997,0.27018569277086485,59927.0,16146495.970000004,175805.0,16942865.12
2019-03-21,0.22,0.2265,0.195,0.2022,64150250.0,19424.0,32075487.75,0.21316666666666664,0.22342857142857145,0.26778,0.21207714176177977,0.22257481675646323,0.2593778573475787,18.181818181818187,0.3834763830576894,0.15208361694231062,-0.035140064517588554,-0.03187403790656282,-0.003266026611025735,0.0315,0.03031428571428571,-438867628.87,-0.015100000000000002,-41.86313973548016,-95.36679536679537,4.633204633204623,5.761396670487582,-8.090909090909095,0.2175,0.2233,0.2127,0.2199,36760892.86,15994.0,19053311.03,1.1034482758620752,31.900361591000404,0.41509969852535755,0.1445003014746424,-0.03438732452775861,-0.031057531253806385,-0.0033297932739522265,0.010599999999999998,0.032242857142857136,-374717378.87,-0.03509999999999999,-29.06451612903226,-92.87984742530196,7.120152574698039,8.264462809917363,0.2217,0.22195428352355956,0.2273,0.22936642234195095,0.2798,0.2653965791736396,57102.0,19618754.92,154525.0,16321920.572857143
2019-03-22,0.2021,0.2086,0.1996,0.2054,40212713.11,15310.0,20886337.93,0.20916666666666664,0.21958571428571427,0.25792000000000004,0.20873857088088987,0.21828111256734745,0.2542371090287617,26.092020966802565,0.3577643968330091,0.15807560316699099,-0.035074090839904426,-0.03251404849323114,-0.002560042346673286,0.009000000000000008,0.02592857142857143,-398654915.76,-0.014800000000000008,-28.556521739130424,-89.66202783300199,10.337972166998007,7.363776458300223,1.6328550222662035,0.22,0.2265,0.195,0.2022,64150250.0,19424.0,32075487.75,-8.090909090909095,18.181818181818187,0.3834763830576894,0.15208361694231062,-0.035140064517588554,-0.03187403790656282,-0.003266026611025735,0.0315,0.03031428571428571,-438867628.87,-0.015100000000000002,-41.86313973548016,-95.36679536679537,4.633204633204623,5.761396670487582,0.21316666666666664,0.21207714176177977,0.22342857142857145,0.22257481675646323,0.26778,0.2593778573475787,60024.0,25642693.273333337,134700.0,16607716.992857143
2019-03-23,0.2054,0.2084,0.1959,0.2022,38747348.04,17264.0,19942156.49,0.20326666666666668,0.21585714285714283,0.24983500000000003,0.20546928544044493,0.21426083442551058,0.24928119388316533,28.86597938144331,0.33918105166076695,0.16048894833923308,-0.034877967977446495,-0.03298683239007422,-0.001891135587372278,0.012500000000000011,0.024814285714285716,-437402263.8,-0.04340000000000002,-24.4958924570575,-91.19804400977996,8.801955990220032,7.924377596807555,-1.557935735150929,0.2021,0.2086,0.1996,0.2054,40212713.11,15310.0,20886337.93,1.6328550222662035,26.092020966802565,0.3577643968330091,0.15807560316699099,-0.035074090839904426,-0.03251404849323114,-0.002560042346673286,0.009000000000000008,0.02592857142857143,-398654915.76,-0.014800000000000008,-28.556521739130424,-89.66202783300199,10.337972166998007,7.363776458300223,0.20916666666666664,0.20873857088088987,0.21958571428571427,0.21828111256734745,0.25792000000000004,0.2542371090287617,50728.0,24005045.570000004,128793.0,18241467.978571426
2019-03-24,0.2022,0.2187,0.2014,0.2084,48190652.49,24512.0,24505447.02,0.20533333333333334,0.2119,0.24370999999999995,0.20693464272022247,0.21279562581913294,0.24538774684667342,34.320323014804856,0.3261886007334471,0.16123139926655283,-0.033832253848997185,-0.03315591668185881,-0.0006763371671383717,0.01730000000000001,0.023914285714285714,-389211611.31,-0.020900000000000002,-18.274509803921568,-83.61858190709047,16.381418092909534,11.840448750042526,3.06627101879328,0.2054,0.2084,0.1959,0.2022,38747348.04,17264.0,19942156.49,-1.557935735150929,28.86597938144331,0.33918105166076695,0.16048894833923308,-0.034877967977446495,-0.03298683239007422,-0.001891135587372278,0.012500000000000011,0.024814285714285716,-437402263.8,-0.04340000000000002,-24.4958924570575,-91.19804400977996,8.801955990220032,7.924377596807555,0.20326666666666668,0.20546928544044493,0.21585714285714283,0.21426083442551058,0.24983500000000003,0.24928119388316533,51998.0,24301327.390000004,127919.0,20056683.015714284
2019-03-25,0.2087,0.2138,0.1906,0.1977,49421470.3,28685.0,24515432.64,0.20276666666666665,0.2076,0.23790999999999998,0.2023173213601112,0.2090217193643497,0.24084605667079975,41.94078947368422,0.31585524123754416,0.1599647587624558,-0.03348097065606395,-0.033220927476699844,-0.00026004317936410837,0.0232,0.021071428571428574,-438633081.61,-0.03460000000000002,-9.01978831109066,-90.82687338501293,9.173126614987071,11.452166899372214,-5.270723526593201,0.2022,0.2187,0.2014,0.2084,48190652.49,24512.0,24505447.02,3.06627101879328,34.320323014804856,0.3261886007334471,0.16123139926655283,-0.033832253848997185,-0.03315591668185881,-0.0006763371671383717,0.01730000000000001,0.023914285714285714,-389211611.31,-0.020900000000000002,-18.274509803921568,-83.61858190709047,16.381418092909534,11.840448750042526,0.20533333333333334,0.20693464272022247,0.2119,0.21279562581913294,0.24370999999999995,0.24538774684667342,57086.0,21777980.480000004,133612.0,22323670.564285714
2019-03-26,0.1976,0.201,0.1777,0.1819,46719166.24,26464.0,23673750.49,0.19600000000000004,0.20252857142857142,0.23150500000000002,0.1921086606800556,0.20224128952326226,0.23523214651167595,35.76208178438662,0.30545819928313134,0.1575518007168687,-0.034084598118511555,-0.033393661605062186,-0.0006909365134493695,0.023300000000000015,0.0204,-485352247.85,-0.0464,-17.393278837420524,-95.34883720930232,4.651162790697684,10.068569166198097,-7.945344129554652,0.2087,0.2138,0.1906,0.1977,49421470.3,28685.0,24515432.64,-5.270723526593201,41.94078947368422,0.31585524123754416,0.1599647587624558,-0.03348097065606395,-0.033220927476699844,-0.00026004317936410837,0.0232,0.021071428571428574,-438633081.61,-0.03460000000000002,-9.01978831109066,-90.82687338501293,9.173126614987071,11.452166899372214,0.20276666666666665,0.2023173213601112,0.2076,0.2090217193643497,0.23790999999999998,0.24084605667079975,70461.0,22987678.71666667,145795.0,23825350.557142857
2019-03-27,0.1818,0.1984,0.18,0.1942,62095512.42,23118.0,33950589.94,0.19126666666666667,0.19885714285714284,0.223825,0.19315433034002782,0.2002309671424467,0.23132432303437347,28.830313014827027,0.27546259850097,0.17218740149903,-0.03318790056779661,-0.03335250939760907,0.00016460882981246538,0.0184,0.019021428571428575,-423256735.43,-0.04189999999999999,-20.92833876221498,-81.72757475083056,18.272425249169448,10.698904884951403,6.820682068206834,0.1976,0.201,0.1777,0.1819,46719166.24,26464.0,23673750.49,-7.945344129554652,35.76208178438662,0.30545819928313134,0.1575518007168687,-0.034084598118511555,-0.033393661605062186,-0.0006909365134493695,0.023300000000000015,0.0204,-485352247.85,-0.0464,-17.393278837420524,-95.34883720930232,4.651162790697684,10.068569166198097,0.19600000000000004,0.1921086606800556,0.20252857142857142,0.20224128952326226,0.23150500000000002,0.23523214651167595,79661.0,24231543.383333337,147653.0,23521703.335714288
2019-03-28,0.1942,0.2239,0.1881,0.2199,76218206.93,28271.0,41475161.5,0.19866666666666669,0.20138571428571428,0.220445,0.2065271651700139,0.20514822535683502,0.23023629226919506,46.406727828746185,0.2624926158658254,0.1783973841341746,-0.03005700760848659,-0.03269340903978458,0.002636401431297987,0.0358,0.018435714285714284,-347038528.5,-0.00789999999999999,-4.099433057130398,-33.855799373040725,66.14420062695928,29.68926288894214,13.233779608650876,0.1818,0.1984,0.18,0.1942,62095512.42,23118.0,33950589.94,6.820682068206834,28.830313014827027,0.27546259850097,0.17218740149903,-0.03318790056779661,-0.03335250939760907,0.00016460882981246538,0.0184,0.019021428571428575,-423256735.43,-0.04189999999999999,-20.92833876221498,-81.72757475083056,18.272425249169448,10.698904884951403,0.19126666666666667,0.19315433034002782,0.19885714285714284,0.2002309671424467,0.223825,0.23132432303437347,78267.0,27379924.35666667,154777.0,25649886.037142854
2019-03-29,0.2199,0.2201,0.2034,0.2067,63644370.74,19307.0,32131059.68,0.20693333333333333,0.20157142857142857,0.21738999999999997,0.20661358258500695,0.20553616901762625,0.2279947406245098,40.92198581560284,0.2533951984550771,0.1813848015449229,-0.028314490245967522,-0.03181762528102117,0.003503135035053645,0.016699999999999993,0.018771428571428574,-410682899.24,-0.010700000000000015,-11.020232458028412,-53.37620578778136,46.62379421221864,43.68014002944913,-6.002728512960444,0.1942,0.2239,0.1881,0.2199,76218206.93,28271.0,41475161.5,13.233779608650876,46.406727828746185,0.2624926158658254,0.1783973841341746,-0.03005700760848659,-0.03269340903978458,0.002636401431297987,0.0358,0.018435714285714284,-347038528.5,-0.00789999999999999,-4.099433057130398,-33.855799373040725,66.14420062695928,29.68926288894214,0.19866666666666669,0.2065271651700139,0.20138571428571428,0.20514822535683502,0.220445,0.23023629226919506,77853.0,33033167.310000002,163624.0,26992696.57285714
2019-03-30,0.2067,0.2072,0.196,0.2052,53398632.02,14098.0,27839952.98,0.21059999999999998,0.202,0.2149,0.20590679129250347,0.20545212676321967,0.22582381294598505,41.66064981949459,0.24658217164273957,0.18321782835726044,-0.02674625595629057,-0.03080335141607505,0.004057095459784478,0.011199999999999988,0.018507142857142857,-464081531.26,-0.014700000000000019,-10.11826544021025,-55.78778135048233,44.21221864951767,52.3267378295652,-0.7256894049346886,0.2199,0.2201,0.2034,0.2067,63644370.74,19307.0,32131059.68,-6.002728512960444,40.92198581560284,0.2533951984550771,0.1813848015449229,-0.028314490245967522,-0.03181762528102117,0.003503135035053645,0.016699999999999993,0.018771428571428574,-410682899.24,-0.010700000000000015,-11.020232458028412,-53.37620578778136,46.62379421221864,43.68014002944913,0.20693333333333333,0.20661358258500695,0.20157142857142857,0.20553616901762625,0.21738999999999997,0.2279947406245098,70696.0,35852270.373333335,167621.0,28599085.394285712
2019-03-31,0.2051,0.2054,0.1922,0.1973,41682675.44,12309.0,20914477.89,0.20306666666666665,0.2004142857142857,0.21390000000000003,0.20160339564625174,0.20341409507241476,0.22310725933208173,36.00288600288601,0.24651210624421893,0.18128789375578114,-0.025842981160033224,-0.029811277364866686,0.003968296204833462,0.01319999999999999,0.01852857142857143,-505764206.7,-0.004899999999999988,-16.43371452774248,-68.13008130081299,31.869918699187,40.90197718697444,-3.8030229156509026,0.2067,0.2072,0.196,0.2052,53398632.02,14098.0,27839952.98,-0.7256894049346886,41.66064981949459,0.24658217164273957,0.18321782835726044,-0.02674625595629057,-0.03080335141607505,0.004057095459784478,0.011199999999999988,0.018507142857142857,-464081531.26,-0.014700000000000019,-10.11826544021025,-55.78778135048233,44.21221864951767,52.3267378295652,0.21059999999999998,0.20590679129250347,0.202,0.20545212676321967,0.2149,0.22582381294598505,61676.0,33815391.38666667,164455.0,29727342.035714287
2019-04-01,0.1971,0.203,0.194,0.2015,62557950.4,14559.0,33538772.89,0.20133333333333334,0.20095714285714286,0.212965,0.20155169782312587,0.20293557130431106,0.22104942510997871,40.223048327137555,0.24588738240404096,0.18004261759595902,-0.0245057375884922,-0.02875016940959179,0.004244431821099591,0.009000000000000008,0.018178571428571433,-443206256.3,-0.003899999999999987,-11.545215100965756,-57.347670250896044,42.652329749103956,39.578155699269544,2.2323693556570343,0.2051,0.2054,0.1922,0.1973,41682675.44,12309.0,20914477.89,-3.8030229156509026,36.00288600288601,0.24651210624421893,0.18128789375578114,-0.025842981160033224,-0.029811277364866686,0.003968296204833462,0.01319999999999999,0.01852857142857143,-505764206.7,-0.004899999999999988,-16.43371452774248,-68.13008130081299,31.869918699187,40.90197718697444,0.20306666666666665,0.20160339564625174,0.2004142857142857,0.20341409507241476,0.21390000000000003,0.22310725933208173,45714.0,26961830.183333337,152252.0,29214346.445714287
2019-04-02,0.2014,0.2093,0.1953,0.2049,78206197.24,30874.0,38812383.41,0.20123333333333335,0.20424285714285714,0.21093,0.20322584891156292,0.20342667847823329,0.21951138462331407,45.09803921568626,0.2401861176688337,0.18167388233116633,-0.02290754689752994,-0.027581644907179424,0.004674098009649484,0.014000000000000012,0.017550000000000003,-365000059.06,0.002700000000000008,-5.74977000919964,-44.26229508196722,55.73770491803278,43.419984455441245,1.7378351539225438,0.1971,0.203,0.194,0.2015,62557950.4,14559.0,33538772.89,2.2323693556570343,40.223048327137555,0.24588738240404096,0.18004261759595902,-0.0245057375884922,-0.02875016940959179,0.004244431821099591,0.009000000000000008,0.018178571428571433,-443206256.3,-0.003899999999999987,-11.545215100965756,-57.347670250896044,42.652329749103956,39.578155699269544,0.20133333333333334,0.20155169782312587,0.20095714285714286,0.20293557130431106,0.212965,0.22104942510997871,40966.0,27431067.920000006,138126.0,30503395.052857142
2019-04-03,0.2045,0.2231,0.188,0.1924,73783946.79,27782.0,36169049.48,0.1996,0.2039857142857143,0.20908500000000002,0.19781292445578147,0.20067000885867498,0.21692934799252225,39.99999999999999,0.2381165454562612,0.18005345454373883,-0.022391499525436676,-0.026543615830830876,0.0041521163053942,0.03509999999999999,0.0193,-438784005.85,-0.016000000000000014,-12.505684402000917,-69.8770491803279,30.122950819672106,42.837661828936284,-5.916870415647922,0.2014,0.2093,0.1953,0.2049,78206197.24,30874.0,38812383.41,1.7378351539225438,45.09803921568626,0.2401861176688337,0.18167388233116633,-0.02290754689752994,-0.027581644907179424,0.004674098009649484,0.014000000000000012,0.017550000000000003,-365000059.06,0.002700000000000008,-5.74977000919964,-44.26229508196722,55.73770491803278,43.419984455441245,0.20123333333333335,0.20322584891156292,0.20424285714285714,0.20342667847823329,0.21093,0.21951138462331407,57742.0,31088544.730000004,142536.0,32666056.898571424
2019-04-04,0.1927,0.2009,0.1888,0.1953,56478444.37,16622.0,30799233.71,0.19753333333333334,0.2004714285714286,0.207235,0.19655646222789075,0.19932750664400622,0.21486941008847252,47.18826405867971,0.2347116331347395,0.1797583668652605,-0.021500676091170567,-0.02553502788289882,0.004034351791728251,0.0121,0.017914285714285716,-382305561.48,-0.0023999999999999855,-3.4124629080118596,-61.904761904761884,38.09523809523811,41.31863127764766,1.3492475350285371,0.2045,0.2231,0.188,0.1924,73783946.79,27782.0,36169049.48,-5.916870415647922,39.99999999999999,0.2381165454562612,0.18005345454373883,-0.022391499525436676,-0.026543615830830876,0.0041521163053942,0.03509999999999999,0.0193,-438784005.85,-0.016000000000000014,-12.505684402000917,-69.8770491803279,30.122950819672106,42.837661828936284,0.1996,0.19781292445578147,0.2039857142857143,0.20067000885867498,0.20908500000000002,0.21692934799252225,73215.0,36173401.92666667,147200.0,32982979.689999998
2019-04-05,0.1952,0.2025,0.1935,0.1973,43657482.78,12254.0,23821070.53,0.19499999999999998,0.1991285714285714,0.20568500000000003,0.19692823111394536,0.19882062998300468,0.21319613293718942,46.666666666666664,0.23161204541999608,0.179757954580004,-0.02039817139376926,-0.02450765658507291,0.0041094851913036495,0.009000000000000008,0.017914285714285716,-338648078.70000005,0.015399999999999997,-3.943524829600775,-57.57575757575756,42.42424242424245,36.880810446384224,1.0758196721311426,0.1927,0.2009,0.1888,0.1953,56478444.37,16622.0,30799233.71,1.3492475350285371,47.18826405867971,0.2347116331347395,0.1797583668652605,-0.021500676091170567,-0.02553502788289882,0.004034351791728251,0.0121,0.017914285714285716,-382305561.48,-0.0023999999999999855,-3.4124629080118596,-61.904761904761884,38.09523809523811,41.31863127764766,0.19753333333333334,0.19655646222789075,0.2004714285714286,0.19932750664400622,0.207235,0.21486941008847252,75278.0,35260222.2,135551.0,31457847.148571424
2019-04-06,0.1973,0.2099,0.1958,0.1997,46296680.86,15489.0,24132017.68,0.19743333333333332,0.19834285714285713,0.20386500000000002,0.19831411555697268,0.1990404724872535,0.2119107869431714,48.96437448218724,0.22556877362289096,0.18216122637710908,-0.019110474877072847,-0.023428220243472898,0.0043177453664000505,0.014100000000000001,0.01802857142857143,-292351397.84000003,0.005499999999999977,-1.236399604352123,-52.380952380952394,47.61904761904761,42.71284271284272,1.2164216928535152,0.1952,0.2025,0.1935,0.1973,43657482.78,12254.0,23821070.53,1.0758196721311426,46.666666666666664,0.23161204541999608,0.179757954580004,-0.02039817139376926,-0.02450765658507291,0.0041094851913036495,0.009000000000000008,0.017914285714285716,-338648078.70000005,0.015399999999999997,-3.943524829600775,-57.57575757575756,42.42424242424245,36.880810446384224,0.19499999999999998,0.19692823111394536,0.1991285714285714,0.19882062998300468,0.20568500000000003,0.21319613293718942,56658.0,30263117.90666667,128498.0,30270705.84142857
2019-04-07,0.2001,0.21,0.1982,0.2027,51759586.89,9697.0,28162820.26,0.1999,0.19911428571428572,0.20261,0.20050705777848632,0.19995535436544012,0.21103356913905982,47.57446808510638,0.22115994963817853,0.1840600503618215,-0.01764449641097654,-0.022271475476973626,0.004626979065997086,0.011800000000000005,0.017635714285714286,-240591810.95000005,-0.01720000000000002,-2.735124760076779,-45.887445887445885,54.112554112554115,48.05194805194807,1.2993503248375768,0.1973,0.2099,0.1958,0.1997,46296680.86,15489.0,24132017.68,1.2164216928535152,48.96437448218724,0.22556877362289096,0.18216122637710908,-0.019110474877072847,-0.023428220243472898,0.0043177453664000505,0.014100000000000001,0.01802857142857143,-292351397.84000003,0.005499999999999977,-1.236399604352123,-52.380952380952394,47.61904761904761,42.71284271284272,0.19743333333333332,0.19831411555697268,0.19834285714285713,0.1990404724872535,0.20386500000000002,0.2119107869431714,44365.0,26250773.97333334,129889.0,29741000.798571426
2019-04-08,0.2024,0.2186,0.1975,0.2115,61498802.64,13520.0,33920265.77,0.2046333333333333,0.20054285714285713,0.20231499999999997,0.20600352888924317,0.2028415157740801,0.21107799112581602,55.96885813148789,0.22004410482496925,0.18458589517503068,-0.015592866599522442,-0.02093575370148339,0.005342887101960948,0.02109999999999998,0.017485714285714285,-179093008.31000006,0.004799999999999999,6.980273141122928,-26.83982683982683,73.16017316017317,58.2972582972583,4.496047430830038,0.2001,0.21,0.1982,0.2027,51759586.89,9697.0,28162820.26,1.2993503248375768,47.57446808510638,0.22115994963817853,0.1840600503618215,-0.01764449641097654,-0.022271475476973626,0.004626979065997086,0.011800000000000005,0.017635714285714286,-240591810.95000005,-0.01720000000000002,-2.735124760076779,-45.887445887445885,54.112554112554115,48.05194805194807,0.1999,0.20050705777848632,0.19911428571428572,0.19995535436544012,0.20261,0.21103356913905982,37440.0,25371969.490000006,127277.0,30776478.28
2019-04-09,0.2116,0.2127,0.1988,0.205,37173577.96,10196.0,18695160.02,0.2064,0.20055714285714285,0.20156999999999997,0.2055017644446216,0.20338113683056006,0.21049913482811924,60.86547507055502,0.21733072400153758,0.18580927599846236,-0.014326286358645024,-0.01961386023291572,0.005287573874270694,0.013899999999999996,0.016814285714285712,-216266586.27000007,-0.00020000000000000573,12.69928532160527,-43.052391799544424,56.947608200455576,61.406778491060955,-3.119092627599254,0.2024,0.2186,0.1975,0.2115,61498802.64,13520.0,33920265.77,4.496047430830038,55.96885813148789,0.22004410482496925,0.18458589517503068,-0.015592866599522442,-0.02093575370148339,0.005342887101960948,0.02109999999999998,0.017485714285714285,-179093008.31000006,0.004799999999999999,6.980273141122928,-26.83982683982683,73.16017316017317,58.2972582972583,0.2046333333333333,0.20600352888924317,0.20054285714285713,0.2028415157740801,0.20231499999999997,0.21107799112581602,38706.0,28738367.90333334,126238.0,30830977.26285714
2019-04-10,0.2049,0.2082,0.2001,0.2018,38389629.56,7329.0,19621076.07,0.20609999999999998,0.2019,0.20154999999999998,0.20365088222231081,0.20298585262292004,0.20967064579686978,53.90946502057612,0.21730837287886937,0.1857916271211306,-0.013425959544753702,-0.018376280095283318,0.004950320550529616,0.008099999999999996,0.016078571428571425,-254656215.83000007,0.004500000000000004,3.913491246138001,-61.559888579387156,38.440111420612844,56.18263092708054,-1.5129331381161502,0.2116,0.2127,0.1988,0.205,37173577.96,10196.0,18695160.02,-3.119092627599254,60.86547507055502,0.21733072400153758,0.18580927599846236,-0.014326286358645024,-0.01961386023291572,0.005287573874270694,0.013899999999999996,0.016814285714285712,-216266586.27000007,-0.00020000000000000573,12.69928532160527,-43.052391799544424,56.947608200455576,61.406778491060955,0.2064,0.2055017644446216,0.20055714285714285,0.20338113683056006,0.20156999999999997,0.21049913482811924,33413.0,26926082.016666677,105560.0,27957088.20714286
2019-04-11,0.2018,0.2033,0.1699,0.181,40867456.61,11713.0,19824392.09,0.19593333333333332,0.19985714285714282,0.20032999999999998,0.1923254411111554,0.19748938946719002,0.2069401081019298,28.92741061755146,0.21843648037524022,0.18222351962475974,-0.014226832160140757,-0.01754639050825481,0.0033195583481140517,0.03340000000000001,0.015907142857142856,-295523672.44000006,-0.020500000000000018,-17.68985902683039,-79.13533834586465,20.864661654135336,38.75079375840126,-10.307234886025775,0.2049,0.2082,0.2001,0.2018,38389629.56,7329.0,19621076.07,-1.5129331381161502,53.90946502057612,0.21730837287886937,0.1857916271211306,-0.013425959544753702,-0.018376280095283318,0.004950320550529616,0.008099999999999996,0.016078571428571425,-254656215.83000007,0.004500000000000004,3.913491246138001,-61.559888579387156,38.440111420612844,56.18263092708054,0.20609999999999998,0.20365088222231081,0.2019,0.20298585262292004,0.20154999999999998,0.20967064579686978,31045.0,24078833.953333337,85107.0,25593092.005714286
2019-04-12,0.1808,0.1928,0.173,0.1893,35520308.48,8195.0,19487009.93,0.1907,0.1987142857142857,0.199685,0.1908127205555777,0.1954420421003925,0.20526009780650792,40.045766590389015,0.21841918209977104,0.18095081790022896,-0.014030059056411082,-0.016843124217886064,0.0028130651614749827,0.019800000000000012,0.01612857142857143,-260003363.96000007,-0.015600000000000003,-8.417997097242381,-63.53383458646616,36.46616541353384,31.923646162760676,4.7013274336283235,0.2018,0.2033,0.1699,0.181,40867456.61,11713.0,19824392.09,-10.307234886025775,28.92741061755146,0.21843648037524022,0.18222351962475974,-0.014226832160140757,-0.01754639050825481,0.0033195583481140517,0.03340000000000001,0.015907142857142856,-295523672.44000006,-0.020500000000000018,-17.68985902683039,-79.13533834586465,20.864661654135336,38.75079375840126,0.19593333333333332,0.1923254411111554,0.19985714285714282,0.19748938946719002,0.20032999999999998,0.2069401081019298,29238.0,19380209.393333342,80198.0,24025257.488571428
2019-04-13,0.1893,0.1947,0.1835,0.192,30017230.26,5957.0,16429817.98,0.18743333333333334,0.19761428571428571,0.19886500000000001,0.19140636027778885,0.1945815315752944,0.20399723134874526,42.550790067720094,0.21742792569953157,0.18030207430046846,-0.013500620766521337,-0.01617462352761312,0.0026740027610917816,0.011200000000000015,0.01612857142857143,-229986133.70000008,-0.0003999999999999837,-6.43274853801169,-58.45864661654133,41.54135338345866,32.95739348370928,1.4263074484944576,0.1808,0.1928,0.173,0.1893,35520308.48,8195.0,19487009.93,4.7013274336283235,40.045766590389015,0.21841918209977104,0.18095081790022896,-0.014030059056411082,-0.016843124217886064,0.0028130651614749827,0.019800000000000012,0.01612857142857143,-260003363.96000007,-0.015600000000000003,-8.417997097242381,-63.53383458646616,36.46616541353384,31.923646162760676,0.1907,0.1908127205555777,0.1987142857142857,0.1954420421003925,0.199685,0.20526009780650792,27237.0,19644159.36333334,76139.0,23406105.974285714
2019-04-14,0.192,0.1924,0.1851,0.1906,25352798.15,4492.0,14585913.81,0.19063333333333332,0.19588571428571427,0.19851000000000002,0.19100318013889442,0.1935861486814708,0.20272130455362666,45.91961023142509,0.21743477073489756,0.17958522926510248,-0.013043646371120265,-0.01554842809631455,0.002504781725194284,0.007300000000000001,0.01570714285714286,-255338931.85000008,-0.00470000000000001,-3.3958438925494216,-61.09022556390978,38.909774436090224,38.972431077694246,-0.7291666666666731,0.1893,0.1947,0.1835,0.192,30017230.26,5957.0,16429817.98,1.4263074484944576,42.550790067720094,0.21742792569953157,0.18030207430046846,-0.013500620766521337,-0.01617462352761312,0.0026740027610917816,0.011200000000000015,0.01612857142857143,-229986133.70000008,-0.0003999999999999837,-6.43274853801169,-58.45864661654133,41.54135338345866,32.95739348370928,0.18743333333333334,0.19140636027778885,0.19761428571428571,0.1945815315752944,0.19886500000000001,0.20399723134874526,25865.0,18580406.666666675,66607.0,22305791.73142857
2019-04-15,0.1905,0.1973,0.1801,0.183,37893791.12,7310.0,21011269.57,0.18853333333333333,0.19181428571428571,0.198565,0.18700159006944722,0.1909396115111031,0.2008430850723289,39.1812865497076,0.21729187626746263,0.17983812373253735,-0.013143240262232014,-0.015067390529498043,0.0019241502672660282,0.017199999999999993,0.016292857142857144,-293232722.9700001,-0.014300000000000007,-9.181141439205964,-75.37593984962406,24.624060150375943,35.025062656641616,-3.9370078740157513,0.192,0.1924,0.1851,0.1906,25352798.15,4492.0,14585913.81,-0.7291666666666731,45.91961023142509,0.21743477073489756,0.17958522926510248,-0.013043646371120265,-0.01554842809631455,0.002504781725194284,0.007300000000000001,0.01570714285714286,-255338931.85000008,-0.00470000000000001,-3.3958438925494216,-61.09022556390978,38.909774436090224,38.972431077694246,0.19063333333333332,0.19100318013889442,0.19588571428571427,0.1935861486814708,0.19851000000000002,0.20272130455362666,18644.0,16834247.240000006,61402.0,20366233.66714286
2019-04-16,0.183,0.1892,0.179,0.1869,29250696.81,5442.0,16201921.24,0.18683333333333332,0.18922857142857144,0.1982,0.18695079503472362,0.18992970863332737,0.1995151722082976,39.534883720930246,0.21755899083929228,0.1788410091607077,-0.012760378037180165,-0.014605988031034467,0.0018456099938543025,0.010200000000000015,0.016021428571428572,-263982026.1600001,-0.012799999999999978,-8.784773060029272,-68.04511278195486,31.95488721804514,31.829573934837104,2.1311475409836143,0.1905,0.1973,0.1801,0.183,37893791.12,7310.0,21011269.57,-3.9370078740157513,39.1812865497076,0.21729187626746263,0.17983812373253735,-0.013143240262232014,-0.015067390529498043,0.0019241502672660282,0.017199999999999993,0.016292857142857144,-293232722.9700001,-0.014300000000000007,-9.181141439205964,-75.37593984962406,24.624060150375943,35.025062656641616,0.18853333333333333,0.18700159006944722,0.19181428571428571,0.1909396115111031,0.198565,0.2008430850723289,17759.0,17342333.786666673,55192.0,18522091.352857143
2019-04-17,0.1871,0.2009,0.1868,0.197,35592104.2,7780.0,20208349.69,0.1889666666666667,0.18854285714285712,0.197055,0.1919753975173618,0.19169728147499554,0.19927563199798354,52.75119617224882,0.21349941674567016,0.18061058325432985,-0.011509299336217277,-0.01398665029207103,0.0024773509558537535,0.014100000000000001,0.014521428571428574,-228389921.9600001,-0.005699999999999983,2.3908523908523938,-44.353182751540004,55.64681724845999,37.40858820562703,5.29128808123999,0.183,0.1892,0.179,0.1869,29250696.81,5442.0,16201921.24,2.1311475409836143,39.534883720930246,0.21755899083929228,0.1788410091607077,-0.012760378037180165,-0.014605988031034467,0.0018456099938543025,0.010200000000000015,0.016021428571428572,-263982026.1600001,-0.012799999999999978,-8.784773060029272,-68.04511278195486,31.95488721804514,31.829573934837104,0.18683333333333332,0.18695079503472362,0.18922857142857144,0.18992970863332737,0.1982,0.1995151722082976,17244.0,17266368.206666674,50438.0,18165914.384285714
2019-04-18,0.1969,0.216,0.1969,0.2109,43770529.81,12482.0,25120188.9,0.19826666666666667,0.19281428571428574,0.197265,0.2014376987586809,0.19649796110624665,0.20038271466484225,58.245243128964056,0.214323817753816,0.18020618224618398,-0.009289117455562962,-0.013047143724769419,0.003758026269206457,0.019100000000000006,0.015021428571428574,-184619392.1500001,-0.0005999999999999894,7.9877112135176676,-15.811088295687856,84.18891170431215,57.26353872360576,7.11020822752667,0.1871,0.2009,0.1868,0.197,35592104.2,7780.0,20208349.69,5.29128808123999,52.75119617224882,0.21349941674567016,0.18061058325432985,-0.011509299336217277,-0.01398665029207103,0.0024773509558537535,0.014100000000000001,0.014521428571428574,-228389921.9600001,-0.005699999999999983,2.3908523908523938,-44.353182751540004,55.64681724845999,37.40858820562703,0.1889666666666667,0.1919753975173618,0.18854285714285712,0.19169728147499554,0.197055,0.19927563199798354,20532.0,19140513.500000007,50889.0,18249810.615714286
2019-04-19,0.2105,0.212,0.201,0.2042,34708544.17,7089.0,19274198.14,0.20403333333333337,0.19494285714285714,0.197215,0.20281884937934044,0.19842347082968498,0.200746265649143,53.474320241691835,0.2141815026014889,0.1802484973985111,-0.007978272763249056,-0.012033369532465346,0.004055096769216291,0.010999999999999982,0.015164285714285715,-219327936.3200001,-0.0007999999999999952,3.4972123669538613,-29.568788501026688,70.43121149897331,70.08898015058182,-2.992874109263658,0.1969,0.216,0.1969,0.2109,43770529.81,12482.0,25120188.9,7.11020822752667,58.245243128964056,0.214323817753816,0.18020618224618398,-0.009289117455562962,-0.013047143724769419,0.003758026269206457,0.019100000000000006,0.015021428571428574,-184619392.1500001,-0.0005999999999999894,7.9877112135176676,-15.811088295687856,84.18891170431215,57.26353872360576,0.19826666666666667,0.2014376987586809,0.19281428571428574,0.19649796110624665,0.197265,0.20038271466484225,25704.0,20510153.276666675,51658.0,19006353.017142855
2019-04-20,0.2043,0.2341,0.203,0.2292,45647573.57,15376.0,26540823.34,0.21476666666666666,0.20025714285714288,0.19881,0.21600942468967022,0.2061176031222637,0.20345614511112936,62.100082034454466,0.22100292442957564,0.17661707557042433,-0.004866035209290881,-0.010599902667830455,0.0057338674585395745,0.03109999999999999,0.01637857142857143,-173680362.75000012,0.02739999999999998,14.772158237356026,-7.632398753894104,92.36760124610589,82.32924148313045,12.187958883994114,0.2105,0.212,0.201,0.2042,34708544.17,7089.0,19274198.14,-2.992874109263658,53.474320241691835,0.2141815026014889,0.1802484973985111,-0.007978272763249056,-0.012033369532465346,0.004055096769216291,0.010999999999999982,0.015164285714285715,-219327936.3200001,-0.0007999999999999952,3.4972123669538613,-29.568788501026688,70.43121149897331,70.08898015058182,0.20403333333333337,0.20281884937934044,0.19494285714285714,0.19842347082968498,0.197215,0.200746265649143,27351.0,21534245.57666667,50552.0,18975951.332857143
2019-04-21,0.2296,0.2488,0.2036,0.2328,66159288.17,27975.0,34334796.22,0.22206666666666666,0.20628571428571427,0.20037500000000003,0.2244047123448351,0.2127882023416978,0.20625079795768847,62.285714285714285,0.22728067343810426,0.1734693265618958,-0.002085039573462788,-0.008896930048956923,0.006811890475494135,0.04519999999999999,0.018764285714285713,-107521074.58000012,0.05180000000000001,14.849531327084375,-20.27883396704688,79.72116603295312,80.83999292601078,1.3937282229965193,0.2043,0.2341,0.203,0.2292,45647573.57,15376.0,26540823.34,12.187958883994114,62.100082034454466,0.22100292442957564,0.17661707557042433,-0.004866035209290881,-0.010599902667830455,0.0057338674585395745,0.03109999999999999,0.01637857142857143,-173680362.75000012,0.02739999999999998,14.772158237356026,-7.632398753894104,92.36760124610589,82.32924148313045,0.21476666666666666,0.21600942468967022,0.20025714285714288,0.2061176031222637,0.19881,0.20345614511112936,34947.0,23645070.126666676,59971.0,20420380.669999998
2019-04-22,0.2328,0.2463,0.2178,0.2293,48467021.61,21257.0,24177726.65,0.23043333333333335,0.2129,0.20159500000000002,0.22685235617241756,0.21691615175627332,0.20844596005695623,57.593856655290104,0.23141907893314628,0.17177092106685377,-0.00016163798330159906,-0.0071498716358258585,0.006988233652524259,0.028499999999999998,0.019292857142857143,-155988096.19000012,0.04000000000000001,8.416075650118216,-24.71482889733839,75.28517110266161,82.45797946057354,-1.5034364261168398,0.2296,0.2488,0.2036,0.2328,66159288.17,27975.0,34334796.22,1.3937282229965193,62.285714285714285,0.22728067343810426,0.1734693265618958,-0.002085039573462788,-0.008896930048956923,0.006811890475494135,0.04519999999999999,0.018764285714285713,-107521074.58000012,0.05180000000000001,14.849531327084375,-20.27883396704688,79.72116603295312,80.83999292601078,0.22206666666666666,0.2244047123448351,0.20628571428571427,0.2127882023416978,0.20037500000000003,0.20625079795768847,50440.0,26716605.900000006,83454.0,23241649.585714284
2019-04-23,0.2293,0.2306,0.2038,0.2076,45255496.41,12604.0,23682187.97,0.22323333333333337,0.2158571428571429,0.20235499999999998,0.21722617808620878,0.214587113817205,0.20836539243248423,50.98187311178248,0.23196641138498025,0.1727435886150197,-0.0003839115182658892,-0.005796679612313865,0.005412768094047976,0.02679999999999999,0.020214285714285712,-201243592.6000001,0.015600000000000003,1.2682926829268304,-52.217997465145736,47.782002534854264,67.59611322348967,-9.463584823375488,0.2328,0.2463,0.2178,0.2293,48467021.61,21257.0,24177726.65,-1.5034364261168398,57.593856655290104,0.23141907893314628,0.17177092106685377,-0.00016163798330159906,-0.0071498716358258585,0.006988233652524259,0.028499999999999998,0.019292857142857143,-155988096.19000012,0.04000000000000001,8.416075650118216,-24.71482889733839,75.28517110266161,82.45797946057354,0.23043333333333335,0.22685235617241756,0.2129,0.21691615175627332,0.20159500000000002,0.20844596005695623,64608.0,28351115.40333334,97401.0,23694000.597142857
2019-04-24,0.2075,0.2077,0.1751,0.1875,43385561.66,13783.0,22461044.67,0.20813333333333336,0.2145,0.201965,0.2023630890431044,0.20781533536290375,0.20637821220081906,45.21098459477562,0.2321672149762844,0.17176278502371561,-0.0021571011935995477,-0.005068763928571002,0.002911662734971454,0.03259999999999999,0.021964285714285714,-244629154.2600001,-0.0030999999999999917,-7.086223984142714,-77.69328263624841,22.30671736375159,48.45796366708915,-9.638554216867465,0.2293,0.2306,0.2038,0.2076,45255496.41,12604.0,23682187.97,-9.463584823375488,50.98187311178248,0.23196641138498025,0.1727435886150197,-0.0003839115182658892,-0.005796679612313865,0.005412768094047976,0.02679999999999999,0.020214285714285712,-201243592.6000001,0.015600000000000003,1.2682926829268304,-52.217997465145736,47.782002534854264,67.59611322348967,0.22323333333333337,0.21722617808620878,0.2158571428571429,0.214587113817205,0.20235499999999998,0.20836539243248423,61836.0,27398236.946666673,104563.0,24762610.13
2019-04-25,0.1874,0.1897,0.1585,0.1601,17425250.37,8483.0,8294065.04,0.18506666666666663,0.20724285714285712,0.20010500000000003,0.1812315445215522,0.19588650152217782,0.20197076341978867,43.29698524695317,0.23562978600994872,0.16458021399005135,-0.0057075249997031174,-0.005196516142797425,-0.0005110088569056925,0.031200000000000006,0.02180714285714286,-262054404.6300001,-0.022900000000000004,-11.546961325966853,-98.22812846068662,1.7718715393133893,23.953530479306412,-14.567769477054437,0.2075,0.2077,0.1751,0.1875,43385561.66,13783.0,22461044.67,-9.638554216867465,45.21098459477562,0.2321672149762844,0.17176278502371561,-0.0021571011935995477,-0.005068763928571002,0.002911662734971454,0.03259999999999999,0.021964285714285714,-244629154.2600001,-0.0030999999999999917,-7.086223984142714,-77.69328263624841,22.30671736375159,48.45796366708915,0.20813333333333336,0.2023630890431044,0.2145,0.20781533536290375,0.201965,0.20637821220081906,47644.0,23440319.76333334,110566.0,25084423.698571425
2019-04-26,0.1604,0.1649,0.1407,0.1461,22673386.24,10295.0,10668228.48,0.16456666666666667,0.19894285714285714,0.19742500000000002,0.1636657722607761,0.18343987614163337,0.19664973833218974,36.633663366336634,0.24038710692667392,0.1544628930733261,-0.00954096216973066,-0.006065405348184072,-0.003475556821546588,0.0242,0.02212142857142857,-284727790.8700001,-0.0408,-22.820919175911246,-95.00462534690101,4.995374653098997,9.691321185387993,-8.9152119700748,0.1874,0.1897,0.1585,0.1601,17425250.37,8483.0,8294065.04,-14.567769477054437,43.29698524695317,0.23562978600994872,0.16458021399005135,-0.0057075249997031174,-0.005196516142797425,-0.0005110088569056925,0.031200000000000006,0.02180714285714286,-262054404.6300001,-0.022900000000000004,-11.546961325966853,-98.22812846068662,1.7718715393133893,23.953530479306412,0.18506666666666663,0.1812315445215522,0.20724285714285712,0.19588650152217782,0.20010500000000003,0.20197076341978867,34870.0,18145765.893333342,106567.0,22680691.718571432
2019-04-27,0.1463,0.1535,0.1411,0.1509,23139161.61,6752.0,19188531.95,0.15236666666666668,0.18775714285714287,0.194835,0.15728288613038804,0.17530490710622504,0.1922926203957907,37.44654856444716,0.2424515948516184,0.1472184051483816,-0.01205273246340205,-0.007262870771227668,-0.0047898616921743815,0.012399999999999994,0.022207142857142852,-261588629.2600001,-0.0461,-21.406249999999993,-90.56429232192413,9.43570767807587,5.400984623496086,3.1442241968557707,0.1604,0.1649,0.1407,0.1461,22673386.24,10295.0,10668228.48,-8.9152119700748,36.633663366336634,0.24038710692667392,0.1544628930733261,-0.00954096216973066,-0.006065405348184072,-0.003475556821546588,0.0242,0.02212142857142857,-284727790.8700001,-0.0408,-22.820919175911246,-95.00462534690101,4.995374653098997,9.691321185387993,0.16456666666666667,0.1636657722607761,0.19894285714285714,0.18343987614163337,0.19742500000000002,0.19664973833218974,32561.0,13807779.396666676,109773.0,21451267.48142857
2019-04-28,0.1511,0.1579,0.144,0.1467,31556751.14,7728.0,27232545.24,0.1479,0.17545714285714284,0.19159500000000002,0.15199144306519402,0.16815368032966876,0.18795046607238208,36.816816816816825,0.24309700711469528,0.14009299288530475,-0.014218333320684173,-0.008653963281118969,-0.005564370039565204,0.013900000000000023,0.02267857142857143,-293145380.4000001,-0.06420000000000001,-23.032528856243438,-94.44958371877891,5.550416281221096,6.660499537465321,-2.911978821972214,0.1463,0.1535,0.1411,0.1509,23139161.61,6752.0,19188531.95,3.1442241968557707,37.44654856444716,0.2424515948516184,0.1472184051483816,-0.01205273246340205,-0.007262870771227668,-0.0047898616921743815,0.012399999999999994,0.022207142857142852,-261588629.2600001,-0.0461,-21.406249999999993,-90.56429232192413,9.43570767807587,5.400984623496086,0.15236666666666668,0.15728288613038804,0.18775714285714287,0.17530490710622504,0.194835,0.1922926203957907,25530.0,12716941.82333334,101149.0,20400940.139999997
2019-04-29,0.1465,0.1499,0.127,0.1284,29393292.01,8855.0,23122284.72,0.142,0.16104285714285713,0.18776500000000002,0.14019572153259702,0.15821526024725155,0.1822789931131076,34.59367945823928,0.24601980418408712,0.12951019581591292,-0.017212825920313368,-0.01036573580895785,-0.006847090111355519,0.022900000000000004,0.02308571428571429,-322538672.4100001,-0.0758,-29.836065573770497,-98.85057471264369,1.1494252873563093,5.3785164155510925,-12.354948805460756,0.1511,0.1579,0.144,0.1467,31556751.14,7728.0,27232545.24,-2.911978821972214,36.816816816816825,0.24309700711469528,0.14009299288530475,-0.014218333320684173,-0.008653963281118969,-0.005564370039565204,0.013900000000000023,0.02267857142857143,-293145380.4000001,-0.06420000000000001,-23.032528856243438,-94.44958371877891,5.550416281221096,6.660499537465321,0.1479,0.15199144306519402,0.17545714285714284,0.16815368032966876,0.19159500000000002,0.18795046607238208,24775.0,19029768.556666672,80902.0,19386332.85714286
2019-04-30,0.1284,0.1399,0.1283,0.1386,34624953.27,7503.0,30342797.16,0.1379,0.15118571428571428,0.184605,0.1393978607662985,0.15331144518543866,0.17811908900709736,36.83923705722071,0.2464029892365781,0.12280701076342186,-0.01854910558189965,-0.012002409763546211,-0.006546695818353439,0.0116,0.023185714285714285,-287913719.1400001,-0.09059999999999999,-25.842696629213492,-90.47619047619048,9.523809523809524,5.40788369746231,7.943925233644872,0.1465,0.1499,0.127,0.1284,29393292.01,8855.0,23122284.72,-12.354948805460756,34.59367945823928,0.24601980418408712,0.12951019581591292,-0.017212825920313368,-0.01036573580895785,-0.006847090111355519,0.022900000000000004,0.02308571428571429,-322538672.4100001,-0.0758,-29.836065573770497,-98.85057471264369,1.1494252873563093,5.3785164155510925,0.142,0.14019572153259702,0.16104285714285713,0.15821526024725155,0.18776500000000002,0.1822789931131076,23335.0,23181120.63666667,68500.0,19235555.438571427
2019-05-01,0.1386,0.1418,0.1327,0.1362,34828656.54,6442.0,31271879.73,0.1344,0.14385714285714285,0.182365,0.13779893038314925,0.149033583889079,0.17412679481594523,32.707622298065985,0.24785088518066128,0.1168791148193387,-0.01957611550955954,-0.013517150912748879,-0.00605896459681066,0.009099999999999997,0.022828571428571427,-322742375.6800001,-0.09660000000000002,-30.862944162436555,-92.44663382594418,7.553366174055818,6.07553366174055,-1.731601731601741,0.1284,0.1399,0.1283,0.1386,34624953.27,7503.0,30342797.16,7.943925233644872,36.83923705722071,0.2464029892365781,0.12280701076342186,-0.01854910558189965,-0.012002409763546211,-0.006546695818353439,0.0116,0.023185714285714285,-287913719.1400001,-0.09059999999999999,-25.842696629213492,-90.47619047619048,9.523809523809524,5.40788369746231,0.1379,0.1393978607662985,0.15118571428571428,0.15331144518543866,0.184605,0.17811908900709736,24086.0,26899209.040000007,63399.0,20187071.037142854
2019-05-02,0.136,0.1412,0.1308,0.1327,26473642.74,7056.0,22543878.8,0.13583333333333333,0.13994285714285715,0.179535,0.13524946519157463,0.14495018791680925,0.1701813857858552,26.360338573156,0.24855558503008182,0.11051441496991818,-0.020436865561035966,-0.014901093842406296,-0.00553577171862967,0.010399999999999993,0.022207142857142852,-349216018.42000014,-0.09659999999999999,-37.0791844476055,-95.32019704433496,4.679802955665034,7.252326217843458,-2.426470588235292,0.1386,0.1418,0.1327,0.1362,34828656.54,6442.0,31271879.73,-1.731601731601741,32.707622298065985,0.24785088518066128,0.1168791148193387,-0.01957611550955954,-0.013517150912748879,-0.00605896459681066,0.009099999999999997,0.022828571428571427,-322742375.6800001,-0.09660000000000002,-30.862944162436555,-92.44663382594418,7.553366174055818,6.07553366174055,0.1344,0.13779893038314925,0.14385714285714285,0.149033583889079,0.182365,0.17412679481594523,22800.0,28245653.87000001,56058.0,21445761.759999998
2019-05-03,0.1326,0.1359,0.1276,0.134,35630525.75,6645.0,31340980.29,0.1343,0.1382142857142857,0.176635,0.13462473259578733,0.14221264093760694,0.16673553952053566,28.062500000000014,0.248274603131523,0.10499539686847696,-0.020774639925457278,-0.016075803059016493,-0.004698836866440785,0.008300000000000002,0.02201428571428571,-313585492.67000014,-0.0736,-34.37806072477962,-94.25287356321839,5.747126436781615,5.993431855500822,1.0558069381598887,0.136,0.1412,0.1308,0.1327,26473642.74,7056.0,22543878.8,-2.426470588235292,26.360338573156,0.24855558503008182,0.11051441496991818,-0.020436865561035966,-0.014901093842406296,-0.00553577171862967,0.010399999999999993,0.022207142857142852,-349216018.42000014,-0.09659999999999999,-37.0791844476055,-95.32019704433496,4.679802955665034,7.252326217843458,0.13583333333333333,0.13524946519157463,0.13994285714285715,0.14495018791680925,0.179535,0.1701813857858552,21001.0,28052851.896666676,54631.0,23481449.439999998
2019-05-04,0.1341,0.1345,0.1187,0.1241,29489810.34,7363.0,24049481.8,0.13026666666666667,0.13438571428571428,0.17331000000000002,0.12936236629789366,0.13768448070320521,0.1626750119471513,13.73360938578331,0.24831441811548255,0.09830558188451748,-0.021592273516665317,-0.01717909715054626,-0.0044131763661190565,0.01580000000000001,0.02092142857142857,-343075303.0100001,-0.0634,-45.85514834205934,-95.84934665641813,4.150653343581862,4.859194245342837,-7.457121551081279,0.1326,0.1359,0.1276,0.134,35630525.75,6645.0,31340980.29,1.0558069381598887,28.062500000000014,0.248274603131523,0.10499539686847696,-0.020774639925457278,-0.016075803059016493,-0.004698836866440785,0.008300000000000002,0.02201428571428571,-313585492.67000014,-0.0736,-34.37806072477962,-94.25287356321839,5.747126436781615,5.993431855500822,0.1343,0.13462473259578733,0.1382142857142857,0.14221264093760694,0.176635,0.16673553952053566,20143.0,28385579.606666673,50981.0,26434699.698571425
2019-05-05,0.1239,0.1255,0.1195,0.1219,29087977.31,7299.0,24908581.96,0.12666666666666668,0.13084285714285712,0.170255,0.12563118314894683,0.1337383605274039,0.15879167747599404,11.358885017421613,0.24850470758310939,0.09200529241689061,-0.022162302415570045,-0.018175738203551017,-0.003986564212019029,0.006000000000000005,0.018121428571428573,-372163280.3200001,-0.0382,-47.637457044673546,-97.4921630094044,2.507836990595607,4.135205590319694,-1.614205004035514,0.1341,0.1345,0.1187,0.1241,29489810.34,7363.0,24049481.8,-7.457121551081279,13.73360938578331,0.24831441811548255,0.09830558188451748,-0.021592273516665317,-0.01717909715054626,-0.0044131763661190565,0.01580000000000001,0.02092142857142857,-343075303.0100001,-0.0634,-45.85514834205934,-95.84934665641813,4.150653343581862,4.859194245342837,0.13026666666666667,0.12936236629789366,0.13438571428571428,0.13768448070320521,0.17331000000000002,0.1626750119471513,21064.0,25978113.630000006,51592.0,27129121.105714288
2019-05-06,0.1219,0.127,0.1174,0.1236,34562990.3,7870.0,29311851.01,0.12319999999999999,0.13015714285714286,0.16709000000000002,0.12461559157447341,0.13120377039555292,0.155440089144947,12.702893436838394,0.24759317810006354,0.08658682189993648,-0.022220731867241023,-0.01898473693628902,-0.003235994930952002,0.009599999999999997,0.016771428571428573,-337600290.0200001,-0.022500000000000006,-46.09681639773223,-94.52296819787986,5.477031802120139,4.045174045432535,1.394585726004928,0.1239,0.1255,0.1195,0.1219,29087977.31,7299.0,24908581.96,-1.614205004035514,11.358885017421613,0.24850470758310939,0.09200529241689061,-0.022162302415570045,-0.018175738203551017,-0.003986564212019029,0.006000000000000005,0.018121428571428573,-372163280.3200001,-0.0382,-47.637457044673546,-97.4921630094044,2.507836990595607,4.135205590319694,0.12666666666666668,0.12563118314894683,0.13084285714285712,0.1337383605274039,0.170255,0.15879167747599404,21307.0,26766348.016666677,51163.0,26797126.351428572
2019-05-07,0.124,0.126,0.11,0.1114,37075435.28,7742.0,31857199.61,0.11896666666666667,0.12627142857142856,0.16281,0.1180077957872367,0.1262528277966647,0.15124579494066634,13.615733736762493,0.2456846904415908,0.07993530955840923,-0.022986501587299563,-0.019785089866491128,-0.003201411720808435,0.016,0.016000000000000004,-374675725.3000001,-0.03950000000000001,-46.33911368015414,-98.56704196519959,1.4329580348004078,3.139275609172051,-10.161290322580644,0.1219,0.127,0.1174,0.1236,34562990.3,7870.0,29311851.01,1.394585726004928,12.702893436838394,0.24759317810006354,0.08658682189993648,-0.022220731867241023,-0.01898473693628902,-0.003235994930952002,0.009599999999999997,0.016771428571428573,-337600290.0200001,-0.022500000000000006,-46.09681639773223,-94.52296819787986,5.477031802120139,4.045174045432535,0.12319999999999999,0.12461559157447341,0.13015714285714286,0.13120377039555292,0.16709000000000002,0.155440089144947,22532.0,26089971.590000007,50178.0,27681350.10714286
2019-05-08,0.1116,0.1136,0.1058,0.1068,21735885.82,6572.0,17031312.95,0.11393333333333333,0.12207142857142858,0.157605,0.11240389789361835,0.12138962084749852,0.14701286208917433,15.424164524421599,0.24083790025110596,0.07437209974889404,-0.023691460751592758,-0.020566364043511455,-0.0031250967080813027,0.007800000000000001,0.014228571428571432,-396411611.12000006,-0.03989999999999999,-43.04,-98.80810488676997,1.1918951132300368,2.700628316716861,-4.301075268817203,0.124,0.126,0.11,0.1114,37075435.28,7742.0,31857199.61,-10.161290322580644,13.615733736762493,0.2456846904415908,0.07993530955840923,-0.022986501587299563,-0.019785089866491128,-0.003201411720808435,0.016,0.016000000000000004,-374675725.3000001,-0.03950000000000001,-46.33911368015414,-98.56704196519959,1.4329580348004078,3.139275609172051,0.11896666666666667,0.1180077957872367,0.12627142857142856,0.1262528277966647,0.16281,0.15124579494066634,22911.0,28692544.193333343,50417.0,27897693.314285714
2019-05-09,0.1061,0.1061,0.0925,0.0943,9601618.45,6280.0,4348085.76,0.10416666666666667,0.11658571428571429,0.15211,0.10335194894680917,0.1146172156356239,0.14199258950925295,17.68172888015718,0.2368873281509926,0.0673326718490074,-0.024970942025593468,-0.02144727963992786,-0.0035236623856656074,0.013600000000000001,0.012971428571428575,-406013229.57000005,-0.03409999999999999,-41.09931292941912,-97.51381215469614,2.486187845303862,1.7036803311114355,-11.121583411875594,0.1116,0.1136,0.1058,0.1068,21735885.82,6572.0,17031312.95,-4.301075268817203,15.424164524421599,0.24083790025110596,0.07437209974889404,-0.023691460751592758,-0.020566364043511455,-0.0031250967080813027,0.007800000000000001,0.014228571428571432,-396411611.12000006,-0.03989999999999999,-43.04,-98.80810488676997,1.1918951132300368,2.700628316716861,0.11393333333333333,0.11240389789361835,0.12207142857142858,0.12138962084749852,0.157605,0.14701286208917433,22184.0,26066787.856666673,50547.0,25863326.631428573
2019-05-10,0.0945,0.1048,0.0875,0.0998,14476137.43,7901.0,6993735.35,0.1003,0.11170000000000001,0.14564000000000002,0.10157597447340458,0.11091291172671792,0.13797424765122887,25.18756698821008,0.22523823854173786,0.06604176145826217,-0.025250069040544554,-0.0222078375200512,-0.0030422315204933527,0.01730000000000001,0.012478571428571431,-391537092.14000005,-0.0388,-31.690622861054074,-82.52840909090908,17.47159090909091,7.0498912892082695,5.6084656084656075,0.1061,0.1061,0.0925,0.0943,9601618.45,6280.0,4348085.76,-11.121583411875594,17.68172888015718,0.2368873281509926,0.0673326718490074,-0.024970942025593468,-0.02144727963992786,-0.0035236623856656074,0.013600000000000001,0.012971428571428575,-406013229.57000005,-0.03409999999999999,-41.09931292941912,-97.51381215469614,2.486187845303862,1.7036803311114355,0.10416666666666667,0.10335194894680917,0.11658571428571429,0.1146172156356239,0.15211,0.14199258950925295,20594.0,17745532.77333334,49771.0,23263927.625714283
2019-05-11,0.0999,0.1132,0.0955,0.1065,35468300.41,11581.0,25608131.63,0.1002,0.10918571428571429,0.139325,0.1040379872367023,0.10980968379503844,0.13497670025587374,26.68067226890757,0.20926168941489742,0.06938831058510257,-0.024646535288263535,-0.022695577073693667,-0.001950958214569868,0.017699999999999994,0.01285714285714286,-356068791.73,-0.02969999999999999,-29.42345924453281,-73.01136363636364,26.98863636363636,15.648805039343712,6.606606606606601,0.0945,0.1048,0.0875,0.0998,14476137.43,7901.0,6993735.35,5.6084656084656075,25.18756698821008,0.22523823854173786,0.06604176145826217,-0.025250069040544554,-0.0222078375200512,-0.0030422315204933527,0.01730000000000001,0.012478571428571431,-391537092.14000005,-0.0388,-31.690622861054074,-82.52840909090908,17.47159090909091,7.0498912892082695,0.1003,0.10157597447340458,0.11170000000000001,0.11091291172671792,0.14564000000000002,0.13797424765122887,20753.0,9457711.353333341,51027.0,19785749.777142856
2019-05-12,0.1065,0.1265,0.1043,0.1147,52739783.96,17154.0,39468172.37,0.107,0.10815714285714285,0.13359500000000002,0.10936899361835115,0.11103226284627885,0.13304558594579052,33.87096774193549,0.1899531582381827,0.07723684176181732,-0.0232386779576928,-0.022804197250493496,-0.00043448070719930357,0.022199999999999998,0.013450000000000002,-303329007.77000004,-0.018000000000000016,-21.813224267211993,-56.41025641025641,43.589743589743584,29.349990287490286,7.699530516431924,0.0999,0.1132,0.0955,0.1065,35468300.41,11581.0,25608131.63,6.606606606606601,26.68067226890757,0.20926168941489742,0.06938831058510257,-0.024646535288263535,-0.022695577073693667,-0.001950958214569868,0.017699999999999994,0.01285714285714286,-356068791.73,-0.02969999999999999,-29.42345924453281,-73.01136363636364,26.98863636363636,15.648805039343712,0.1002,0.1040379872367023,0.10918571428571429,0.10980968379503844,0.139325,0.13497670025587374,25762.0,12316650.913333341,55245.0,20008414.038571425
2019-05-13,0.1149,0.1326,0.1141,0.1201,45923125.33,20006.0,31451521.57,0.11376666666666667,0.10765714285714285,0.12922,0.11473449680917558,0.11329919713470912,0.13181267299857238,45.19119351100812,0.17372833629782228,0.08471166370217773,-0.02144005836299842,-0.022531369472994483,0.001091311109996062,0.018500000000000003,0.013135714285714287,-257405882.44000006,-0.01390000000000001,-6.464174454828653,-39.96316758747699,60.03683241252301,43.53840412196765,4.525674499564836,0.1065,0.1265,0.1043,0.1147,52739783.96,17154.0,39468172.37,7.699530516431924,33.87096774193549,0.1899531582381827,0.07723684176181732,-0.0232386779576928,-0.022804197250493496,-0.00043448070719930357,0.022199999999999998,0.013450000000000002,-303329007.77000004,-0.018000000000000016,-21.813224267211993,-56.41025641025641,43.589743589743584,29.349990287490286,0.107,0.10936899361835115,0.10815714285714285,0.11103226284627885,0.13359500000000002,0.13304558594579052,36636.0,24023346.450000007,65100.0,22088355.525714286
2019-05-14,0.1201,0.145,0.1201,0.1433,57979259.36,21850.0,40793158.3,0.12603333333333333,0.11221428571428572,0.12701,0.12901724840458778,0.12079939785103183,0.1329067041415655,52.36656596173213,0.16288615540043044,0.09113384459956958,-0.017935840066722233,-0.02161226359174003,0.003676423525017798,0.02489999999999999,0.014085714285714285,-199426623.08000004,0.01920000000000001,3.391053391053389,-2.956521739130399,97.04347826086959,66.89001808771206,19.3172356369692,0.1149,0.1326,0.1141,0.1201,45923125.33,20006.0,31451521.57,4.525674499564836,45.19119351100812,0.17372833629782228,0.08471166370217773,-0.02144005836299842,-0.022531369472994483,0.001091311109996062,0.018500000000000003,0.013135714285714287,-257405882.44000006,-0.01390000000000001,-6.464174454828653,-39.96316758747699,60.03683241252301,43.53840412196765,0.11376666666666667,0.11473449680917558,0.10765714285714285,0.11329919713470912,0.12922,0.13181267299857238,48741.0,32175941.856666673,77236.0,22394022.74857143
2019-05-15,0.143,0.1499,0.1326,0.1471,23107049.24,11922.0,13007504.33,0.13683333333333333,0.11797142857142859,0.12636,0.1380586242022939,0.1273745483882739,0.13425844660427355,55.4121151936445,0.16012054377212426,0.09259945622787573,-0.01468283895064576,-0.02022637866352118,0.0055435397128754185,0.01730000000000001,0.014671428571428573,-176319573.84000003,0.025200000000000014,8.002936857562414,-4.487179487179482,95.51282051282051,84.19771039540437,2.8671328671328813,0.1201,0.145,0.1201,0.1433,57979259.36,21850.0,40793158.3,19.3172356369692,52.36656596173213,0.16288615540043044,0.09113384459956958,-0.017935840066722233,-0.02161226359174003,0.003676423525017798,0.02489999999999999,0.014085714285714285,-199426623.08000004,0.01920000000000001,3.391053391053389,-2.956521739130399,97.04347826086959,66.89001808771206,0.12603333333333333,0.12901724840458778,0.11221428571428572,0.12079939785103183,0.12701,0.1329067041415655,59010.0,37237617.413333334,91344.0,23670588.275714286
2019-05-16,0.1467,0.157,0.1279,0.1332,33338162.86,19518.0,17610282.79,0.14120000000000002,0.12352857142857143,0.125715,0.13562931210114695,0.1288309112912054,0.1341576421657713,50.225022502250226,0.15836215833527423,0.09306784166472576,-0.013075697461404717,-0.018796242423097888,0.0057205449616931706,0.029099999999999987,0.01600714285714286,-209657736.70000005,0.009600000000000011,0.37678975131876236,-34.24460431654674,65.75539568345326,86.10389815238112,-9.20245398773005,0.143,0.1499,0.1326,0.1471,23107049.24,11922.0,13007504.33,2.8671328671328813,55.4121151936445,0.16012054377212426,0.09259945622787573,-0.01468283895064576,-0.02022637866352118,0.0055435397128754185,0.01730000000000001,0.014671428571428573,-176319573.84000003,0.025200000000000014,8.002936857562414,-4.487179487179482,95.51282051282051,84.19771039540437,0.13683333333333333,0.1380586242022939,0.11797142857142859,0.1273745483882739,0.12636,0.13425844660427355,53778.0,28417394.733333338,96694.0,23095758.472857144
2019-05-17,0.1331,0.18,0.1145,0.1709,57768580.48,47154.0,28533548.83,0.1504,0.13368571428571427,0.126715,0.1532646560505735,0.13934818346840405,0.13765691434045976,62.508474576271176,0.16356498178961262,0.08986501821038737,-0.00866012281927675,-0.01676901850233366,0.008108895683056911,0.06549999999999999,0.02009285714285714,-151889156.22000006,0.0595,27.53731343283581,-9.837837837837835,90.16216216216216,83.81012611947864,28.399699474079643,0.1467,0.157,0.1279,0.1332,33338162.86,19518.0,17610282.79,-9.20245398773005,50.225022502250226,0.15836215833527423,0.09306784166472576,-0.013075697461404717,-0.018796242423097888,0.0057205449616931706,0.029099999999999987,0.01600714285714286,-209657736.70000005,0.009600000000000011,0.37678975131876236,-34.24460431654674,65.75539568345326,86.10389815238112,0.14120000000000002,0.13562931210114695,0.12352857142857143,0.1288309112912054,0.125715,0.1341576421657713,53290.0,23803648.47333334,109932.0,24990358.048571426
2019-05-18,0.1711,0.193,0.1555,0.1615,43772639.46,34813.0,18692142.0,0.1552,0.14154285714285714,0.12745499999999998,0.15738232802528673,0.14488613760130303,0.1399276844032731,62.72108843537415,0.1665224706521671,0.08838752934783287,-0.005851793708557956,-0.01458557354357852,0.008733779835020564,0.037500000000000006,0.021642857142857137,-195661795.68000007,0.0547,30.136986301369873,-29.85781990521327,70.14218009478674,75.35324598013405,-5.610753945061366,0.1331,0.18,0.1145,0.1709,57768580.48,47154.0,28533548.83,28.399699474079643,62.508474576271176,0.16356498178961262,0.08986501821038737,-0.00866012281927675,-0.01676901850233366,0.008108895683056911,0.06549999999999999,0.02009285714285714,-151889156.22000006,0.0595,27.53731343283581,-9.837837837837835,90.16216216216216,83.81012611947864,0.1504,0.1532646560505735,0.13368571428571427,0.13934818346840405,0.126715,0.13765691434045976,78594.0,19717111.983333338,149185.0,28067474.259999998
2019-05-19,0.1613,0.2156,0.1551,0.2059,88020567.99,58955.0,52695156.58,0.17943333333333333,0.15457142857142858,0.13133,0.18164116401264335,0.16013960320097728,0.14621076207915185,72.19873150105708,0.18385003527477112,0.07880996472522889,-4.296840860951168e-05,-0.01167705251658472,0.011634084107975208,0.060500000000000026,0.025535714285714283,-107641227.69000007,0.1116,68.90894175553733,-7.572209211553484,92.42779078844652,84.24404434846514,27.650340979541227,0.1711,0.193,0.1555,0.1615,43772639.46,34813.0,18692142.0,-5.610753945061366,62.72108843537415,0.1665224706521671,0.08838752934783287,-0.005851793708557956,-0.01458557354357852,0.008733779835020564,0.037500000000000006,0.021642857142857137,-195661795.68000007,0.0547,30.136986301369873,-29.85781990521327,70.14218009478674,75.35324598013405,0.1552,0.15738232802528673,0.14154285714285714,0.14488613760130303,0.12745499999999998,0.1399276844032731,101485.0,21611991.20666667,172417.0,27079475.741428573
2019-05-20,0.2059,0.3166,0.1946,0.2709,185510226.27,126080.0,104873597.81,0.21276666666666666,0.17611428571428572,0.13794499999999998,0.22627058200632166,0.18782970240073293,0.1580859275954231,79.16831683168317,0.21957826140992465,0.056311738590075336,0.009693780398000895,-0.007402885933667598,0.017096666331668495,0.122,0.03356428571428571,77868998.57999994,0.17109999999999997,119.17475728155335,-19.947621126145794,80.0523788738542,80.87411658569583,31.56872268091305,0.1613,0.2156,0.1551,0.2059,88020567.99,58955.0,52695156.58,27.650340979541227,72.19873150105708,0.18385003527477112,0.07880996472522889,-4.296840860951168e-05,-0.01167705251658472,0.011634084107975208,0.060500000000000026,0.025535714285714283,-107641227.69000007,0.1116,68.90894175553733,-7.572209211553484,92.42779078844652,84.24404434846514,0.17943333333333333,0.18164116401264335,0.15457142857142858,0.16013960320097728,0.13133,0.14621076207915185,140922.0,33306949.13666667,214218.0,28969044.914285712
2019-05-21,0.2715,0.3422,0.2167,0.2285,206404080.15,129456.0,111448001.43,0.2351,0.1882857142857143,0.14256,0.22738529100316085,0.1979972768005497,0.16479202972919232,70.71100106119562,0.23366450679244566,0.05145549320755434,0.01382948068354467,-0.003156412610225144,0.016985893293769816,0.1255,0.04138571428571429,-128535081.57000007,0.12200000000000001,105.11669658886893,-44.64075382803297,55.359246171967015,75.94647194475591,-15.837937384898716,0.2059,0.3166,0.1946,0.2709,185510226.27,126080.0,104873597.81,31.56872268091305,79.16831683168317,0.21957826140992465,0.056311738590075336,0.009693780398000895,-0.007402885933667598,0.017096666331668495,0.122,0.03356428571428571,77868998.57999994,0.17109999999999997,119.17475728155335,-19.947621126145794,80.0523788738542,80.87411658569583,0.21276666666666666,0.22627058200632166,0.17611428571428572,0.18782970240073293,0.13794499999999998,0.1580859275954231,219848.0,58753632.13,320292.0,39457912.94857143
2019-05-22,0.2285,0.2404,0.1636,0.1686,116173555.21,46093.0,69892057.1,0.22266666666666668,0.19135714285714286,0.144355,0.1979926455015804,0.19064795760041228,0.16515469356450735,59.14201183431953,0.23605424467346636,0.052655755326533646,0.012133753207163922,-9.837944674733054e-05,0.012232132653911253,0.07680000000000001,0.04631428571428571,-244708636.78000006,0.0539,57.865168539325836,-68.15861798193953,31.84138201806046,55.75100235462722,-26.21444201312911,0.2715,0.3422,0.2167,0.2285,206404080.15,129456.0,111448001.43,-15.837937384898716,70.71100106119562,0.23366450679244566,0.05145549320755434,0.01382948068354467,-0.003156412610225144,0.016985893293769816,0.1255,0.04138571428571429,-128535081.57000007,0.12200000000000001,105.11669658886893,-44.64075382803297,55.359246171967015,75.94647194475591,0.2351,0.22738529100316085,0.1882857142857143,0.1979972768005497,0.14256,0.16479202972919232,314491.0,89672251.94000001,427898.0,49551461.96714286
2019-05-23,0.1688,0.2163,0.1585,0.1789,142239360.03,48216.0,84218905.29,0.19200000000000003,0.19788571428571428,0.1466,0.1884463227507902,0.1877109682003092,0.1664637703678876,62.59678379988088,0.23942343170603125,0.05377656829396876,0.011488567825872292,0.0022190100077765945,0.009269557818095698,0.05779999999999999,0.049471428571428576,-102469276.75000006,0.058800000000000005,89.71367974549311,-64.1146446800157,35.88535531998429,41.02866117000392,5.98341232227488,0.2285,0.2404,0.1636,0.1686,116173555.21,46093.0,69892057.1,-26.21444201312911,59.14201183431953,0.23605424467346636,0.052655755326533646,0.012133753207163922,-9.837944674733054e-05,0.012232132653911253,0.07680000000000001,0.04631428571428571,-244708636.78000006,0.0539,57.865168539325836,-68.15861798193953,31.84138201806046,55.75100235462722,0.22266666666666668,0.1979926455015804,0.19135714285714286,0.19064795760041228,0.144355,0.16515469356450735,301629.0,95404552.11333334,462069.0,57677826.648571424
2019-05-24,0.1789,0.1855,0.1526,0.1585,69875445.41,25867.0,46496801.47,0.16866666666666666,0.1961142857142857,0.14831999999999998,0.1734731613753951,0.1804082261502319,0.1657053160471364,58.36897633304819,0.2406615764260181,0.055978423573981875,0.00922480642655979,0.0036201692915332337,0.005604637135026556,0.032899999999999985,0.05058571428571428,-172344722.16000006,0.015199999999999991,58.81763527054109,-74.46291041751115,25.537089582488854,31.087942306844536,-11.403018446059251,0.1688,0.2163,0.1585,0.1789,142239360.03,48216.0,84218905.29,5.98341232227488,62.59678379988088,0.23942343170603125,0.05377656829396876,0.011488567825872292,0.0022190100077765945,0.009269557818095698,0.05779999999999999,0.049471428571428576,-102469276.75000006,0.058800000000000005,89.71367974549311,-64.1146446800157,35.88535531998429,41.02866117000392,0.19200000000000003,0.1884463227507902,0.19788571428571428,0.1877109682003092,0.1466,0.1664637703678876,223765.0,88519654.60666668,490767.0,67193344.14857142
2019-05-25,0.158,0.19,0.1478,0.1777,100283057.11,36019.0,52672126.69,0.1717,0.19842857142857143,0.15111000000000002,0.17558658068769756,0.1797311696126739,0.16684766689979008,59.801762114537446,0.24346238919201668,0.05875761080798335,0.008877702123092024,0.004671675857844992,0.004206026265247032,0.042200000000000015,0.052335714285714284,-72061665.05000006,0.03059999999999999,66.8544600938967,-69.14670029424128,30.85329970575872,30.75858153607729,12.468354430379744,0.1789,0.1855,0.1526,0.1585,69875445.41,25867.0,46496801.47,-11.403018446059251,58.36897633304819,0.2406615764260181,0.055978423573981875,0.00922480642655979,0.0036201692915332337,0.005604637135026556,0.032899999999999985,0.05058571428571428,-172344722.16000006,0.015199999999999991,58.81763527054109,-74.46291041751115,25.537089582488854,31.087942306844536,0.16866666666666666,0.1734731613753951,0.1961142857142857,0.1804082261502319,0.14831999999999998,0.1657053160471364,120176.0,66869254.620000005,469480.0,69759523.09714286
2019-05-26,0.1777,0.2093,0.1615,0.1741,91490186.06,39037.0,41691300.41,0.1701,0.19388571428571427,0.153635,0.17484329034384877,0.17832337720950545,0.16753836529028626,58.28220858895706,0.24558098586012064,0.061689014139879345,0.008217404425240188,0.0053808215713240315,0.0028365828539161564,0.04780000000000001,0.05416428571428571,-163551851.11000007,0.04089999999999999,51.78727114210986,-73.6957474791758,26.3042525208242,27.564880603023923,-2.0258863252673,0.158,0.19,0.1478,0.1777,100283057.11,36019.0,52672126.69,12.468354430379744,59.801762114537446,0.24346238919201668,0.05875761080798335,0.008877702123092024,0.004671675857844992,0.004206026265247032,0.042200000000000015,0.052335714285714284,-72061665.05000006,0.03059999999999999,66.8544600938967,-69.14670029424128,30.85329970575872,30.75858153607729,0.1717,0.17558658068769756,0.19842857142857143,0.1797311696126739,0.15111000000000002,0.16684766689979008,110102.0,61129277.81666667,470686.0,74613806.62428571
2019-05-27,0.1738,0.1865,0.162,0.1697,51124673.08,24492.0,24350480.15,0.17383333333333337,0.17942857142857147,0.15655,0.1722716451719244,0.17616753290712908,0.16774423526263996,56.93512304250559,0.24653379971153888,0.06656620028846111,0.0072554343836156165,0.005755744133782349,0.0014996902498332675,0.024499999999999994,0.05459285714285715,-214676524.19000006,-0.0012000000000000066,41.29891756869275,-75.75757575757575,24.242424242424235,27.13332548966905,-2.359033371691611,0.1777,0.2093,0.1615,0.1741,91490186.06,39037.0,41691300.41,-2.0258863252673,58.28220858895706,0.24558098586012064,0.061689014139879345,0.008217404425240188,0.0053808215713240315,0.0028365828539161564,0.04780000000000001,0.05416428571428571,-163551851.11000007,0.04089999999999999,51.78727114210986,-73.6957474791758,26.3042525208242,27.564880603023923,0.1701,0.17484329034384877,0.19388571428571427,0.17832337720950545,0.153635,0.16753836529028626,100923.0,46953409.52333333,450768.0,73041827.17142858
2019-05-28,0.1696,0.2025,0.1693,0.1821,69507078.25,35341.0,34232823.17,0.1753,0.1728,0.160315,0.17718582258596222,0.17765064968034683,0.16911145095191232,55.59400230680508,0.24780080095318946,0.07282919904681058,0.007408244927828683,0.006086244292591616,0.0013220006352370672,0.03320000000000001,0.05518571428571429,-145169445.94000006,0.020600000000000007,27.07606420097697,-70.31181379007465,29.688186209925345,26.744954324391262,7.370283018867931,0.1738,0.1865,0.162,0.1697,51124673.08,24492.0,24350480.15,-2.359033371691611,56.93512304250559,0.24653379971153888,0.06656620028846111,0.0072554343836156165,0.005755744133782349,0.0014996902498332675,0.024499999999999994,0.05459285714285715,-214676524.19000006,-0.0012000000000000066,41.29891756869275,-75.75757575757575,24.242424242424235,27.13332548966905,0.17383333333333337,0.1722716451719244,0.17942857142857147,0.17616753290712908,0.15655,0.16774423526263996,99548.0,39571302.416666664,349180.0,61538524.64857143
2019-05-29,0.1821,0.1857,0.1666,0.1755,57063165.31,22789.0,26420589.42,0.17576666666666665,0.17378571428571427,0.164375,0.1763429112929811,0.17711298726026012,0.16971988419458733,54.06178489702517,0.24632275935410264,0.08242724064589733,0.0069170481185616695,0.006252405057785627,0.0006646430607760425,0.019100000000000006,0.05531428571428572,-202232611.25000006,-0.03040000000000001,19.306594153636958,-73.21036451471234,26.78963548528765,26.906748645879077,-3.624382207578266,0.1696,0.2025,0.1693,0.1821,69507078.25,35341.0,34232823.17,7.370283018867931,55.59400230680508,0.24780080095318946,0.07282919904681058,0.007408244927828683,0.006086244292591616,0.0013220006352370672,0.03320000000000001,0.05518571428571429,-145169445.94000006,0.020600000000000007,27.07606420097697,-70.31181379007465,29.688186209925345,26.744954324391262,0.1753,0.17718582258596222,0.1728,0.17765064968034683,0.160315,0.16911145095191232,98870.0,33424867.910000008,255065.0,50507784.89714285
2019-05-30,0.1756,0.1887,0.156,0.164,73852700.68,29949.0,36476502.81,0.1738666666666667,0.17165714285714287,0.16758499999999998,0.17017145564649055,0.1738347404451951,0.16917513331891235,54.43548387096774,0.2437046364457398,0.09146536355426016,0.005536001637015564,0.006109124373631614,-0.00057312273661605,0.03270000000000001,0.05557142857142857,-276085311.93000007,-0.10689999999999997,23.123123123123122,-78.26086956521738,21.73913043478261,26.0723173766652,-6.6059225512528466,0.1821,0.1857,0.1666,0.1755,57063165.31,22789.0,26420589.42,-3.624382207578266,54.06178489702517,0.24632275935410264,0.08242724064589733,0.0069170481185616695,0.006252405057785627,0.0006646430607760425,0.019100000000000006,0.05531428571428572,-202232611.25000006,-0.03040000000000001,19.306594153636958,-73.21036451471234,26.78963548528765,26.906748645879077,0.17576666666666665,0.1763429112929811,0.17378571428571427,0.17711298726026012,0.164375,0.16971988419458733,82622.0,28334630.913333338,231761.0,44297575.22857142
2019-05-31,0.1641,0.1968,0.1635,0.1828,73322193.25,34421.0,35501210.61,0.1741,0.17512857142857144,0.1714,0.1764857278232453,0.1760760553338963,0.17047273966949214,51.812366737739865,0.2420831030206767,0.10071689697932328,0.00589061192484111,0.006065421883873514,-0.00017480995903240357,0.033299999999999996,0.053271428571428574,-202763118.68000007,-0.04570000000000002,6.9631363370392,-81.99588477366255,18.00411522633745,22.177627048802567,11.395490554539911,0.1756,0.1887,0.156,0.164,73852700.68,29949.0,36476502.81,-6.6059225512528466,54.43548387096774,0.2437046364457398,0.09146536355426016,0.005536001637015564,0.006109124373631614,-0.00057312273661605,0.03270000000000001,0.05557142857142857,-276085311.93000007,-0.10689999999999997,23.123123123123122,-78.26086956521738,21.73913043478261,26.0723173766652,0.1738666666666667,0.17017145564649055,0.17165714285714287,0.1738347404451951,0.16758499999999998,0.16917513331891235,88079.0,32376638.466666672,213494.0,37477232.017142855
2019-06-01,0.1826,0.2036,0.1725,0.1939,94307860.09,39688.0,45675270.46,0.18023333333333333,0.17744285714285715,0.17536,0.18519286391162265,0.18053204150042224,0.1727039073200167,54.90909090909091,0.24138903348647406,0.10933096651352593,0.006986781102768902,0.0062496937276525924,0.0007370873751163095,0.031100000000000017,0.052814285714285716,-108455258.59000006,0.02529999999999999,20.061919504643953,-76.28600823045268,23.713991769547324,21.15241247688913,6.1883899233296695,0.1641,0.1968,0.1635,0.1828,73322193.25,34421.0,35501210.61,11.395490554539911,51.812366737739865,0.2420831030206767,0.10071689697932328,0.00589061192484111,0.006065421883873514,-0.00017480995903240357,0.033299999999999996,0.053271428571428574,-202763118.68000007,-0.04570000000000002,6.9631363370392,-81.99588477366255,18.00411522633745,22.177627048802567,0.1741,0.1764857278232453,0.17512857142857144,0.1760760553338963,0.1714,0.17047273966949214,87159.0,32799434.280000005,222048.0,35906433.32285714
2019-06-02,0.1939,0.2115,0.1826,0.2,47247676.38,29587.0,21039334.07,0.19223333333333334,0.18114285714285713,0.179355,0.19259643195581133,0.1853990311253167,0.1753035351943008,48.98868700719918,0.24081695999409555,0.11789304000590442,0.008252591357809008,0.006650273253683876,0.0016023181041251323,0.02889999999999998,0.05055714285714286,-61207582.21000006,0.021100000000000008,-2.865468674113647,-73.14814814814814,26.851851851851862,22.856652949245547,3.145951521402796,0.1826,0.2036,0.1725,0.1939,94307860.09,39688.0,45675270.46,6.1883899233296695,54.90909090909091,0.24138903348647406,0.10933096651352593,0.006986781102768902,0.0062496937276525924,0.0007370873751163095,0.031100000000000017,0.052814285714285716,-108455258.59000006,0.02529999999999999,20.061919504643953,-76.28600823045268,23.713991769547324,21.15241247688913,0.18023333333333333,0.18519286391162265,0.17744285714285715,0.18053204150042224,0.17536,0.1727039073200167,104058.0,39217661.293333344,225717.0,34906882.43285714
2019-06-03,0.1999,0.2005,0.174,0.1752,61362152.81,28475.0,27409643.41,0.1897,0.18192857142857144,0.18095,0.18389821597790568,0.18284927334398754,0.1752936746996055,30.97415506958251,0.24008390691784567,0.12181609308215433,0.007171928835600416,0.006754604370067184,0.0004173244655332319,0.026500000000000024,0.04373571428571429,-122569735.02000007,0.016699999999999993,-35.326688815060905,-85.90534979423869,14.094650205761319,21.553497942386837,-12.356178089044523,0.1939,0.2115,0.1826,0.2,47247676.38,29587.0,21039334.07,3.145951521402796,48.98868700719918,0.24081695999409555,0.11789304000590442,0.008252591357809008,0.006650273253683876,0.0016023181041251323,0.02889999999999998,0.05055714285714286,-61207582.21000006,0.021100000000000008,-2.865468674113647,-73.14814814814814,26.851851851851862,22.856652949245547,0.19223333333333334,0.19259643195581133,0.18114285714285713,0.1853990311253167,0.179355,0.1753035351943008,103696.0,34071938.38,216267.0,31956601.52714286
2019-06-04,0.1748,0.1821,0.1624,0.1762,75388705.57,32622.0,36502951.62,0.1838,0.18108571428571427,0.18240499999999998,0.18004910798895285,0.18118695500799067,0.17537999139488114,37.55354593050929,0.23942630626722844,0.12538369373277153,0.006323296616370322,0.006668342819327812,-0.0003450462029574901,0.019700000000000023,0.036178571428571435,-47181029.45000008,-0.0015000000000000013,-22.888402625820568,-69.3304535637149,30.6695464362851,23.872016164632765,0.8009153318077715,0.1999,0.2005,0.174,0.1752,61362152.81,28475.0,27409643.41,-12.356178089044523,30.97415506958251,0.24008390691784567,0.12181609308215433,0.007171928835600416,0.006754604370067184,0.0004173244655332319,0.026500000000000024,0.04373571428571429,-122569735.02000007,0.016699999999999993,-35.326688815060905,-85.90534979423869,14.094650205761319,21.553497942386837,0.1897,0.18389821597790568,0.18192857142857144,0.18284927334398754,0.18095,0.1752936746996055,97750.0,31374749.313333336,220250.0,32393624.85
2019-06-05,0.176,0.2173,0.1685,0.2049,136770343.87,61528.0,66443331.85,0.18543333333333334,0.18528571428571428,0.18599,0.19247455399447644,0.187115216255993,0.17819142078584482,60.145332588038,0.23884957165726456,0.13313042834273542,0.007875812152684375,0.006909836685999125,0.0009659754666852503,0.04879999999999998,0.03417857142857143,89589314.41999993,0.030799999999999994,21.530249110320288,-17.841726618705025,82.15827338129498,42.307490007780466,16.42045454545455,0.1748,0.1821,0.1624,0.1762,75388705.57,32622.0,36502951.62,0.8009153318077715,37.55354593050929,0.23942630626722844,0.12538369373277153,0.006323296616370322,0.006668342819327812,-0.0003450462029574901,0.019700000000000023,0.036178571428571435,-47181029.45000008,-0.0015000000000000013,-22.888402625820568,-69.3304535637149,30.6695464362851,23.872016164632765,0.1838,0.18004910798895285,0.18108571428571427,0.18118695500799067,0.18240499999999998,0.17537999139488114,90684.0,28317309.700000007,217531.0,32717928.914285712
2019-06-06,0.2047,0.2209,0.185,0.1981,104811482.6,48301.0,48872850.71,0.19306666666666664,0.19015714285714286,0.18735,0.19528727699723822,0.18986141219199476,0.18008747594909771,55.47320410490308,0.2399739689235159,0.13472603107648407,0.008459967491361409,0.007219862847071582,0.001240104644289827,0.035900000000000015,0.03261428571428572,-15222168.180000067,0.02840000000000001,10.732252655114593,-31.19015047879618,68.80984952120383,60.54588977959463,-3.224230581338542,0.176,0.2173,0.1685,0.2049,136770343.87,61528.0,66443331.85,16.42045454545455,60.145332588038,0.23884957165726456,0.13313042834273542,0.007875812152684375,0.006909836685999125,0.0009659754666852503,0.04879999999999998,0.03417857142857143,89589314.41999993,0.030799999999999994,21.530249110320288,-17.841726618705025,82.15827338129498,42.307490007780466,0.18543333333333334,0.19247455399447644,0.18528571428571428,0.187115216255993,0.18599,0.17819142078584482,122625.0,43451975.62666667,256270.0,38435463.547142856
2019-06-07,0.1981,0.218,0.1952,0.2075,50399926.66,23888.0,24620691.14,0.20350000000000001,0.19368571428571427,0.18965,0.2013936384986191,0.19427105914399606,0.18269819252537411,64.90267639902675,0.2415326408450133,0.13776735915498672,0.009571086716919058,0.007690107621041078,0.0018809790958779805,0.022799999999999987,0.031892857142857146,35177758.47999993,0.025399999999999978,30.9148264984227,-18.33105335157321,81.66894664842678,77.54568985030853,4.745078243311455,0.2047,0.2209,0.185,0.1981,104811482.6,48301.0,48872850.71,-3.224230581338542,55.47320410490308,0.2399739689235159,0.13472603107648407,0.008459967491361409,0.007219862847071582,0.001240104644289827,0.035900000000000015,0.03261428571428572,-15222168.180000067,0.02840000000000001,10.732252655114593,-31.19015047879618,68.80984952120383,60.54588977959463,0.19306666666666664,0.19528727699723822,0.19015714285714286,0.18986141219199476,0.18735,0.18008747594909771,142451.0,50606378.06,274622.0,40206370.39
2019-06-08,0.2067,0.2173,0.1971,0.2131,27439885.64,14765.0,14320146.75,0.20623333333333335,0.19642857142857142,0.19000999999999998,0.20724681924930954,0.19897829435799708,0.18559360276105277,61.73740053050398,0.24246416645937077,0.1375558335406292,0.010779273156123287,0.00830794072805752,0.0024713324280657666,0.020199999999999996,0.030321428571428576,62617644.11999993,0.03760000000000002,19.921215531795177,-12.01848998459168,87.98151001540833,79.48676872834632,3.0962747943880102,0.1981,0.218,0.1952,0.2075,50399926.66,23888.0,24620691.14,4.745078243311455,64.90267639902675,0.2415326408450133,0.13776735915498672,0.009571086716919058,0.007690107621041078,0.0018809790958779805,0.022799999999999987,0.031892857142857146,35177758.47999993,0.025399999999999978,30.9148264984227,-18.33105335157321,81.66894664842678,77.54568985030853,0.20350000000000001,0.2013936384986191,0.19368571428571427,0.19427105914399606,0.18965,0.18269819252537411,133717.0,46645624.56666667,264089.0,38652010.46571428
2019-06-09,0.2135,0.2361,0.1972,0.2048,123931742.84,44642.0,63081971.68,0.20846666666666666,0.19711428571428574,0.186705,0.20602340962465476,0.2004337207684978,0.18742278345047633,59.871382636655945,0.22377230578143967,0.14963769421856035,0.010940908991327492,0.008834534380711514,0.0021063746106159773,0.03890000000000002,0.02968571428571429,-61314098.72000007,0.0408,17.633543940264218,-39.07615480649188,60.92384519350812,76.85810061911441,-4.074941451990625,0.2067,0.2173,0.1971,0.2131,27439885.64,14765.0,14320146.75,3.0962747943880102,61.73740053050398,0.24246416645937077,0.1375558335406292,0.010779273156123287,0.00830794072805752,0.0024713324280657666,0.020199999999999996,0.030321428571428576,62617644.11999993,0.03760000000000002,19.921215531795177,-12.01848998459168,87.98151001540833,79.48676872834632,0.20623333333333335,0.20724681924930954,0.19642857142857142,0.19897829435799708,0.19000999999999998,0.18559360276105277,86954.0,29271229.533333343,239166.0,34172707.07857143
2019-06-10,0.205,0.254,0.1952,0.2436,168069851.71,54063.0,82443851.63,0.2205,0.20688571428571428,0.18746000000000002,0.22481170481232737,0.21122529057637335,0.19277299455043095,69.45760926803581,0.22851259271253238,0.14640740728746765,0.014038020725560652,0.009875231649681342,0.00416278907587931,0.05879999999999999,0.03213571428571429,106755752.98999994,0.06080000000000002,43.547436652916936,-10.612244897959176,89.38775510204083,79.4310367703191,18.829268292682936,0.2135,0.2361,0.1972,0.2048,123931742.84,44642.0,63081971.68,-4.074941451990625,59.871382636655945,0.22377230578143967,0.14963769421856035,0.010940908991327492,0.008834534380711514,0.0021063746106159773,0.03890000000000002,0.02968571428571429,-61314098.72000007,0.0408,17.633543940264218,-39.07615480649188,60.92384519350812,76.85810061911441,0.20846666666666666,0.20602340962465476,0.19711428571428574,0.2004337207684978,0.186705,0.18742278345047633,83295.0,34007603.190000005,254221.0,40178798.16571428
2019-06-11,0.2439,0.2539,0.2236,0.2519,114110261.31,48652.0,54251224.96,0.23343333333333335,0.21769999999999998,0.19162500000000002,0.2383558524061637,0.22139396793228,0.1984041379265804,68.78363832077503,0.24073308165883228,0.14251691834116775,0.016966663585993358,0.011293518036943746,0.005673145549049612,0.03030000000000002,0.03192857142857143,220866014.29999995,0.058000000000000024,38.330587589236686,-2.1428571428571335,97.85714285714286,82.7229143842306,3.280032800328006,0.205,0.254,0.1952,0.2436,168069851.71,54063.0,82443851.63,18.829268292682936,69.45760926803581,0.22851259271253238,0.14640740728746765,0.014038020725560652,0.009875231649681342,0.00416278907587931,0.05879999999999999,0.03213571428571429,106755752.98999994,0.06080000000000002,43.547436652916936,-10.612244897959176,89.38775510204083,79.4310367703191,0.2205,0.22481170481232737,0.20688571428571428,0.21122529057637335,0.18746000000000002,0.19277299455043095,113470.0,53281990.02,279809.0,48040827.91142857
2019-06-12,0.2519,0.2559,0.2263,0.2365,112776518.47,37769.0,53016315.19,0.244,0.22221428571428573,0.194505,0.23742792620308184,0.22517047594920997,0.2020323152669061,65.67317574511819,0.24710291770943438,0.14190708229056564,0.017839342025523314,0.01260268283465966,0.005236659190863654,0.029600000000000015,0.03267857142857144,108089495.82999995,0.03649999999999998,34.75783475783476,-19.419419419419444,80.58058058058054,89.27515951325476,-6.11353711790394,0.2439,0.2539,0.2236,0.2519,114110261.31,48652.0,54251224.96,3.280032800328006,68.78363832077503,0.24073308165883228,0.14251691834116775,0.016966663585993358,0.011293518036943746,0.005673145549049612,0.03030000000000002,0.03192857142857143,220866014.29999995,0.058000000000000024,38.330587589236686,-2.1428571428571335,97.85714285714286,82.7229143842306,0.23343333333333335,0.2383558524061637,0.21769999999999998,0.22139396793228,0.19162500000000002,0.1984041379265804,147357.0,66592349.42333334,295839.0,50576295.53142857
2019-06-13,0.2364,0.2386,0.2123,0.2137,86282637.7,36057.0,38935477.34,0.23403333333333332,0.22444285714285717,0.197265,0.22556396310154092,0.2223028569619075,0.20314352333672456,62.068965517241374,0.247654651193161,0.146875348806839,0.016500963685832842,0.013382339004894297,0.0031186246809385455,0.026300000000000018,0.032221428571428574,21806858.12999995,0.038500000000000006,30.30487804878048,-45.13368983957219,54.8663101604278,77.76801119938375,-9.602368866328256,0.2519,0.2559,0.2263,0.2365,112776518.47,37769.0,53016315.19,-6.11353711790394,65.67317574511819,0.24710291770943438,0.14190708229056564,0.017839342025523314,0.01260268283465966,0.005236659190863654,0.029600000000000015,0.03267857142857144,108089495.82999995,0.03649999999999998,34.75783475783476,-19.419419419419444,80.58058058058054,89.27515951325476,0.244,0.23742792620308184,0.22221428571428573,0.22517047594920997,0.194505,0.2020323152669061,140484.0,63237130.593333334,272080.0,48658150.294285715
2019-06-14,0.2138,0.2171,0.1865,0.1961,74346679.56,30303.0,34509141.41,0.21543333333333334,0.22281428571428571,0.198185,0.21083198155077046,0.21575214272143062,0.20247271159036984,53.248656570591116,0.24773549630639974,0.14863450369360026,0.013860342893359329,0.013477939782587305,0.0003824031107720234,0.03059999999999999,0.03202857142857143,-52539821.43000005,0.0199,7.275711159737419,-63.95721925133691,36.0427807486631,57.16322382989049,-8.27876520112254,0.2364,0.2386,0.2123,0.2137,86282637.7,36057.0,38935477.34,-9.602368866328256,62.068965517241374,0.247654651193161,0.146875348806839,0.016500963685832842,0.013382339004894297,0.0031186246809385455,0.026300000000000018,0.032221428571428574,21806858.12999995,0.038500000000000006,30.30487804878048,-45.13368983957219,54.8663101604278,77.76801119938375,0.23403333333333332,0.22556396310154092,0.22444285714285717,0.2223028569619075,0.197265,0.20314352333672456,122478.0,48734339.163333334,259836.0,47238525.52714286
2019-06-15,0.1958,0.2158,0.1934,0.2031,82551173.74,29515.0,41807812.21,0.2043,0.2213857142857143,0.199635,0.20696599077538524,0.21258910704107298,0.20253245334366793,52.293120638085746,0.24789845571853247,0.15137154428146754,0.012191932381952875,0.01322073830246042,-0.0010288059205075459,0.022400000000000003,0.03140714285714286,30011352.309999943,-0.001799999999999996,4.744713769984532,-56.470588235294116,43.529411764705884,44.81283422459894,3.7282941777323804,0.2138,0.2171,0.1865,0.1961,74346679.56,30303.0,34509141.41,-8.27876520112254,53.248656570591116,0.24773549630639974,0.14863450369360026,0.013860342893359329,0.013477939782587305,0.0003824031107720234,0.03059999999999999,0.03202857142857143,-52539821.43000005,0.0199,7.275711159737419,-63.95721925133691,36.0427807486631,57.16322382989049,0.21543333333333334,0.21083198155077046,0.22281428571428571,0.21575214272143062,0.198185,0.20247271159036984,104129.0,42153644.64666667,266251.0,48651161.279999994
2019-06-16,0.2034,0.2038,0.1943,0.2005,57100137.6,22305.0,27645021.33,0.1999,0.22077142857142856,0.20117500000000002,0.20373299538769263,0.20956683028080472,0.20233888635855668,50.12683916793505,0.24733645008212174,0.1550135499178783,0.01053842634159799,0.012684275910287934,-0.002145849568689944,0.009500000000000008,0.030021428571428577,-27088785.29000006,0.0024000000000000132,0.24999999999999467,-59.251336898395714,40.748663101604286,40.10695187165776,-1.4257620452310649,0.1958,0.2158,0.1934,0.2031,82551173.74,29515.0,41807812.21,3.7282941777323804,52.293120638085746,0.24789845571853247,0.15137154428146754,0.012191932381952875,0.01322073830246042,-0.0010288059205075459,0.022400000000000003,0.03140714285714286,30011352.309999943,-0.001799999999999996,4.744713769984532,-56.470588235294116,43.529411764705884,44.81283422459894,0.2043,0.20696599077538524,0.2213857142857143,0.21258910704107298,0.199635,0.20253245334366793,95875.0,38417476.98666667,281001.0,52577970.63142858
2019-06-17,0.2004,0.225,0.1963,0.198,82965791.14,30614.0,42777221.51,0.20053333333333334,0.21425714285714287,0.20196999999999998,0.20086649769384632,0.20667512271060356,0.2019256590863132,56.52173913043479,0.24728820129286969,0.15665179870713028,0.008923418175033865,0.011932104363237122,-0.003008686188203257,0.028700000000000003,0.030178571428571433,-110054576.43000007,-0.00949999999999998,13.013698630136993,-61.92513368983956,38.07486631016044,40.784313725490215,-1.1976047904191545,0.2034,0.2038,0.1943,0.2005,57100137.6,22305.0,27645021.33,-1.4257620452310649,50.12683916793505,0.24733645008212174,0.1550135499178783,0.01053842634159799,0.012684275910287934,-0.002145849568689944,0.009500000000000008,0.030021428571428577,-27088785.29000006,0.0024000000000000132,0.24999999999999467,-59.251336898395714,40.748663101604286,40.10695187165776,0.1999,0.20373299538769263,0.22077142857142856,0.20956683028080472,0.20117500000000002,0.20233888635855668,82123.0,34653991.65,258664.0,47515549.15285714
2019-06-18,0.1976,0.211,0.1932,0.2084,67971296.12,21502.0,33308257.61,0.2023,0.20804285714285717,0.20361500000000002,0.20463324884692316,0.20710634203295267,0.2025422629828548,58.74049945711184,0.2472446024566615,0.15998539754333854,0.008386036640830818,0.011222890818755863,-0.0028368541779250443,0.017799999999999983,0.030042857142857145,-42083280.31000006,-0.00470000000000001,18.274687854710557,-54.34782608695653,45.65217391304346,41.4919011082694,5.4655870445344155,0.2004,0.225,0.1963,0.198,82965791.14,30614.0,42777221.51,-1.1976047904191545,56.52173913043479,0.24728820129286969,0.15665179870713028,0.008923418175033865,0.011932104363237122,-0.003008686188203257,0.028700000000000003,0.030178571428571433,-110054576.43000007,-0.00949999999999998,13.013698630136993,-61.92513368983956,38.07486631016044,40.784313725490215,0.20053333333333334,0.20086649769384632,0.21425714285714287,0.20667512271060356,0.20196999999999998,0.2019256590863132,82434.0,37410018.35,235215.0,41848887.70714285
2019-06-19,0.2084,0.217,0.2006,0.2024,78364192.17,23594.0,38561435.41,0.20293333333333333,0.20317142857142856,0.20553500000000002,0.20351662442346158,0.2059297565247145,0.20252871412734483,49.22600619195046,0.24500577666484816,0.1660642233351519,0.007390811374536926,0.010456474929912075,-0.0030656635553751484,0.016399999999999998,0.02772857142857143,-120447472.48000006,-0.0024000000000000132,-1.2201073694485087,-75.45839210155148,24.54160789844851,36.08954937388415,-2.879078694817661,0.1976,0.211,0.1932,0.2084,67971296.12,21502.0,33308257.61,5.4655870445344155,58.74049945711184,0.2472446024566615,0.15998539754333854,0.008386036640830818,0.011222890818755863,-0.0028368541779250443,0.017799999999999983,0.030042857142857145,-42083280.31000006,-0.00470000000000001,18.274687854710557,-54.34782608695653,45.65217391304346,41.4919011082694,0.2023,0.20463324884692316,0.20804285714285717,0.20710634203295267,0.20361500000000002,0.2025422629828548,74421.0,34576833.48333334,208065.0,38857035.22857142
2019-06-20,0.2029,0.2047,0.1892,0.1915,68655287.53,20264.0,34152330.37,0.20076666666666668,0.19999999999999998,0.20597,0.1975083122117308,0.2023223173935359,0.20147836040093103,48.007246376811594,0.24456790558812067,0.1673720944118793,0.005657335039126743,0.009496646951755009,-0.003839311912628266,0.015499999999999986,0.026271428571428574,-189102760.01000005,-0.05210000000000001,-3.3316506814739966,-92.79538904899135,7.20461095100865,25.79946425416688,-5.618531296205024,0.2084,0.217,0.2006,0.2024,78364192.17,23594.0,38561435.41,-2.879078694817661,49.22600619195046,0.24500577666484816,0.1660642233351519,0.007390811374536926,0.010456474929912075,-0.0030656635553751484,0.016399999999999998,0.02772857142857143,-120447472.48000006,-0.0024000000000000132,-1.2201073694485087,-75.45839210155148,24.54160789844851,36.08954937388415,0.20293333333333333,0.20351662442346158,0.20317142857142856,0.2059297565247145,0.20553500000000002,0.20252871412734483,75710.0,38215638.17666667,193890.0,36792052.40285714
2019-06-21,0.1914,0.1953,0.1764,0.1803,59644404.53,19131.0,30501369.67,0.1914,0.19774285714285716,0.20529000000000003,0.1889041561058654,0.19681673804515193,0.19946137369608044,41.87574671445639,0.2452388040793267,0.16534119592067337,0.0033412799610803012,0.008265573553620068,-0.004924293592539767,0.0189,0.025992857142857144,-248747164.54000005,-0.07160000000000002,-13.108433734939762,-95.09433962264153,4.905660377358473,12.217293075605221,-5.799373040752351,0.2029,0.2047,0.1892,0.1915,68655287.53,20264.0,34152330.37,-5.618531296205024,48.007246376811594,0.24456790558812067,0.1673720944118793,0.005657335039126743,0.009496646951755009,-0.003839311912628266,0.015499999999999986,0.026271428571428574,-189102760.01000005,-0.05210000000000001,-3.3316506814739966,-92.79538904899135,7.20461095100865,25.79946425416688,0.20076666666666668,0.1975083122117308,0.19999999999999998,0.2023223173935359,0.20597,0.20147836040093103,65360.0,35340674.46333334,178097.0,36108745.69285714
2019-06-22,0.1807,0.1898,0.1734,0.1869,73545943.15,24107.0,34624790.68,0.18623333333333333,0.19542857142857142,0.20463499999999998,0.1879020780529327,0.19433755353386395,0.19826505239169184,42.220902612826606,0.24537082543270988,0.16389917456729008,0.0020151253562168125,0.007015483914139417,-0.005000358557922605,0.016399999999999998,0.025721428571428572,-175201221.39000005,-0.04959999999999998,-12.294697325199433,-83.63636363636363,16.363636363636374,9.491302564001176,3.4311012728278976,0.1914,0.1953,0.1764,0.1803,59644404.53,19131.0,30501369.67,-5.799373040752351,41.87574671445639,0.2452388040793267,0.16534119592067337,0.0033412799610803012,0.008265573553620068,-0.004924293592539767,0.0189,0.025992857142857144,-248747164.54000005,-0.07160000000000002,-13.108433734939762,-95.09433962264153,4.905660377358473,12.217293075605221,0.1914,0.1889041561058654,0.19774285714285716,0.19681673804515193,0.20529000000000003,0.19946137369608044,62989.0,34405045.15,166925.0,35536206.87285714
2019-06-23,0.187,0.1921,0.1757,0.1766,68512795.88,18289.0,35315634.44,0.1812666666666667,0.19201428571428572,0.204705,0.18225103902646633,0.18990316515039796,0.19620171406867357,41.72535211267606,0.24523213061381818,0.1641778693861818,0.00013149852498509085,0.005638686836308552,-0.0055071883113234615,0.016399999999999998,0.024114285714285717,-243714017.27000004,-0.037099999999999994,-13.76953125,-96.12121212121211,3.8787878787878878,8.382694873260922,-5.561497326203205,0.1807,0.1898,0.1734,0.1869,73545943.15,24107.0,34624790.68,3.4311012728278976,42.220902612826606,0.24537082543270988,0.16389917456729008,0.0020151253562168125,0.007015483914139417,-0.005000358557922605,0.016399999999999998,0.025721428571428572,-175201221.39000005,-0.04959999999999998,-12.294697325199433,-83.63636363636363,16.363636363636374,9.491302564001176,0.18623333333333333,0.1879020780529327,0.19542857142857142,0.19433755353386395,0.20463499999999998,0.19826505239169184,63502.0,33092830.240000006,161517.0,34510060.94
2019-06-24,0.1767,0.1823,0.1662,0.169,62445524.83,17584.0,32232990.61,0.1775,0.1878714285714286,0.204345,0.17562551951323319,0.18467737386279848,0.1936110746335618,23.204022988505756,0.246049094207694,0.162640905792306,-0.00195204384734729,0.0041205406995773845,-0.006072584546924675,0.016100000000000003,0.02106428571428572,-306159542.1,-0.027099999999999985,-30.623973727422005,-96.87848383500554,3.1215161649944525,7.787980135806247,-4.357668364459527,0.187,0.1921,0.1757,0.1766,68512795.88,18289.0,35315634.44,-5.561497326203205,41.72535211267606,0.24523213061381818,0.1641778693861818,0.00013149852498509085,0.005638686836308552,-0.0055071883113234615,0.016399999999999998,0.024114285714285717,-243714017.27000004,-0.037099999999999994,-13.76953125,-96.12121212121211,3.8787878787878878,8.382694873260922,0.1812666666666667,0.18225103902646633,0.19201428571428572,0.18990316515039796,0.204705,0.19620171406867357,61527.0,33480598.26333334,157501.0,35605862.81285714
2019-06-25,0.1695,0.1696,0.1617,0.1625,58591942.12,17455.0,32195963.54,0.16936666666666667,0.18131428571428573,0.20222500000000002,0.1690627597566166,0.17913303039709885,0.19064811514465116,17.467248908296952,0.24792921493864545,0.15652078506135458,-0.004080721844504032,0.002480288190761101,-0.006561010035265133,0.00789999999999999,0.019464285714285715,-364751484.22,-0.0406,-35.49027391822152,-99.15074309978769,0.849256900212309,2.6165203146648923,-4.129793510324487,0.1767,0.1823,0.1662,0.169,62445524.83,17584.0,32232990.61,-4.357668364459527,23.204022988505756,0.246049094207694,0.162640905792306,-0.00195204384734729,0.0041205406995773845,-0.006072584546924675,0.016100000000000003,0.02106428571428572,-306159542.1,-0.027099999999999985,-30.623973727422005,-96.87848383500554,3.1215161649944525,7.787980135806247,0.1775,0.17562551951323319,0.1878714285714286,0.18467737386279848,0.204345,0.1936110746335618,59980.0,34057805.24333334,144471.0,34099544.11285714
2019-06-26,0.1623,0.1644,0.1414,0.1504,63275060.57,26204.0,33147162.25,0.16063333333333332,0.17388571428571428,0.19984,0.15973137987830832,0.17194977279782414,0.18681496132135103,17.897091722595093,0.2510921280687832,0.14858787193121678,-0.00666722771869227,0.0006507850088704268,-0.007318012727562697,0.022999999999999993,0.01899285714285714,-428026544.79,-0.050100000000000006,-36.40591966173361,-90.74074074074073,9.259259259259267,4.410010774822019,-7.332101047443003,0.1695,0.1696,0.1617,0.1625,58591942.12,17455.0,32195963.54,-4.129793510324487,17.467248908296952,0.24792921493864545,0.15652078506135458,-0.004080721844504032,0.002480288190761101,-0.006561010035265133,0.00789999999999999,0.019464285714285715,-364751484.22,-0.0406,-35.49027391822152,-99.15074309978769,0.849256900212309,2.6165203146648923,0.16936666666666667,0.1690627597566166,0.18131428571428573,0.17913303039709885,0.20222500000000002,0.19064811514465116,53328.0,33248196.19666667,140424.0,33940644.95999999
2019-06-27,0.1505,0.1667,0.1449,0.1506,43499951.6,26195.0,20876485.8,0.1545,0.16804285714285716,0.196995,0.15516568993915417,0.16661232959836814,0.1833659173859843,21.704035874439484,0.2525898303162691,0.14140016968373095,-0.008601758215920213,-0.0011997236360877012,-0.007402034579832512,0.021799999999999986,0.018671428571428568,-384526593.19,-0.0474,-29.527374824520347,-88.99521531100477,11.004784688995231,7.037766949488945,0.06644518272426361,0.1623,0.1644,0.1414,0.1504,63275060.57,26204.0,33147162.25,-7.332101047443003,17.897091722595093,0.2510921280687832,0.14858787193121678,-0.00666722771869227,0.0006507850088704268,-0.007318012727562697,0.022999999999999993,0.01899285714285714,-428026544.79,-0.050100000000000006,-36.40591966173361,-90.74074074074073,9.259259259259267,4.410010774822019,0.16063333333333332,0.15973137987830832,0.17388571428571428,0.17194977279782414,0.19984,0.18681496132135103,61243.0,32525372.133333337,143034.0,33167177.365714286
2019-06-28,0.1507,0.156,0.1426,0.1447,36872296.35,23704.0,16184554.69,0.14856666666666665,0.16295714285714286,0.193575,0.1499328449695771,0.16113424719877611,0.17968344906350958,24.248496993988,0.25326313247116006,0.13388686752883994,-0.010490045548894572,-0.0030577880186490754,-0.007432257530245496,0.013399999999999995,0.01744285714285714,-421398889.54,-0.0637,-26.21111677715452,-96.05263157894737,3.947368421052628,8.070470789769052,-3.9814200398142043,0.1505,0.1667,0.1449,0.1506,43499951.6,26195.0,20876485.8,0.06644518272426361,21.704035874439484,0.2525898303162691,0.14140016968373095,-0.008601758215920213,-0.0011997236360877012,-0.007402034579832512,0.021799999999999986,0.018671428571428568,-384526593.19,-0.0474,-29.527374824520347,-88.99521531100477,11.004784688995231,7.037766949488945,0.1545,0.15516568993915417,0.16804285714285716,0.16661232959836814,0.196995,0.1833659173859843,69854.0,28739870.530000005,148965.0,31270628.141428567
2019-06-29,0.1452,0.172,0.142,0.1633,52865317.74,31030.0,26333275.6,0.15286666666666668,0.15958571428571428,0.1915,0.15661642248478855,0.1616756853990821,0.17812312058127058,32.136445242369845,0.25241782212646474,0.13058217787353527,-0.01036616758414352,-0.004519463931747965,-0.005846703652395556,0.03,0.01798571428571428,-368533571.8,-0.039099999999999996,-19.596258000984733,-73.80382775119617,26.19617224880383,13.716108452950571,12.465564738292015,0.1507,0.156,0.1426,0.1447,36872296.35,23704.0,16184554.69,-3.9814200398142043,24.248496993988,0.25326313247116006,0.13388686752883994,-0.010490045548894572,-0.0030577880186490754,-0.007432257530245496,0.013399999999999995,0.01744285714285714,-421398889.54,-0.0637,-26.21111677715452,-96.05263157894737,3.947368421052628,8.070470789769052,0.14856666666666665,0.1499328449695771,0.16295714285714286,0.16113424719877611,0.193575,0.17968344906350958,76103.0,23402734.24666667,153538.0,29225368.85857143
2019-06-30,0.1632,0.1873,0.1519,0.1527,73026885.15,38870.0,34439744.64,0.15356666666666666,0.15617142857142857,0.186955,0.15465821124239426,0.1594317640493116,0.17570187100210194,29.983249581239534,0.24500225751715737,0.12890774248284265,-0.010996563280316979,-0.005814883801461768,-0.0051816794788552105,0.03539999999999999,0.019835714285714283,-441560456.95000005,-0.0388,-23.840399002493772,-86.48325358851675,13.516746411483258,14.553429027113248,-6.43382352941177,0.1452,0.172,0.142,0.1633,52865317.74,31030.0,26333275.6,12.465564738292015,32.136445242369845,0.25241782212646474,0.13058217787353527,-0.01036616758414352,-0.004519463931747965,-0.005846703652395556,0.03,0.01798571428571428,-368533571.8,-0.039099999999999996,-19.596258000984733,-73.80382775119617,26.19617224880383,13.716108452950571,0.15286666666666668,0.15661642248478855,0.15958571428571428,0.1616756853990821,0.1915,0.17812312058127058,80929.0,21131438.696666673,160461.0,28040866.704285715
2019-07-01,0.1526,0.1647,0.1464,0.1629,40932237.1,28162.0,20103467.94,0.15963333333333332,0.1553,0.18250499999999997,0.15877910562119713,0.16029882303698367,0.17448264519237794,36.19197482297403,0.2327041601942757,0.13230583980572425,-0.010551470868141566,-0.006762201214797727,-0.0037892696533438387,0.01830000000000001,0.019092857142857137,-400628219.85,-0.0174,-17.727272727272737,-71.56084656084657,28.439153439153426,22.717357366480183,6.749672346002606,0.1632,0.1873,0.1519,0.1527,73026885.15,38870.0,34439744.64,-6.43382352941177,29.983249581239534,0.24500225751715737,0.12890774248284265,-0.010996563280316979,-0.005814883801461768,-0.0051816794788552105,0.03539999999999999,0.019835714285714283,-441560456.95000005,-0.0388,-23.840399002493772,-86.48325358851675,13.516746411483258,14.553429027113248,0.15356666666666666,0.15465821124239426,0.15617142857142857,0.1594317640493116,0.186955,0.17570187100210194,93604.0,25652524.976666674,181042.0,27915739.59
2019-07-02,0.1629,0.1651,0.1455,0.1481,37729114.21,25773.0,16874840.91,0.15456666666666666,0.15324285714285715,0.178085,0.15343955281059857,0.15724911727773777,0.17197001231691336,27.07224334600761,0.2236164940164328,0.1325535059835672,-0.011263133840162087,-0.0076623877398706,-0.003600746100291487,0.019600000000000006,0.019221428571428566,-438357334.06,-0.0388,-28.934740882917463,-91.13756613756611,8.862433862433877,16.93944457102353,-9.085328422344984,0.1526,0.1647,0.1464,0.1629,40932237.1,28162.0,20103467.94,6.749672346002606,36.19197482297403,0.2327041601942757,0.13230583980572425,-0.010551470868141566,-0.006762201214797727,-0.0037892696533438387,0.01830000000000001,0.019092857142857137,-400628219.85,-0.0174,-17.727272727272737,-71.56084656084657,28.439153439153426,22.717357366480183,0.15963333333333332,0.15877910562119713,0.1553,0.16029882303698367,0.18250499999999997,0.17448264519237794,98062.0,26958829.393333342,191620.0,26182950.63714286
2019-07-03,0.1482,0.157,0.1432,0.1484,32905523.67,24353.0,15454255.57,0.15313333333333332,0.15295714285714285,0.17482,0.1509197764052993,0.15503683795830334,0.16972524923911209,28.537360890302082,0.21894153549840353,0.13069846450159647,-0.01166841811920763,-0.008463593815738007,-0.003204824303469623,0.013800000000000007,0.019035714285714284,-405451810.39,-0.028200000000000003,-26.679841897233203,-88.94154818325434,11.058451816745666,16.120013039444334,0.13495276653171778,0.1629,0.1651,0.1455,0.1481,37729114.21,25773.0,16874840.91,-9.085328422344984,27.07224334600761,0.2236164940164328,0.1325535059835672,-0.011263133840162087,-0.0076623877398706,-0.003600746100291487,0.019600000000000006,0.019221428571428566,-438357334.06,-0.0388,-28.934740882917463,-91.13756613756611,8.862433862433877,16.93944457102353,0.15456666666666666,0.15343955281059857,0.15324285714285715,0.15724911727773777,0.178085,0.17197001231691336,92805.0,23806017.830000002,199938.0,23994218.832857143
2019-07-04,0.1485,0.1492,0.1329,0.1362,25687477.79,15267.0,11780852.98,0.14423333333333332,0.1509,0.171825,0.14355988820264964,0.1503276284687275,0.16653236835919666,28.245476003147132,0.21795100020310548,0.12569899979689453,-0.012826194484622716,-0.00933611394951495,-0.0034900805351077667,0.01630000000000001,0.01909285714285714,-431139288.18,-0.032800000000000024,-28.877284595300267,-94.71153846153847,5.288461538461534,8.403115739213701,-8.282828282828286,0.1482,0.157,0.1432,0.1484,32905523.67,24353.0,15454255.57,0.13495276653171778,28.537360890302082,0.21894153549840353,0.13069846450159647,-0.01166841811920763,-0.008463593815738007,-0.003204824303469623,0.013800000000000007,0.019035714285714284,-405451810.39,-0.028200000000000003,-26.679841897233203,-88.94154818325434,11.058451816745666,16.120013039444334,0.15313333333333332,0.1509197764052993,0.15295714285714285,0.15503683795830334,0.17482,0.16972524923911209,78288.0,17477521.47333334,198087.0,21466660.735714283
2019-07-05,0.1358,0.1526,0.1354,0.1457,15177688.9,10996.0,7993808.42,0.14343333333333333,0.15104285714285717,0.16895500000000002,0.14462994410132482,0.14917072135154563,0.16454833327736842,36.20414673046253,0.21401820590366202,0.12389179409633802,-0.012829282013257087,-0.010034747562263378,-0.002794534450993709,0.01720000000000002,0.018971428571428573,-415961599.28000003,-0.01680000000000001,-19.19023849140321,-78.37837837837837,21.62162162162163,12.656178325609622,7.2901325478645,0.1485,0.1492,0.1329,0.1362,25687477.79,15267.0,11780852.98,-8.282828282828286,28.245476003147132,0.21795100020310548,0.12569899979689453,-0.012826194484622716,-0.00933611394951495,-0.0034900805351077667,0.01630000000000001,0.01909285714285714,-431139288.18,-0.032800000000000024,-28.877284595300267,-94.71153846153847,5.288461538461534,8.403115739213701,0.14423333333333332,0.14355988820264964,0.1509,0.1503276284687275,0.171825,0.16653236835919666,65393.0,14703316.486666672,187159.0,20167284.61857143
2019-07-06,0.1462,0.151,0.1401,0.1418,12829281.66,9012.0,5879788.42,0.14123333333333332,0.1479714285714286,0.16602,0.14321497205066241,0.14732804101365923,0.16238182534619047,31.62184189079055,0.2100673716283784,0.12197262837162161,-0.012996609484258265,-0.010627119946662357,-0.0023694895375959077,0.010899999999999993,0.018578571428571427,-428790880.94000006,-0.008599999999999997,-24.130551096843234,-84.96621621621618,15.033783783783816,13.981288981289003,-3.009575923392604,0.1358,0.1526,0.1354,0.1457,15177688.9,10996.0,7993808.42,7.2901325478645,36.20414673046253,0.21401820590366202,0.12389179409633802,-0.012829282013257087,-0.010034747562263378,-0.002794534450993709,0.01720000000000002,0.018971428571428573,-415961599.28000003,-0.01680000000000001,-19.19023849140321,-78.37837837837837,21.62162162162163,12.656178325609622,0.14343333333333333,0.14462994410132482,0.15104285714285717,0.14917072135154563,0.16895500000000002,0.16454833327736842,50616.0,11742972.323333338,174451.0,18997178.00857143
2019-07-07,0.1418,0.1486,0.1393,0.1451,9220530.58,7580.0,4814344.97,0.1442,0.14688571428571429,0.163375,0.1441574860253312,0.14677103076024442,0.16073593721798185,36.387208297320655,0.20565431558476138,0.12109568441523862,-0.012716349132657984,-0.011044965783861483,-0.0016713833487965006,0.009300000000000003,0.01807142857142857,-419570350.3600001,-0.005500000000000005,-17.836919592298983,-77.57352941176467,22.426470588235322,19.693958664546933,2.3272214386459784,0.1462,0.151,0.1401,0.1418,12829281.66,9012.0,5879788.42,-3.009575923392604,31.62184189079055,0.2100673716283784,0.12197262837162161,-0.012996609484258265,-0.010627119946662357,-0.0023694895375959077,0.010899999999999993,0.018578571428571427,-428790880.94000006,-0.008599999999999997,-24.130551096843234,-84.96621621621618,15.033783783783816,13.981288981289003,0.14123333333333332,0.14321497205066241,0.1479714285714286,0.14732804101365923,0.16602,0.16238182534619047,35275.0,8551483.273333339,152433.0,16075251.268571427
2019-07-08,0.1451,0.1479,0.1334,0.1358,11296853.55,8386.0,3909006.88,0.1409,0.14301428571428573,0.159745,0.1399787430126656,0.14402827307018332,0.15836108605436452,35.8603066439523,0.19802488203248692,0.1214651179675131,-0.01309373661635968,-0.011454719950361123,-0.0016390166659985567,0.014500000000000013,0.01795714285714286,-430867203.9100001,-0.008899999999999991,-19.64497041420119,-94.6691176470588,5.3308823529412015,14.263712241653456,-6.40937284631289,0.1418,0.1486,0.1393,0.1451,9220530.58,7580.0,4814344.97,2.3272214386459784,36.387208297320655,0.20565431558476138,0.12109568441523862,-0.012716349132657984,-0.011044965783861483,-0.0016713833487965006,0.009300000000000003,0.01807142857142857,-419570350.3600001,-0.005500000000000005,-17.836919592298983,-77.57352941176467,22.426470588235322,19.693958664546933,0.1442,0.1441574860253312,0.14688571428571429,0.14677103076024442,0.163375,0.16073593721798185,27588.0,6229313.936666671,121143.0,11843051.315714287
2019-07-09,0.1358,0.1364,0.1287,0.1291,11751196.89,8103.0,5217289.54,0.1366666666666667,0.1403,0.15608000000000002,0.1345393715063328,0.1402962048026375,0.15557431595394886,35.799319727891145,0.19105798405313149,0.12110201594686856,-0.013774667133603341,-0.011918709387009568,-0.001855957746593773,0.007699999999999985,0.017942857142857142,-442618400.8000001,-0.03420000000000001,-20.553846153846155,-99.31740614334473,0.6825938566552624,9.47998226594394,-4.9337260677466945,0.1451,0.1479,0.1334,0.1358,11296853.55,8386.0,3909006.88,-6.40937284631289,35.8603066439523,0.19802488203248692,0.1214651179675131,-0.01309373661635968,-0.011454719950361123,-0.0016390166659985567,0.014500000000000013,0.01795714285714286,-430867203.9100001,-0.008899999999999991,-19.64497041420119,-94.6691176470588,5.3308823529412015,14.263712241653456,0.1409,0.1399787430126656,0.14301428571428573,0.14402827307018332,0.159745,0.15836108605436452,24978.0,4867713.423333338,101367.0,9529556.87857143
2019-07-10,0.1291,0.13,0.118,0.1259,15429159.9,9937.0,6485233.68,0.13026666666666667,0.13708571428571428,0.1528,0.1302196857531664,0.13669715360197812,0.15274819062500133,38.73045078196873,0.18605347627257332,0.11954652372742666,-0.01440645409573324,-0.012416258328754303,-0.001990195766978937,0.01200000000000001,0.01715714285714286,-458047560.70000005,-0.02679999999999999,-16.289893617021267,-88.60028860028858,11.399711399711427,5.804395869769306,-2.47869868319131,0.1358,0.1364,0.1287,0.1291,11751196.89,8103.0,5217289.54,-4.9337260677466945,35.799319727891145,0.19105798405313149,0.12110201594686856,-0.013774667133603341,-0.011918709387009568,-0.001855957746593773,0.007699999999999985,0.017942857142857142,-442618400.8000001,-0.03420000000000001,-20.553846153846155,-99.31740614334473,0.6825938566552624,9.47998226594394,0.1366666666666667,0.1345393715063328,0.1403,0.1402962048026375,0.15608000000000002,0.15557431595394886,24069.0,4646880.4633333385,83697.0,7864192.397142857
2019-07-11,0.1255,0.1272,0.1098,0.1113,14465401.88,8775.0,6707393.24,0.1221,0.13352857142857144,0.14934999999999998,0.1207598428765832,0.1303478652014836,0.14880074389881073,34.03736799350122,0.18483304265123762,0.11386695734876234,-0.015901940130499004,-0.013113394689103244,-0.00278854544139576,0.017400000000000013,0.01684285714285715,-472512962.58000004,-0.05159999999999999,-26.09561752988049,-98.06451612903226,1.9354838709677438,4.672596375778153,-11.314741035856576,0.1291,0.13,0.118,0.1259,15429159.9,9937.0,6485233.68,-2.47869868319131,38.73045078196873,0.18605347627257332,0.11954652372742666,-0.01440645409573324,-0.012416258328754303,-0.001990195766978937,0.01200000000000001,0.01715714285714286,-458047560.70000005,-0.02679999999999999,-16.289893617021267,-88.60028860028858,11.399711399711427,5.804395869769306,0.13026666666666667,0.1302196857531664,0.13708571428571428,0.13669715360197812,0.1528,0.15274819062500133,26426.0,5203843.366666672,69281.0,6582903.555714286
2019-07-12,0.1113,0.122,0.1044,0.1194,17957483.69,10607.0,8389408.34,0.11886666666666668,0.12977142857142857,0.14597500000000002,0.1200799214382916,0.1276108989011127,0.14600067305130493,39.90422984836394,0.17918773535067184,0.11276226464932822,-0.01624624468616448,-0.013739964688515491,-0.002506279997648988,0.01759999999999999,0.017142857142857147,-454555478.89000005,-0.028700000000000003,-17.484450587422252,-81.9059107358263,18.094089264173704,10.476428178284301,7.277628032345023,0.1255,0.1272,0.1098,0.1113,14465401.88,8775.0,6707393.24,-11.314741035856576,34.03736799350122,0.18483304265123762,0.11386695734876234,-0.015901940130499004,-0.013113394689103244,-0.00278854544139576,0.017400000000000013,0.01684285714285715,-472512962.58000004,-0.05159999999999999,-26.09561752988049,-98.06451612903226,1.9354838709677438,4.672596375778153,0.1221,0.1207598428765832,0.13352857142857144,0.1303478652014836,0.14934999999999998,0.14880074389881073,26815.0,6136638.820000005,62789.0,5858123.592857143
2019-07-13,0.1194,0.1394,0.1139,0.122,27899232.17,15610.0,14113191.28,0.11756666666666667,0.12694285714285714,0.143245,0.1210399607191458,0.12620817417583452,0.14371489466546636,31.10704483074109,0.17479282334638668,0.11169717665361333,-0.016123449170675486,-0.014216661584947492,-0.001906787585727994,0.025499999999999995,0.016821428571428574,-426656246.72,-0.026400000000000007,-25.290875688916103,-78.76960193003619,21.230398069963805,13.753323735035094,2.1775544388609642,0.1113,0.122,0.1044,0.1194,17957483.69,10607.0,8389408.34,7.277628032345023,39.90422984836394,0.17918773535067184,0.11276226464932822,-0.01624624468616448,-0.013739964688515491,-0.002506279997648988,0.01759999999999999,0.017142857142857147,-454555478.89000005,-0.028700000000000003,-17.484450587422252,-81.9059107358263,18.094089264173704,10.476428178284301,0.11886666666666668,0.1200799214382916,0.12977142857142857,0.1276108989011127,0.14597500000000002,0.14600067305130493,29319.0,7194011.753333339,62400.0,5914637.867142857
2019-07-14,0.1222,0.1295,0.1045,0.1045,17234524.87,10612.0,7145240.44,0.1153,0.12114285714285714,0.14002,0.11276998035957289,0.12078113063187589,0.13998014279256482,29.259896729776244,0.17360368024721912,0.10643631975278088,-0.01723951024348977,-0.014821231316655949,-0.002418278926833821,0.02500000000000001,0.016078571428571435,-443890771.59000003,-0.03169999999999999,-31.56516044531762,-99.835255354201,0.1647446457989934,13.163077326645508,-14.484451718494276,0.1194,0.1394,0.1139,0.122,27899232.17,15610.0,14113191.28,2.1775544388609642,31.10704483074109,0.17479282334638668,0.11169717665361333,-0.016123449170675486,-0.014216661584947492,-0.001906787585727994,0.025499999999999995,0.016821428571428574,-426656246.72,-0.026400000000000007,-25.290875688916103,-78.76960193003619,21.230398069963805,13.753323735035094,0.11756666666666667,0.1210399607191458,0.12694285714285714,0.12620817417583452,0.143245,0.14371489466546636,34992.0,9736664.28666667,68998.0,7090838.275714286
2019-07-15,0.1045,0.112,0.0964,0.1035,16445767.76,9307.0,7815238.01,0.10999999999999999,0.11652857142857143,0.13707,0.10813499017978645,0.1164608479739069,0.1365058434789872,22.242990654205613,0.1726454557614048,0.10149454423859519,-0.017997227491495377,-0.015456430551623835,-0.0025407969398715414,0.015600000000000003,0.015885714285714288,-460336539.35,-0.0422,-36.46408839779005,-89.66521106259097,10.33478893740902,10.576643884390615,-0.956937799043063,0.1222,0.1295,0.1045,0.1045,17234524.87,10612.0,7145240.44,-14.484451718494276,29.259896729776244,0.17360368024721912,0.10643631975278088,-0.01723951024348977,-0.014821231316655949,-0.002418278926833821,0.02500000000000001,0.016078571428571435,-443890771.59000003,-0.03169999999999999,-31.56516044531762,-99.835255354201,0.1647446457989934,13.163077326645508,0.1153,0.11276998035957289,0.12114285714285714,0.12078113063187589,0.14002,0.13998014279256482,36829.0,9882613.353333337,72030.0,7423823.342857143
2019-07-16,0.1036,0.1063,0.09,0.0924,13572811.17,8927.0,5739639.34,0.10013333333333334,0.1112857142857143,0.13417,0.10026749508989322,0.11044563598043018,0.13230528695717889,23.039690222652467,0.17433068252722714,0.09400931747277289,-0.019271254081910077,-0.016219395257681082,-0.003051858824228995,0.01630000000000001,0.015650000000000004,-473909350.52000004,-0.04940000000000001,-37.609723160027016,-96.41791044776119,3.5820895522388048,4.693874378482282,-10.810810810810812,0.1045,0.112,0.0964,0.1035,16445767.76,9307.0,7815238.01,-0.956937799043063,22.242990654205613,0.1726454557614048,0.10149454423859519,-0.017997227491495377,-0.015456430551623835,-0.0025407969398715414,0.015600000000000003,0.015885714285714288,-460336539.35,-0.0422,-36.46408839779005,-89.66521106259097,10.33478893740902,10.576643884390615,0.10999999999999999,0.10813499017978645,0.11652857142857143,0.1164608479739069,0.13707,0.1365058434789872,35529.0,9691223.243333338,72951.0,7981856.361428571
2019-07-17,0.0926,0.1028,0.09,0.0977,14275091.15,8975.0,6787596.15,0.09786666666666666,0.10725714285714286,0.131525,0.0989837475449466,0.10725922698532264,0.12900954534220946,26.59279778393352,0.17402918555241098,0.08902081444758903,-0.019627015609079312,-0.01690091932796073,-0.002726096281118584,0.012800000000000006,0.015578571428571433,-459634259.37000006,-0.04740000000000001,-34.16442048517521,-87.69968051118211,12.300319488817886,8.739065992821912,5.507559395248373,0.1036,0.1063,0.09,0.0924,13572811.17,8927.0,5739639.34,-10.810810810810812,23.039690222652467,0.17433068252722714,0.09400931747277289,-0.019271254081910077,-0.016219395257681082,-0.003051858824228995,0.01630000000000001,0.015650000000000004,-473909350.52000004,-0.04940000000000001,-37.609723160027016,-96.41791044776119,3.5820895522388048,4.693874378482282,0.10013333333333334,0.10026749508989322,0.1112857142857143,0.11044563598043018,0.13417,0.13230528695717889,28846.0,6900039.263333338,73775.0,8056477.761428571
2019-07-18,0.0976,0.1052,0.0951,0.1019,17774185.34,9820.0,8588810.33,0.09733333333333334,0.10591428571428571,0.129385,0.1004418737724733,0.10591942023899198,0.12642768388104667,32.90129611166502,0.17337984539184936,0.08539015460815062,-0.019347033721715284,-0.01739014220671164,-0.0019568915150036427,0.010099999999999998,0.015135714285714289,-441860074.0300001,-0.0339,-25.183553597650498,-80.99041533546325,19.00958466453675,11.630664568531154,4.405737704918031,0.0926,0.1028,0.09,0.0977,14275091.15,8975.0,6787596.15,5.507559395248373,26.59279778393352,0.17402918555241098,0.08902081444758903,-0.019627015609079312,-0.01690091932796073,-0.002726096281118584,0.012800000000000006,0.015578571428571433,-459634259.37000006,-0.04740000000000001,-34.16442048517521,-87.69968051118211,12.300319488817886,8.739065992821912,0.09786666666666666,0.0989837475449466,0.10725714285714286,0.10725922698532264,0.131525,0.12900954534220946,27209.0,6780824.500000005,72813.0,8099672.399999999
2019-07-19,0.1018,0.1032,0.099,0.1025,8466422.63,6199.0,4224500.79,0.1007,0.10350000000000001,0.12634499999999999,0.10147093688623665,0.10506456517924398,0.1241488568447565,26.367614879649892,0.16884971057486137,0.0838402894251386,-0.018859332428518782,-0.01768398025107307,-0.001175352177445712,0.004199999999999995,0.01420714285714286,-433393651.4000001,-0.0266,-29.649965682910096,-79.50819672131148,20.49180327868852,17.26723581068106,0.6876227897838824,0.0976,0.1052,0.0951,0.1019,17774185.34,9820.0,8588810.33,4.405737704918031,32.90129611166502,0.17337984539184936,0.08539015460815062,-0.019347033721715284,-0.01739014220671164,-0.0019568915150036427,0.010099999999999998,0.015135714285714289,-441860074.0300001,-0.0339,-25.183553597650498,-80.99041533546325,19.00958466453675,11.630664568531154,0.09733333333333334,0.1004418737724733,0.10591428571428571,0.10591942023899198,0.129385,0.12642768388104667,27722.0,7038681.940000005,73858.0,8368446.2700000005
2019-07-20,0.1024,0.1087,0.1005,0.1059,12084567.03,7143.0,5498715.68,0.10343333333333332,0.1012,0.124005,0.10368546844311832,0.10527342388443298,0.12241087047858921,30.253025302530247,0.16554252773729344,0.08246747226270658,-0.017991084037227864,-0.01774540100830403,-0.00024568302892383556,0.008199999999999999,0.014014285714285717,-421309084.3700001,-0.020000000000000018,-25.317348377997185,-72.86689419795222,27.13310580204777,22.21149791509102,3.41796874999999,0.1018,0.1032,0.099,0.1025,8466422.63,6199.0,4224500.79,0.6876227897838824,26.367614879649892,0.16884971057486137,0.0838402894251386,-0.018859332428518782,-0.01768398025107307,-0.001175352177445712,0.004199999999999995,0.01420714285714286,-433393651.4000001,-0.0266,-29.649965682910096,-79.50819672131148,20.49180327868852,17.26723581068106,0.1007,0.10147093688623665,0.10350000000000001,0.10506456517924398,0.12634499999999999,0.1241488568447565,24994.0,6533635.7566666715,69450.0,7773459.477142857
2019-07-21,0.1058,0.1071,0.1003,0.1028,8382354.68,5667.0,3876813.56,0.10373333333333333,0.10095714285714286,0.121,0.10324273422155916,0.10465506791332474,0.1205431685282474,26.681367144432187,0.15925597992471383,0.08274402007528617,-0.01735309929718823,-0.01766694066608087,0.00031384136889264086,0.0068000000000000005,0.013835714285714288,-429691439.05000013,-0.008499999999999994,-29.15230875258442,-77.89291882556131,22.107081174438694,23.243996751725007,-2.8355387523629516,0.1024,0.1087,0.1005,0.1059,12084567.03,7143.0,5498715.68,3.41796874999999,30.253025302530247,0.16554252773729344,0.08246747226270658,-0.017991084037227864,-0.01774540100830403,-0.00024568302892383556,0.008199999999999999,0.014014285714285717,-421309084.3700001,-0.020000000000000018,-25.317348377997185,-72.86689419795222,27.13310580204777,22.21149791509102,0.10343333333333332,0.10368546844311832,0.1012,0.10527342388443298,0.124005,0.12241087047858921,23162.0,6104008.933333337,60983.0,6542820.105714286
2019-07-22,0.103,0.1044,0.095,0.0983,9925395.54,6661.0,3719614.48,0.10233333333333333,0.1002142857142857,0.11850999999999998,0.10077136711077958,0.10306630093499355,0.11842477152555718,28.172293364377182,0.15580991674888556,0.0812100832511144,-0.01701447194476756,-0.01753644692181821,0.0005219749770506502,0.009400000000000006,0.013471428571428573,-439616834.59000015,-0.021100000000000008,-27.61413843888071,-83.19838056680162,16.801619433198383,22.01393546989496,-4.563106796116501,0.1058,0.1071,0.1003,0.1028,8382354.68,5667.0,3876813.56,-2.8355387523629516,26.681367144432187,0.15925597992471383,0.08274402007528617,-0.01735309929718823,-0.01766694066608087,0.00031384136889264086,0.0068000000000000005,0.013835714285714288,-429691439.05000013,-0.008499999999999994,-29.15230875258442,-77.89291882556131,22.107081174438694,23.243996751725007,0.10373333333333333,0.10324273422155916,0.10095714285714286,0.10465506791332474,0.121,0.1205431685282474,19009.0,4533343.343333338,56038.0,6075901.9799999995
2019-07-23,0.0984,0.0987,0.0883,0.0888,11194710.91,7117.0,4306660.07,0.09663333333333335,0.0997,0.11553,0.0947856835553898,0.09949972570124516,0.11560336471359936,27.28297632468997,0.15229457677253025,0.07876542322746974,-0.017313103256178533,-0.017491778188690275,0.00017867493251174163,0.010399999999999993,0.013664285714285716,-450811545.5000002,-0.03319999999999999,-31.21611154144074,-99.02152641878669,0.9784735812133082,13.295724729616806,-9.756097560975608,0.103,0.1044,0.095,0.0983,9925395.54,6661.0,3719614.48,-4.563106796116501,28.172293364377182,0.15580991674888556,0.0812100832511144,-0.01701447194476756,-0.01753644692181821,0.0005219749770506502,0.009400000000000006,0.013471428571428573,-439616834.59000015,-0.021100000000000008,-27.61413843888071,-83.19838056680162,16.801619433198383,22.01393546989496,0.10233333333333333,0.10077136711077958,0.1002142857142857,0.10306630093499355,0.11850999999999998,0.11842477152555718,19471.0,4365047.906666671,53392.0,5490812.904285715
2019-07-24,0.0888,0.0917,0.0845,0.0874,15249658.14,8771.0,6039830.23,0.09150000000000001,0.09822857142857143,0.11309,0.0910928417776949,0.09647479427593386,0.11291732997897085,27.848101265822777,0.15054941804139668,0.07563058195860331,-0.017461454246529826,-0.017485713400258184,2.42591537283586e-05,0.007199999999999998,0.013321428571428571,-466061203.64000016,-0.01709999999999999,-30.57982525814138,-94.71766848816029,5.282331511839709,7.687474842083809,-1.5765765765765747,0.0984,0.0987,0.0883,0.0888,11194710.91,7117.0,4306660.07,-9.756097560975608,27.28297632468997,0.15229457677253025,0.07876542322746974,-0.017313103256178533,-0.017491778188690275,0.00017867493251174163,0.010399999999999993,0.013664285714285716,-450811545.5000002,-0.03319999999999999,-31.21611154144074,-99.02152641878669,0.9784735812133082,13.295724729616806,0.09663333333333335,0.0947856835553898,0.0997,0.09949972570124516,0.11553,0.11560336471359936,19445.0,3967696.0366666713,51582.0,5286101.58
2019-07-25,0.0874,0.1144,0.0873,0.1053,46332633.15,20328.0,22416160.03,0.09383333333333334,0.09871428571428573,0.11107,0.09819642088884745,0.0986810957069504,0.11219186998097362,46.67405764966741,0.145347204332358,0.076792795667642,-0.015950772495420082,-0.017178725219290564,0.0012279527238704818,0.0271,0.014014285714285713,-419728570.4900002,0.00180000000000001,-5.390835579514819,-62.11293260473588,37.887067395264125,14.715957496105723,20.480549199084667,0.0888,0.0917,0.0845,0.0874,15249658.14,8771.0,6039830.23,-1.5765765765765747,27.848101265822777,0.15054941804139668,0.07563058195860331,-0.017461454246529826,-0.017485713400258184,2.42591537283586e-05,0.007199999999999998,0.013321428571428571,-466061203.64000016,-0.01709999999999999,-30.57982525814138,-94.71766848816029,5.282331511839709,7.687474842083809,0.09150000000000001,0.0910928417776949,0.09822857142857143,0.09647479427593386,0.11309,0.11291732997897085,22549.0,4688701.593333338,51378.0,5179277.877142857
2019-07-26,0.1053,0.1123,0.102,0.1023,24061765.15,12758.0,11061545.22,0.09833333333333334,0.09868571428571428,0.10909500000000001,0.10024821044442372,0.0995858217802128,0.11124978712564279,39.9529964747356,0.14033421119025885,0.07785578880974117,-0.014824730981070067,-0.016707926371646465,0.0018831953905763983,0.010300000000000004,0.013492857142857143,-443790335.64000016,0.009900000000000006,-14.321608040201006,-67.57741347905282,32.42258652094718,25.19732847601701,-2.8490028490028516,0.0874,0.1144,0.0873,0.1053,46332633.15,20328.0,22416160.03,20.480549199084667,46.67405764966741,0.145347204332358,0.076792795667642,-0.015950772495420082,-0.017178725219290564,0.0012279527238704818,0.0271,0.014014285714285713,-419728570.4900002,0.00180000000000001,-5.390835579514819,-62.11293260473588,37.887067395264125,14.715957496105723,0.09383333333333334,0.09819642088884745,0.09871428571428573,0.0986810957069504,0.11107,0.11219186998097362,36216.0,10920883.443333339,61886.0,7154613.548571429
2019-07-27,0.1023,0.105,0.0915,0.0917,24789395.08,11502.0,10665301.22,0.09976666666666667,0.09665714285714286,0.10642500000000002,0.09597410522221186,0.0976143663351596,0.10938790263748634,33.72717508055854,0.1335664132975716,0.07928358670242842,-0.014619145965769395,-0.01629017029047105,0.0016710243247016546,0.013499999999999998,0.012635714285714287,-468579730.72000015,-0.0059999999999999915,-24.836065573770483,-84.00000000000001,15.999999999999998,28.769884638737107,-10.361681329423263,0.1053,0.1123,0.102,0.1023,24061765.15,12758.0,11061545.22,-2.8490028490028516,39.9529964747356,0.14033421119025885,0.07785578880974117,-0.014824730981070067,-0.016707926371646465,0.0018831953905763983,0.010300000000000004,0.013492857142857143,-443790335.64000016,0.009900000000000006,-14.321608040201006,-67.57741347905282,32.42258652094718,25.19732847601701,0.09833333333333334,0.10024821044442372,0.09868571428571428,0.0995858217802128,0.10909500000000001,0.11124978712564279,41857.0,13172511.826666674,68445.0,8131334.181428572
2019-07-28,0.0921,0.0949,0.0862,0.0902,15041440.75,8460.0,6744707.08,0.09473333333333334,0.09485714285714286,0.104145,0.09308705261110593,0.0957607747513697,0.10756048333867811,40.72632944228276,0.12840460254805502,0.07988539745194496,-0.01441113325046807,-0.015914362882470452,0.0015032296320023827,0.0087,0.011471428571428572,-483621171.47000015,-0.011700000000000002,-13.684210526315788,-80.93645484949835,19.063545150501664,22.49537722381629,-2.062975027144407,0.1023,0.105,0.0915,0.0917,24789395.08,11502.0,10665301.22,-10.361681329423263,33.72717508055854,0.1335664132975716,0.07928358670242842,-0.014619145965769395,-0.01629017029047105,0.0016710243247016546,0.013499999999999998,0.012635714285714287,-468579730.72000015,-0.0059999999999999915,-24.836065573770483,-84.00000000000001,15.999999999999998,28.769884638737107,0.09976666666666667,0.09597410522221186,0.09665714285714286,0.0976143663351596,0.10642500000000002,0.10938790263748634,44588.0,14714335.490000004,72804.0,8869417.83
2019-07-29,0.0902,0.0947,0.0882,0.0932,14073958.59,8635.0,7200148.28,0.0917,0.09412857142857144,0.10235000000000001,0.09314352630555298,0.09512058106352728,0.10619281825880401,43.48925410872314,0.12400815757339047,0.08069184242660955,-0.013844614647306436,-0.01550041323543765,0.0016557985881312139,0.006500000000000006,0.010821428571428574,-469547212.8800002,-0.009299999999999989,-9.951690821256031,-70.90301003344482,29.096989966555185,21.38684503901896,3.3259423503325976,0.0921,0.0949,0.0862,0.0902,15041440.75,8460.0,6744707.08,-2.062975027144407,40.72632944228276,0.12840460254805502,0.07988539745194496,-0.01441113325046807,-0.015914362882470452,0.0015032296320023827,0.0087,0.011471428571428572,-483621171.47000015,-0.011700000000000002,-13.684210526315788,-80.93645484949835,19.063545150501664,22.49537722381629,0.09473333333333334,0.09308705261110593,0.09485714285714286,0.0957607747513697,0.104145,0.10756048333867811,32720.0,9490517.840000005,75597.0,9279116.904285714
2019-07-30,0.0932,0.0947,0.0902,0.0916,17301648.47,7827.0,8712491.47,0.09166666666666667,0.09452857142857143,0.100635,0.09237176315277648,0.09424043579764546,0.10480302604367982,49.42528735632184,0.11972065457421997,0.08154934542578003,-0.013370622982182001,-0.01507445518478652,0.0017038322026045188,0.004500000000000004,0.009978571428571429,-486848861.35000014,-0.014299999999999993,-0.8658008658008587,-76.2541806020067,23.745819397993298,23.968784838350057,-1.7167381974248972,0.0902,0.0947,0.0882,0.0932,14073958.59,8635.0,7200148.28,3.3259423503325976,43.48925410872314,0.12400815757339047,0.08069184242660955,-0.013844614647306436,-0.01550041323543765,0.0016557985881312139,0.006500000000000006,0.010821428571428574,-469547212.8800002,-0.009299999999999989,-9.951690821256031,-70.90301003344482,29.096989966555185,21.38684503901896,0.0917,0.09314352630555298,0.09412857142857144,0.09512058106352728,0.10235000000000001,0.10619281825880401,28597.0,8203385.526666672,77571.0,9776336.01857143
2019-07-31,0.0916,0.093,0.0885,0.0901,17183174.25,8304.0,7121616.69,0.09163333333333334,0.09491428571428573,0.099575,0.09123588157638823,0.0932053268482341,0.10340273784904365,44.224924012158056,0.11852100360581902,0.08062899639418097,-0.012966548338769035,-0.014652873815583023,0.0016863254768139883,0.004500000000000004,0.009385714285714287,-504032035.60000014,-0.012700000000000003,-7.778915046059365,-81.27090301003346,18.729096989966536,23.857302118171685,-1.63755458515284,0.0932,0.0947,0.0902,0.0916,17301648.47,7827.0,8712491.47,-1.7167381974248972,49.42528735632184,0.11972065457421997,0.08154934542578003,-0.013370622982182001,-0.01507445518478652,0.0017038322026045188,0.004500000000000004,0.009978571428571429,-486848861.35000014,-0.014299999999999993,-0.8658008658008587,-76.2541806020067,23.745819397993298,23.968784838350057,0.09166666666666667,0.09237176315277648,0.09452857142857143,0.09424043579764546,0.100635,0.10480302604367982,24922.0,7552448.943333339,78281.0,10405740.504285714
2019-08-01,0.0901,0.0911,0.0826,0.0838,18390812.16,9421.0,8705927.19,0.08850000000000001,0.09184285714285714,0.09779499999999999,0.08751794078819411,0.09085399513617556,0.10153581043484902,36.671575846833576,0.11555047061731216,0.08003952938268782,-0.013004762810866946,-0.014323251614639808,0.0013184888037728621,0.008499999999999994,0.009271428571428571,-522422847.76000017,-0.014499999999999999,-17.762512266928365,-96.22641509433964,3.773584905660355,15.416167097873407,-6.992230854605993,0.0916,0.093,0.0885,0.0901,17183174.25,8304.0,7121616.69,-1.63755458515284,44.224924012158056,0.11852100360581902,0.08062899639418097,-0.012966548338769035,-0.014652873815583023,0.0016863254768139883,0.004500000000000004,0.009385714285714287,-504032035.60000014,-0.012700000000000003,-7.778915046059365,-81.27090301003346,18.729096989966536,23.857302118171685,0.09163333333333334,0.09123588157638823,0.09491428571428573,0.0932053268482341,0.099575,0.10340273784904365,24766.0,7678085.480000005,77814.0,10560281.427142857
2019-08-02,0.0838,0.09,0.0831,0.085,16016100.52,7994.0,7584117.52,0.0863,0.08937142857142857,0.09594499999999999,0.08625897039409705,0.08939049635213168,0.09996097134581579,37.22627737226278,0.11050413169765304,0.08138586830234694,-0.0127907740034124,-0.014016756092394328,0.0012259820889819282,0.006900000000000003,0.009464285714285715,-506406747.2400002,-0.003799999999999998,-17.07317073170731,-92.45283018867924,7.547169811320755,10.016617235649226,1.431980906921249,0.0901,0.0911,0.0826,0.0838,18390812.16,9421.0,8705927.19,-6.992230854605993,36.671575846833576,0.11555047061731216,0.08003952938268782,-0.013004762810866946,-0.014323251614639808,0.0013184888037728621,0.008499999999999994,0.009271428571428571,-522422847.76000017,-0.014499999999999999,-17.762512266928365,-96.22641509433964,3.773584905660355,15.416167097873407,0.08850000000000001,0.08751794078819411,0.09184285714285714,0.09085399513617556,0.09779499999999999,0.10153581043484902,25552.0,8180011.783333339,66907.0,8601676.735714285
2019-08-03,0.0851,0.0864,0.0812,0.0824,9781086.53,5359.0,4343480.26,0.08373333333333333,0.08804285714285716,0.09484000000000001,0.08432948519704853,0.08764287226409875,0.09828849788430952,32.64401772525851,0.11000719451559246,0.07967280548440756,-0.012684762555937631,-0.01375035738510299,0.0010655948291653592,0.00520000000000001,0.00925,-516187833.77000016,-0.0050000000000000044,-22.19074598677998,-96.38554216867468,3.6144578313253204,4.978404182768821,-3.172737955346644,0.0838,0.09,0.0831,0.085,16016100.52,7994.0,7584117.52,1.431980906921249,37.22627737226278,0.11050413169765304,0.08138586830234694,-0.0127907740034124,-0.014016756092394328,0.0012259820889819282,0.006900000000000003,0.009464285714285715,-506406747.2400002,-0.003799999999999998,-17.07317073170731,-92.45283018867924,7.547169811320755,10.016617235649226,0.0863,0.08625897039409705,0.08937142857142857,0.08939049635213168,0.09594499999999999,0.09996097134581579,25719.0,7803887.133333339,62143.0,8104901.350000001
2019-08-04,0.0823,0.0827,0.0775,0.078,8940998.46,5346.0,4249333.99,0.0818,0.0863,0.093565,0.08116474259852427,0.08523215419807408,0.09635625999056575,32.028985507246375,0.10990858396564963,0.07722141603435036,-0.012808146606423904,-0.013561915229367174,0.00075376862294327,0.005199999999999996,0.009135714285714287,-525128832.23000014,-0.027300000000000005,-24.124513618677046,-98.6449864498645,1.3550135501355025,4.172213730927203,-5.22478736330498,0.0851,0.0864,0.0812,0.0824,9781086.53,5359.0,4343480.26,-3.172737955346644,32.64401772525851,0.11000719451559246,0.07967280548440756,-0.012684762555937631,-0.01375035738510299,0.0010655948291653592,0.00520000000000001,0.00925,-516187833.77000016,-0.0050000000000000044,-22.19074598677998,-96.38554216867468,3.6144578313253204,4.978404182768821,0.08373333333333333,0.08432948519704853,0.08804285714285716,0.08764287226409875,0.09484000000000001,0.09828849788430952,22774.0,6877841.656666671,56000.0,7201784.07
2019-08-05,0.078,0.0819,0.0734,0.0772,21089110.29,8625.0,9478515.55,0.0792,0.08401428571428572,0.092805,0.07918237129926214,0.08322411564855556,0.09453185427717854,33.84379785604902,0.1107152411162508,0.07489475888374919,-0.012822670901176142,-0.013414066363728968,0.0005913954625528257,0.008499999999999994,0.009071428571428572,-546217942.5200001,-0.025099999999999997,-21.464903357070185,-90.73170731707317,9.268292682926825,4.745921354795893,-1.0256410256410193,0.0823,0.0827,0.0775,0.078,8940998.46,5346.0,4249333.99,-5.22478736330498,32.028985507246375,0.10990858396564963,0.07722141603435036,-0.012808146606423904,-0.013561915229367174,0.00075376862294327,0.005199999999999996,0.009135714285714287,-525128832.23000014,-0.027300000000000005,-24.124513618677046,-98.6449864498645,1.3550135501355025,4.172213730927203,0.0818,0.08116474259852427,0.0863,0.08523215419807408,0.093565,0.09635625999056575,18699.0,5392310.590000006,52886.0,6845302.199999998
2019-08-06,0.0771,0.0899,0.077,0.0813,35022158.68,12764.0,16329859.18,0.07883333333333332,0.08254285714285714,0.09198500000000001,0.08024118564963106,0.08274308673641667,0.09327167767935202,43.73956594323873,0.11044488823596577,0.07352511176403426,-0.01236085750360394,-0.013203424591703964,0.0008425670881000245,0.012899999999999995,0.00925,-511195783.8400001,-0.010400000000000006,-8.445945945945954,-80.73170731707319,19.26829268292681,9.963866305329722,5.4474708171206165,0.078,0.0819,0.0734,0.0772,21089110.29,8625.0,9478515.55,-1.0256410256410193,33.84379785604902,0.1107152411162508,0.07489475888374919,-0.012822670901176142,-0.013414066363728968,0.0005913954625528257,0.008499999999999994,0.009071428571428572,-546217942.5200001,-0.025099999999999997,-21.464903357070185,-90.73170731707317,9.268292682926825,4.745921354795893,0.0792,0.07918237129926214,0.08401428571428572,0.08322411564855556,0.092805,0.09453185427717854,19330.0,6023776.600000006,52876.0,7170783.238571428
2019-08-07,0.0816,0.0906,0.0771,0.0794,40473942.39,13651.0,18822830.62,0.0793,0.08101428571428572,0.09086,0.07982059282481553,0.0819073150523125,0.09195056551941372,43.37748344370861,0.10951706018473917,0.07220293981526082,-0.012009740368712857,-0.012964687747105744,0.0009549473783928876,0.013499999999999998,0.0097,-551669726.2300001,-0.010800000000000004,-9.153318077803208,-85.36585365853661,14.634146341463394,14.39024390243902,-2.696078431372558,0.0771,0.0899,0.077,0.0813,35022158.68,12764.0,16329859.18,5.4474708171206165,43.73956594323873,0.11044488823596577,0.07352511176403426,-0.01236085750360394,-0.013203424591703964,0.0008425670881000245,0.012899999999999995,0.00925,-511195783.8400001,-0.010400000000000006,-8.445945945945954,-80.73170731707319,19.26829268292681,9.963866305329722,0.07883333333333332,0.08024118564963106,0.08254285714285714,0.08274308673641667,0.09198500000000001,0.09327167767935202,26735.0,10019236.240000008,57813.0,8258978.625714285
2019-08-08,0.0797,0.0831,0.0778,0.0796,19783322.36,9631.0,8562357.32,0.0801,0.08041428571428573,0.08971500000000002,0.07971029641240776,0.08133048628923437,0.09077432118423147,19.906323185011715,0.10817397585116315,0.07125602414883689,-0.011581831042302884,-0.012688116406145174,0.0011062853638422899,0.005299999999999999,0.008142857142857143,-531886403.8700001,-0.013600000000000001,-24.406457739791076,-84.06169665809769,15.93830334190231,16.61358078876418,-0.12547051442909535,0.0816,0.0906,0.0771,0.0794,40473942.39,13651.0,18822830.62,-2.696078431372558,43.37748344370861,0.10951706018473917,0.07220293981526082,-0.012009740368712857,-0.012964687747105744,0.0009549473783928876,0.013499999999999998,0.0097,-551669726.2300001,-0.010800000000000004,-9.153318077803208,-85.36585365853661,14.634146341463394,14.39024390243902,0.0793,0.07982059282481553,0.08101428571428572,0.0819073150523125,0.09086,0.09195056551941372,35040.0,14877068.450000005,63160.0,9930580.615714286
2019-08-09,0.0801,0.0803,0.0725,0.0732,12510515.77,7116.0,5295904.65,0.07740000000000001,0.07872857142857144,0.08808,0.07645514820620389,0.07929786471692578,0.08910057630954275,18.438177874186565,0.1062940027104693,0.0698659972895307,-0.01162512907953378,-0.012475518940822897,0.0008503898612891164,0.007800000000000001,0.007964285714285714,-544396919.6400001,-0.0184,-28.445747800586506,-97.84615384615383,2.153846153846173,10.908765279070636,-8.614232209737832,0.0797,0.0831,0.0778,0.0796,19783322.36,9631.0,8562357.32,-0.12547051442909535,19.906323185011715,0.10817397585116315,0.07125602414883689,-0.011581831042302884,-0.012688116406145174,0.0011062853638422899,0.005299999999999999,0.008142857142857143,-531886403.8700001,-0.013600000000000001,-24.406457739791076,-84.06169665809769,15.93830334190231,16.61358078876418,0.0801,0.07971029641240776,0.08041428571428573,0.08133048628923437,0.08971500000000002,0.09077432118423147,36046.0,14571682.37333334,63370.0,9910070.634285714
2019-08-10,0.0733,0.0775,0.0729,0.0753,10450533.62,5931.0,4589277.59,0.07603333333333333,0.07771428571428572,0.086705,0.07587757410310195,0.07829839853769432,0.08778623570863392,28.19148936170214,0.1043843039872566,0.06902569601274341,-0.011359050572184379,-0.012252225267095193,0.0008931746949108147,0.004599999999999993,0.007328571428571428,-533946386.0200001,-0.014799999999999994,-17.884405670665203,-87.49999999999996,12.500000000000048,10.197383165249521,2.7285129604365643,0.0801,0.0803,0.0725,0.0732,12510515.77,7116.0,5295904.65,-8.614232209737832,18.438177874186565,0.1062940027104693,0.0698659972895307,-0.01162512907953378,-0.012475518940822897,0.0008503898612891164,0.007800000000000001,0.007964285714285714,-544396919.6400001,-0.0184,-28.445747800586506,-97.84615384615383,2.153846153846173,10.908765279070636,0.07740000000000001,0.07645514820620389,0.07872857142857144,0.07929786471692578,0.08808,0.08910057630954275,30398.0,10893697.530000007,62492.0,9583183.08142857
2019-08-11,0.0753,0.0803,0.0747,0.0758,11798706.24,6369.0,5717197.92,0.07476666666666668,0.07740000000000001,0.08558,0.07583878705155098,0.07767379890327075,0.08664468945066879,30.327868852459034,0.10301446073306472,0.06814553926693528,-0.010981250595518216,-0.0119980303327798,0.001016779737261584,0.005599999999999994,0.007107142857142856,-522147679.7800001,-0.007999999999999993,-15.964523281596444,-85.13513513513509,14.864864864864908,9.839570339570386,0.6640106241699872,0.0733,0.0775,0.0729,0.0753,10450533.62,5931.0,4589277.59,2.7285129604365643,28.19148936170214,0.1043843039872566,0.06902569601274341,-0.011359050572184379,-0.012252225267095193,0.0008931746949108147,0.004599999999999993,0.007328571428571428,-533946386.0200001,-0.014799999999999994,-17.884405670665203,-87.49999999999996,12.500000000000048,10.197383165249521,0.07603333333333333,0.07587757410310195,0.07771428571428572,0.07829839853769432,0.086705,0.08778623570863392,22678.0,6149179.853333339,63064.0,9618296.985714287
2019-08-12,0.0758,0.0802,0.0754,0.0779,9542798.9,5058.0,4664281.19,0.07633333333333334,0.0775,0.085035,0.07686939352577549,0.07773034917745306,0.08581186188393843,28.57142857142857,0.10272523221412365,0.06734476778587635,-0.010392589638352212,-0.011676942193894283,0.0012843525555420714,0.004799999999999999,0.006985714285714284,-512604880.8800001,-0.007100000000000009,-16.41630901287554,-75.67567567567568,24.32432432432432,17.22972972972977,2.7704485488126527,0.0753,0.0803,0.0747,0.0758,11798706.24,6369.0,5717197.92,0.6640106241699872,30.327868852459034,0.10301446073306472,0.06814553926693528,-0.010981250595518216,-0.0119980303327798,0.001016779737261584,0.005599999999999994,0.007107142857142856,-522147679.7800001,-0.007999999999999993,-15.964523281596444,-85.13513513513509,14.864864864864908,9.839570339570386,0.07476666666666668,0.07583878705155098,0.07740000000000001,0.07767379890327075,0.08558,0.08664468945066879,19416.0,5200793.386666671,64087.0,9827991.832857143
2019-08-13,0.0776,0.0789,0.0733,0.0769,11212317.45,5408.0,5332968.14,0.07686666666666667,0.07687142857142858,0.08451,0.07688469676288774,0.07752276188308979,0.08496311313308715,29.059829059829042,0.10252495285355848,0.06649504714644153,-0.009892726043554331,-0.011320098963826294,0.0014273729202719625,0.005599999999999994,0.007064285714285712,-523817198.3300001,-0.005500000000000005,-16.048034934497824,-78.53658536585367,21.463414634146343,20.217534607778536,-0.902061855670111,0.0758,0.0802,0.0754,0.0779,9542798.9,5058.0,4664281.19,2.7704485488126527,28.57142857142857,0.10272523221412365,0.06734476778587635,-0.010392589638352212,-0.011676942193894283,0.0012843525555420714,0.004799999999999999,0.006985714285714284,-512604880.8800001,-0.007100000000000009,-16.41630901287554,-75.67567567567568,24.32432432432432,17.22972972972977,0.07633333333333334,0.07686939352577549,0.0775,0.07773034917745306,0.085035,0.08581186188393843,17358.0,4990252.233333338,60520.0,9140244.067142857
2019-08-14,0.077,0.0778,0.0679,0.0693,11350679.09,6422.0,4605263.16,0.0747,0.07542857142857143,0.08271,0.07309234838144388,0.07546707141231734,0.08347138807279313,24.75728155339806,0.09909920055210104,0.06632079944789897,-0.009994625209526889,-0.011055004212966412,0.0010603790034395232,0.009899999999999992,0.007449999999999997,-535167877.4200001,-0.0087,-23.085460599334073,-93.96551724137932,6.034482758620683,17.274073905697126,-9.999999999999998,0.0776,0.0789,0.0733,0.0769,11212317.45,5408.0,5332968.14,-0.902061855670111,29.059829059829042,0.10252495285355848,0.06649504714644153,-0.009892726043554331,-0.011320098963826294,0.0014273729202719625,0.005599999999999994,0.007064285714285712,-523817198.3300001,-0.005500000000000005,-16.048034934497824,-78.53658536585367,21.463414634146343,20.217534607778536,0.07686666666666667,0.07688469676288774,0.07687142857142858,0.07752276188308979,0.08451,0.08496311313308715,16835.0,5238149.083333339,53164.0,7569259.632857142
2019-08-15,0.0694,0.0728,0.0685,0.0716,5883308.24,3191.0,3074630.15,0.0726,0.07428571428571429,0.081175,0.07234617419072194,0.07450030355923801,0.08234077968490806,33.602150537634415,0.09545356324779217,0.06689643675220783,-0.00977708609216034,-0.010799420588805198,0.0010223344966448587,0.004299999999999998,0.0071499999999999975,-529284569.18000007,-0.005600000000000008,-14.558472553699286,-83.70044052863437,16.29955947136562,14.599152288044229,3.1700288184437944,0.077,0.0778,0.0679,0.0693,11350679.09,6422.0,4605263.16,-9.999999999999998,24.75728155339806,0.09909920055210104,0.06632079944789897,-0.009994625209526889,-0.011055004212966412,0.0010603790034395232,0.009899999999999992,0.007449999999999997,-535167877.4200001,-0.0087,-23.085460599334073,-93.96551724137932,6.034482758620683,17.274073905697126,0.0747,0.07309234838144388,0.07542857142857143,0.07546707141231734,0.08271,0.08347138807279313,16888.0,4867504.163333339,45935.0,5538178.567142857
2019-08-16,0.0716,0.0728,0.065,0.067,11262624.16,5548.0,5661572.85,0.0693,0.0734,0.07994,0.06967308709536096,0.0726252276694285,0.08087975304825015,27.832512315270918,0.09465174253517245,0.06522825746482755,-0.009862181244170473,-0.010611972719878253,0.0007497914757077801,0.007800000000000001,0.007214285714285712,-540547193.34,-0.014299999999999993,-21.176470588235297,-92.18749999999999,7.812500000000007,10.048847409995448,-6.424581005586583,0.0694,0.0728,0.0685,0.0716,5883308.24,3191.0,3074630.15,3.1700288184437944,33.602150537634415,0.09545356324779217,0.06689643675220783,-0.00977708609216034,-0.010799420588805198,0.0010223344966448587,0.004299999999999998,0.0071499999999999975,-529284569.18000007,-0.005600000000000008,-14.558472553699286,-83.70044052863437,16.29955947136562,14.599152288044229,0.0726,0.07234617419072194,0.07428571428571429,0.07450030355923801,0.081175,0.08234077968490806,15021.0,4337620.483333339,39495.0,4754217.542857142
2019-08-17,0.0671,0.0676,0.0651,0.0665,5118619.46,3544.0,2488782.48,0.06836666666666667,0.07214285714285715,0.078755,0.06808654354768048,0.07109392075207138,0.07951025275794062,29.35064935064935,0.09380124100635118,0.06370875899364883,-0.009856347745099553,-0.010460847724922513,0.0006044999798229603,0.0024999999999999883,0.007021428571428567,-545665812.8000001,-0.012899999999999995,-19.296116504854368,-94.14062499999999,5.859375000000005,9.99047815712189,-0.8941877794336859,0.0716,0.0728,0.065,0.067,11262624.16,5548.0,5661572.85,-6.424581005586583,27.832512315270918,0.09465174253517245,0.06522825746482755,-0.009862181244170473,-0.010611972719878253,0.0007497914757077801,0.007800000000000001,0.007214285714285712,-540547193.34,-0.014299999999999993,-21.176470588235297,-92.18749999999999,7.812500000000007,10.048847409995448,0.0693,0.06967308709536096,0.0734,0.0726252276694285,0.07994,0.08087975304825015,15161.0,4447155.386666671,37927.0,4806455.857142857
2019-08-18,0.0665,0.0683,0.066,0.067,8641624.76,3820.0,4416978.11,0.06683333333333334,0.07088571428571429,0.077445,0.06754327177384024,0.07007044056405354,0.07831880011432722,34.10404624277457,0.09173927194810802,0.06315072805189198,-0.009699568248732304,-0.010308591829684473,0.0006090235809521685,0.0022999999999999965,0.00681428571428571,-537024188.0400001,-0.0126,-14.102564102564097,-92.18749999999999,7.812500000000007,7.161458333333353,0.7518796992481209,0.0671,0.0676,0.0651,0.0665,5118619.46,3544.0,2488782.48,-0.8941877794336859,29.35064935064935,0.09380124100635118,0.06370875899364883,-0.009856347745099553,-0.010460847724922513,0.0006044999798229603,0.0024999999999999883,0.007021428571428567,-545665812.8000001,-0.012899999999999995,-19.296116504854368,-94.14062499999999,5.859375000000005,9.99047815712189,0.06836666666666667,0.06808654354768048,0.07214285714285715,0.07109392075207138,0.078755,0.07951025275794062,12283.0,3741661.826666672,35540.0,4506385.127142856
2019-08-19,0.0669,0.0723,0.0665,0.0692,16950718.05,6723.0,8611485.87,0.06756666666666666,0.06964285714285715,0.076325,0.06837163588692012,0.06985283042304015,0.07745034296058177,38.888888888888864,0.08940835624090657,0.06324164375909344,-0.009290700344185512,-0.01010501353258468,0.0008143131883991683,0.0058,0.006621428571428568,-520073469.99000007,-0.0040000000000000036,-10.362694300518138,-83.59375000000001,16.406249999999982,10.026041666666677,3.437967115097155,0.0665,0.0683,0.066,0.067,8641624.76,3820.0,4416978.11,0.7518796992481209,34.10404624277457,0.09173927194810802,0.06315072805189198,-0.009699568248732304,-0.010308591829684473,0.0006090235809521685,0.0022999999999999965,0.00681428571428571,-537024188.0400001,-0.0126,-14.102564102564097,-92.18749999999999,7.812500000000007,7.161458333333353,0.06683333333333334,0.06754327177384024,0.07088571428571429,0.07007044056405354,0.077445,0.07831880011432722,12912.0,4189111.1466666716,32991.0,4320639.4399999995
2019-08-20,0.0692,0.0707,0.0662,0.0676,12981519.24,5729.0,6423856.64,0.06793333333333333,0.0683142857142857,0.0752,0.06798581794346006,0.06928962281728011,0.07651221505957399,29.552238805970134,0.0871131948077109,0.0632868051922891,-0.008992120642968685,-0.00988243495466148,0.0008903143116927963,0.004500000000000004,0.006021428571428568,-533054989.2300001,-0.007700000000000012,-16.85116851168512,-89.84375000000003,10.156249999999966,11.458333333333329,-2.3121387283237054,0.0669,0.0723,0.0665,0.0692,16950718.05,6723.0,8611485.87,3.437967115097155,38.888888888888864,0.08940835624090657,0.06324164375909344,-0.009290700344185512,-0.01010501353258468,0.0008143131883991683,0.0058,0.006621428571428568,-520073469.99000007,-0.0040000000000000036,-10.362694300518138,-83.59375000000001,16.406249999999982,10.026041666666677,0.06756666666666666,0.06837163588692012,0.06964285714285715,0.06985283042304015,0.076325,0.07745034296058177,14087.0,5172415.486666671,34656.0,4884525.8228571415
2019-08-21,0.0677,0.0685,0.0615,0.0636,16988489.88,5735.0,7561310.97,0.0668,0.0675,0.07419,0.06579290897173004,0.06786721711296008,0.07528248029199552,27.80898876404494,0.08645323559948909,0.061926764400510925,-0.008974804687394602,-0.009700908901208106,0.0007261042138135033,0.007000000000000006,0.005557142857142855,-550043479.1100001,-0.012200000000000003,-19.899244332493694,-90.27777777777776,9.722222222222246,12.09490740740741,-6.0561299852289405,0.0692,0.0707,0.0662,0.0676,12981519.24,5729.0,6423856.64,-2.3121387283237054,29.552238805970134,0.0871131948077109,0.0632868051922891,-0.008992120642968685,-0.00988243495466148,0.0008903143116927963,0.004500000000000004,0.006021428571428568,-533054989.2300001,-0.007700000000000012,-16.85116851168512,-89.84375000000003,10.156249999999966,11.458333333333329,0.06793333333333333,0.06798581794346006,0.0683142857142857,0.06928962281728011,0.0752,0.07651221505957399,16272.0,6484106.873333338,34977.0,5040367.037142856
2019-08-22,0.0637,0.0666,0.0609,0.0653,15498044.73,5518.0,8013471.36,0.06549999999999999,0.0666,0.073205,0.06554645448586502,0.06722541283472006,0.07433176788323405,30.72776280323447,0.08496675336016785,0.06144324663983217,-0.008723348543427503,-0.009505396829651985,0.0007820482862244821,0.005700000000000004,0.005585714285714283,-534545434.3800001,-0.0126,-17.96482412060302,-77.319587628866,22.680412371133997,14.186294864452082,2.5117739403453534,0.0677,0.0685,0.0615,0.0636,16988489.88,5735.0,7561310.97,-6.0561299852289405,27.80898876404494,0.08645323559948909,0.061926764400510925,-0.008974804687394602,-0.009700908901208106,0.0007261042138135033,0.007000000000000006,0.005557142857142855,-550043479.1100001,-0.012200000000000003,-19.899244332493694,-90.27777777777776,9.722222222222246,12.09490740740741,0.0668,0.06579290897173004,0.0675,0.06786721711296008,0.07419,0.07528248029199552,18187.0,7532217.826666671,34290.0,5462659.581428571
2019-08-23,0.0651,0.0667,0.0639,0.0656,14425065.15,7123.0,6959893.44,0.06483333333333334,0.0664,0.072365,0.06557322724293252,0.06681905962604004,0.07350017094197366,37.74193548387097,0.08375553623801929,0.06097446376198071,-0.008402995740679181,-0.009284916611857425,0.0008819208711782437,0.002799999999999997,0.005228571428571425,-520120369.23000014,-0.01129999999999999,-10.382513661202175,-75.77319587628864,24.22680412371136,18.87647957235588,0.76804915514593,0.0637,0.0666,0.0609,0.0653,15498044.73,5518.0,8013471.36,2.5117739403453534,30.72776280323447,0.08496675336016785,0.06144324663983217,-0.008723348543427503,-0.009505396829651985,0.0007820482862244821,0.005700000000000004,0.005585714285714283,-534545434.3800001,-0.0126,-17.96482412060302,-77.319587628866,22.680412371133997,14.186294864452082,0.06549999999999999,0.06554645448586502,0.0666,0.06722541283472006,0.073205,0.07433176788323405,16982.0,7332879.656666671,36617.0,6168208.3257142855
2019-08-24,0.0656,0.0682,0.0623,0.0673,19886384.78,7340.0,9260680.32,0.06606666666666666,0.06651428571428572,0.07183,0.06643661362146626,0.06693929471953003,0.0729096784713095,36.928104575163374,0.08311074279003358,0.060549257209966435,-0.007920633906723332,-0.009012060070830606,0.0010914261641072742,0.0058999999999999955,0.005321428571428569,-500233984.45000017,-0.0020000000000000018,-10.6241699867198,-67.01030927835052,32.989690721649474,26.63230240549829,2.591463414634136,0.0651,0.0667,0.0639,0.0656,14425065.15,7123.0,6959893.44,0.76804915514593,37.74193548387097,0.08375553623801929,0.06097446376198071,-0.008402995740679181,-0.009284916611857425,0.0008819208711782437,0.002799999999999997,0.005228571428571425,-520120369.23000014,-0.01129999999999999,-10.382513661202175,-75.77319587628864,24.22680412371136,18.87647957235588,0.06483333333333334,0.06557322724293252,0.0664,0.06681905962604004,0.072365,0.07350017094197366,18376.0,7511558.5900000045,38192.0,6353682.695714286
2019-08-25,0.0672,0.0701,0.0618,0.0626,28175809.83,9041.0,12546779.22,0.06516666666666666,0.06588571428571428,0.07110000000000001,0.06451830681073313,0.06585447103964752,0.07192780433118479,31.034482758620655,0.08279939269679597,0.05940060730320405,-0.007827380231610073,-0.0087751241029865,0.0009477438713764268,0.008299999999999995,0.005514285714285712,-528409794.28000015,-0.008999999999999994,-17.41424802110818,-91.19170984455958,8.80829015544042,22.008261666933763,-6.845238095238085,0.0656,0.0682,0.0623,0.0673,19886384.78,7340.0,9260680.32,2.591463414634136,36.928104575163374,0.08311074279003358,0.060549257209966435,-0.007920633906723332,-0.009012060070830606,0.0010914261641072742,0.0058999999999999955,0.005321428571428569,-500233984.45000017,-0.0020000000000000018,-10.6241699867198,-67.01030927835052,32.989690721649474,26.63230240549829,0.06606666666666666,0.06643661362146626,0.06651428571428572,0.06693929471953003,0.07183,0.0729096784713095,19981.0,8078015.040000006,41988.0,7321096.672857142
2019-08-26,0.0628,0.0634,0.0594,0.0607,22818201.74,8238.0,8972010.38,0.06353333333333334,0.06467142857142857,0.07007,0.06260915340536656,0.06456585327973563,0.07085848963297672,25.14450867052021,0.0816145316287182,0.05852546837128178,-0.007816684272685323,-0.008583436136926265,0.0007667518642409422,0.003999999999999997,0.005457142857142855,-551227996.0200001,-0.006300000000000007,-22.079589216944807,-93.33333333333336,6.666666666666646,16.154882514585527,-3.3439490445859836,0.0672,0.0701,0.0618,0.0626,28175809.83,9041.0,12546779.22,-6.845238095238085,31.034482758620655,0.08279939269679597,0.05940060730320405,-0.007827380231610073,-0.0087751241029865,0.0009477438713764268,0.008299999999999995,0.005514285714285712,-528409794.28000015,-0.008999999999999994,-17.41424802110818,-91.19170984455958,8.80829015544042,22.008261666933763,0.06516666666666666,0.06451830681073313,0.06588571428571428,0.06585447103964752,0.07110000000000001,0.07192780433118479,23504.0,9589117.660000006,47209.0,8482496.83142857
2019-08-27,0.0608,0.0623,0.0588,0.0606,20909307.19,7911.0,9660510.31,0.0613,0.06367142857142857,0.06913,0.06160457670268328,0.06357438995980172,0.06988149062031226,25.81602373887239,0.08053657243596876,0.05772342756403123,-0.007727202432813399,-0.008412189396103692,0.0006849869632902933,0.003500000000000003,0.005307142857142856,-572137303.2100002,-0.0059000000000000025,-21.1963589076723,-90.52631578947367,9.473684210526335,8.316213677544479,-0.32894736842105066,0.0628,0.0634,0.0594,0.0607,22818201.74,8238.0,8972010.38,-3.3439490445859836,25.14450867052021,0.0816145316287182,0.05852546837128178,-0.007816684272685323,-0.008583436136926265,0.0007667518642409422,0.003999999999999997,0.005457142857142855,-551227996.0200001,-0.006300000000000007,-22.079589216944807,-93.33333333333336,6.666666666666646,16.154882514585527,0.06353333333333334,0.06260915340536656,0.06467142857142857,0.06456585327973563,0.07007,0.07085848963297672,24619.0,10259823.306666672,48724.0,8534000.332857143
2019-08-28,0.0606,0.0607,0.0514,0.052,22590735.3,8194.0,9720564.54,0.05776666666666667,0.06201428571428571,0.06775,0.05680228835134164,0.06068079246985129,0.06817849151361587,25.07204610951007,0.08043027892770392,0.05506972107229609,-0.008255076177269158,-0.008380766752336786,0.00012569057506762842,0.009299999999999996,0.0052642857142857135,-594728038.5100001,-0.015000000000000006,-24.963924963924967,-97.19626168224302,2.803738317756992,6.314696398316669,-14.191419141914196,0.0608,0.0623,0.0588,0.0606,20909307.19,7911.0,9660510.31,-0.32894736842105066,25.81602373887239,0.08053657243596876,0.05772342756403123,-0.007727202432813399,-0.008412189396103692,0.0006849869632902933,0.003500000000000003,0.005307142857142856,-572137303.2100002,-0.0059000000000000025,-21.1963589076723,-90.52631578947367,9.473684210526335,8.316213677544479,0.0613,0.06160457670268328,0.06367142857142857,0.06357438995980172,0.06913,0.06988149062031226,25190.0,10393099.970000006,50906.0,8996379.42857143
2019-08-29,0.0521,0.0528,0.0494,0.0502,22227502.82,7108.0,11764326.4,0.054266666666666664,0.05985714285714285,0.0666,0.053501144175670826,0.058060594352388466,0.06646625422660483,18.71345029239764,0.08122226132702984,0.051977738672970175,-0.008718167274181565,-0.008448246856705742,-0.0002699204174758229,0.0034000000000000002,0.005199999999999998,-616955541.3300002,-0.018999999999999996,-29.88826815642458,-96.58119658119656,3.4188034188034275,5.232075315695597,-3.6468330134356983,0.0606,0.0607,0.0514,0.052,22590735.3,8194.0,9720564.54,-14.191419141914196,25.07204610951007,0.08043027892770392,0.05506972107229609,-0.008255076177269158,-0.008380766752336786,0.00012569057506762842,0.009299999999999996,0.0052642857142857135,-594728038.5100001,-0.015000000000000006,-24.963924963924967,-97.19626168224302,2.803738317756992,6.314696398316669,0.05776666666666667,0.05680228835134164,0.06201428571428571,0.06068079246985129,0.06775,0.06817849151361587,24343.0,9451028.410000006,53365.0,9304844.224285714
2019-08-30,0.0502,0.0523,0.049,0.0516,16907350.88,6004.0,8469657.21,0.05126666666666666,0.057857142857142864,0.065415,0.05255057208783541,0.05644544576429135,0.06505042049073771,25.161290322580626,0.08088534854845521,0.049944651451544794,-0.008869954688865846,-0.008532588423137763,-0.0003373662657280823,0.0032999999999999974,0.0048785714285714266,-600048190.4500002,-0.015999999999999993,-22.985074626865675,-88.84120171673821,11.158798283261794,5.793780006607416,2.788844621513941,0.0521,0.0528,0.0494,0.0502,22227502.82,7108.0,11764326.4,-3.6468330134356983,18.71345029239764,0.08122226132702984,0.051977738672970175,-0.008718167274181565,-0.008448246856705742,-0.0002699204174758229,0.0034000000000000002,0.005199999999999998,-616955541.3300002,-0.018999999999999996,-29.88826815642458,-96.58119658119656,3.4188034188034275,5.232075315695597,0.054266666666666664,0.053501144175670826,0.05985714285714285,0.058060594352388466,0.0666,0.06646625422660483,23213.0,10381800.416666672,54955.0,9840680.658571428
2019-08-31,0.0516,0.0538,0.0495,0.0505,16856580.95,6352.0,8632716.08,0.05076666666666666,0.05545714285714286,0.06415,0.051525286043917706,0.05495908432321851,0.0636646661582865,24.683544303797447,0.08017254989891817,0.048127450101081826,-0.008975543635540241,-0.008621179465618259,-0.0003543641699219821,0.004299999999999998,0.005007142857142857,-616904771.4000002,-0.0131,-24.06015037593985,-93.56223175965664,6.4377682403433525,7.0051233141362035,-2.1317829457364277,0.0502,0.0523,0.049,0.0516,16907350.88,6004.0,8469657.21,2.788844621513941,25.161290322580626,0.08088534854845521,0.049944651451544794,-0.008869954688865846,-0.008532588423137763,-0.0003373662657280823,0.0032999999999999974,0.0048785714285714266,-600048190.4500002,-0.015999999999999993,-22.985074626865675,-88.84120171673821,11.158798283261794,5.793780006607416,0.05126666666666666,0.05255057208783541,0.057857142857142864,0.05644544576429135,0.065415,0.06505042049073771,21306.0,9984849.383333338,53836.0,10056361.197142856
2019-09-01,0.0504,0.0512,0.0477,0.0488,13470772.89,5597.0,6315084.38,0.050300000000000004,0.05348571428571429,0.06269499999999999,0.05016264302195886,0.05341931324241389,0.06224898366702112,22.25609756097559,0.07874524675987249,0.04664475324012748,-0.009091597156318867,-0.00871526300375838,-0.00037633415256048755,0.003500000000000003,0.005092857142857143,-630375544.2900002,-0.016499999999999994,-27.164179104477615,-95.52845528455282,4.471544715447169,7.356037079684117,-3.1746031746031687,0.0516,0.0538,0.0495,0.0505,16856580.95,6352.0,8632716.08,-2.1317829457364277,24.683544303797447,0.08017254989891817,0.048127450101081826,-0.008975543635540241,-0.008621179465618259,-0.0003543641699219821,0.004299999999999998,0.005007142857142857,-616904771.4000002,-0.0131,-24.06015037593985,-93.56223175965664,6.4377682403433525,7.0051233141362035,0.05076666666666666,0.051525286043917706,0.05545714285714286,0.05495908432321851,0.06415,0.0636646661582865,19464.0,9622233.230000004,52848.0,9966652.02
2019-09-02,0.0488,0.0511,0.0481,0.0494,17947626.36,6690.0,7564877.47,0.04956666666666667,0.051871428571428575,0.06132,0.04978132151097943,0.05241448493181042,0.061025270936828635,18.269230769230745,0.07695270525802805,0.04568729474197194,-0.009031051086771429,-0.00877842062036099,-0.00025263046641043826,0.0030000000000000027,0.004892857142857143,-612427917.9300002,-0.016200000000000006,-28.612716763005775,-92.6086956521739,7.391304347826087,6.100205767872215,1.229508196721304,0.0504,0.0512,0.0477,0.0488,13470772.89,5597.0,6315084.38,-3.1746031746031687,22.25609756097559,0.07874524675987249,0.04664475324012748,-0.009091597156318867,-0.00871526300375838,-0.00037633415256048755,0.003500000000000003,0.005092857142857143,-630375544.2900002,-0.016499999999999994,-27.164179104477615,-95.52845528455282,4.471544715447169,7.356037079684117,0.050300000000000004,0.05016264302195886,0.05348571428571429,0.05341931324241389,0.06269499999999999,0.06224898366702112,17953.0,7805819.223333339,49404.0,9076409.9
2019-09-03,0.0494,0.051,0.0488,0.0496,21446846.93,6170.0,9263729.49,0.04926666666666666,0.0503,0.06033500000000001,0.04969066075548971,0.051710863698857815,0.05993714989522591,19.79865771812078,0.07632898242103509,0.04434101757896493,-0.008864742330439143,-0.008795684962376621,-6.905736806252227e-05,0.0021999999999999936,0.0047285714285714275,-590981071.0000002,-0.0177,-26.627218934911234,-91.51785714285715,8.482142857142854,6.781663973472049,0.4048582995951393,0.0488,0.0511,0.0481,0.0494,17947626.36,6690.0,7564877.47,1.229508196721304,18.269230769230745,0.07695270525802805,0.04568729474197194,-0.009031051086771429,-0.00877842062036099,-0.00025263046641043826,0.0030000000000000027,0.004892857142857143,-612427917.9300002,-0.016200000000000006,-28.612716763005775,-92.6086956521739,7.391304347826087,6.100205767872215,0.04956666666666667,0.04978132151097943,0.051871428571428575,0.05241448493181042,0.06132,0.061025270936828635,18639.0,7504225.976666671,47856.0,8875390.912857143
2019-09-04,0.0496,0.0529,0.049,0.0492,35254835.54,7508.0,15997353.29,0.0494,0.0499,0.059215,0.04944533037774486,0.05108314777414336,0.05891456419091868,22.519083969465626,0.07502362855665459,0.04340637144334541,-0.008665329574561266,-0.008769613884813551,0.0001042843102522853,0.0039000000000000007,0.004507142857142856,-626235906.5400002,-0.013400000000000002,-22.64150943396227,-93.30357142857142,6.696428571428578,7.523291925465851,-0.8064516129032209,0.0494,0.051,0.0488,0.0496,21446846.93,6170.0,9263729.49,0.4048582995951393,19.79865771812078,0.07632898242103509,0.04434101757896493,-0.008864742330439143,-0.008795684962376621,-6.905736806252227e-05,0.0021999999999999936,0.0047285714285714275,-590981071.0000002,-0.0177,-26.627218934911234,-91.51785714285715,8.482142857142854,6.781663973472049,0.04926666666666666,0.04969066075548971,0.0503,0.051710863698857815,0.06033500000000001,0.05993714989522591,18457.0,7714563.780000005,46115.0,8818707.938571429
2019-09-05,0.0492,0.0576,0.0487,0.0524,43122643.25,11396.0,24086773.59,0.0504,0.05021428571428572,0.058484999999999995,0.05092266518887243,0.051412360830607524,0.058294129506069284,26.714801444043317,0.07412748936980239,0.0428425106301976,-0.00815507365956223,-0.008646705839763288,0.0004916321802010577,0.008899999999999998,0.004735714285714283,-583113263.2900002,-0.008299999999999995,-19.754977029096466,-79.01785714285712,20.982142857142875,12.053571428571447,6.50406504065041,0.0496,0.0529,0.049,0.0492,35254835.54,7508.0,15997353.29,-0.8064516129032209,22.519083969465626,0.07502362855665459,0.04340637144334541,-0.008665329574561266,-0.008769613884813551,0.0001042843102522853,0.0039000000000000007,0.004507142857142856,-626235906.5400002,-0.013400000000000002,-22.64150943396227,-93.30357142857142,6.696428571428578,7.523291925465851,0.0494,0.04944533037774486,0.0499,0.05108314777414336,0.059215,0.05891456419091868,20368.0,10941986.750000006,45429.0,9715392.045714285
2019-09-06,0.0524,0.0551,0.0492,0.0497,41553176.98,7385.0,16893888.12,0.05043333333333333,0.04994285714285714,0.057645,0.050311332594436216,0.050984270622955644,0.05747564098168173,23.588039867109615,0.07327957369860187,0.04201042630139813,-0.007877749809810146,-0.00849291463377266,0.0006151648239625142,0.0059000000000000025,0.004957142857142856,-624666440.2700002,-0.0109,-24.237804878048784,-91.07142857142856,8.928571428571438,12.202380952380976,-5.152671755725192,0.0492,0.0576,0.0487,0.0524,43122643.25,11396.0,24086773.59,6.50406504065041,26.714801444043317,0.07412748936980239,0.0428425106301976,-0.00815507365956223,-0.008646705839763288,0.0004916321802010577,0.008899999999999998,0.004735714285714283,-583113263.2900002,-0.008299999999999995,-19.754977029096466,-79.01785714285712,20.982142857142875,12.053571428571447,0.0504,0.05092266518887243,0.05021428571428572,0.051412360830607524,0.058484999999999995,0.058294129506069284,25074.0,16449285.456666673,49717.0,11475741.644285712
2019-09-07,0.0495,0.0524,0.0493,0.0514,27641214.04,5671.0,12330939.34,0.05116666666666667,0.05007142857142858,0.056865,0.050855666297218105,0.051088202967216736,0.05689700850723585,23.58803986710963,0.07208552284876067,0.041644477151239326,-0.007435085827129047,-0.008281348872443937,0.0008462630453148906,0.0031000000000000055,0.0047571428571428565,-597025226.2300003,-0.0005999999999999964,-23.625557206537884,-83.48214285714285,16.517857142857153,15.476190476190501,3.838383838383836,0.0524,0.0551,0.0492,0.0497,41553176.98,7385.0,16893888.12,-5.152671755725192,23.588039867109615,0.07327957369860187,0.04201042630139813,-0.007877749809810146,-0.00849291463377266,0.0006151648239625142,0.0059000000000000025,0.004957142857142856,-624666440.2700002,-0.0109,-24.237804878048784,-91.07142857142856,8.928571428571438,12.202380952380976,0.05043333333333333,0.050311332594436216,0.04994285714285714,0.050984270622955644,0.057645,0.05747564098168173,26289.0,18992671.66666667,51098.0,12679203.202857142
2019-09-08,0.0514,0.0543,0.0508,0.0536,25337230.79,6718.0,14641332.27,0.05156666666666667,0.050757142857142855,0.05608500000000001,0.05222783314860906,0.05171615222541256,0.05658300769702291,33.69565217391303,0.07020289085187431,0.04196710914812571,-0.006828040418166599,-0.00799068718158847,0.0011626467634218707,0.003500000000000003,0.004414285714285714,-571687995.4400003,0.0034000000000000002,-14.376996805111819,-62.42038216560508,37.579617834394924,21.008682135274515,4.280155642023347,0.0495,0.0524,0.0493,0.0514,27641214.04,5671.0,12330939.34,3.838383838383836,23.58803986710963,0.07208552284876067,0.041644477151239326,-0.007435085827129047,-0.008281348872443937,0.0008462630453148906,0.0031000000000000055,0.0047571428571428565,-597025226.2300003,-0.0005999999999999964,-23.625557206537884,-83.48214285714285,16.517857142857153,15.476190476190501,0.05116666666666667,0.050855666297218105,0.05007142857142858,0.051088202967216736,0.056865,0.05689700850723585,24452.0,17770533.683333337,50417.0,13207520.811428573
2019-09-09,0.0535,0.0551,0.0507,0.0523,41348688.05,7644.0,22627524.68,0.05243333333333333,0.051171428571428576,0.05532,0.05226391657430453,0.05186211416905942,0.056175102202068346,34.44444444444444,0.0684330469380756,0.04220695306192441,-0.006378326318060221,-0.007668215008882821,0.0012898886908226,0.004400000000000001,0.004442857142857143,-613036683.4900002,0.0006999999999999992,-13.838550247116965,-68.49315068493152,31.506849315068486,28.534774764106867,-2.242990654205607,0.0514,0.0543,0.0508,0.0536,25337230.79,6718.0,14641332.27,4.280155642023347,33.69565217391303,0.07020289085187431,0.04196710914812571,-0.006828040418166599,-0.00799068718158847,0.0011626467634218707,0.003500000000000003,0.004414285714285714,-571687995.4400003,0.0034000000000000002,-14.376996805111819,-62.42038216560508,37.579617834394924,21.008682135274515,0.05156666666666667,0.05222783314860906,0.050757142857142855,0.05171615222541256,0.05608500000000001,0.05658300769702291,19774.0,14622053.24333334,51538.0,14396984.795714285
2019-09-10,0.0523,0.054,0.0515,0.0523,31591098.05,6114.0,16237831.87,0.05273333333333333,0.05155714285714286,0.05475500000000001,0.052281958287152264,0.05197158562679456,0.05580604484949041,34.5724907063197,0.06732856876861626,0.04218143123138377,-0.005953298731731171,-0.007325231753452491,0.0013719330217213197,0.0025000000000000022,0.004371428571428572,-644627781.5400002,0.001799999999999996,-13.696369636963702,-64.61538461538461,35.384615384615394,34.82369417802628,0.0,0.0535,0.0551,0.0507,0.0523,41348688.05,7644.0,22627524.68,-2.242990654205607,34.44444444444444,0.0684330469380756,0.04220695306192441,-0.006378326318060221,-0.007668215008882821,0.0012898886908226,0.004400000000000001,0.004442857142857143,-613036683.4900002,0.0006999999999999992,-13.838550247116965,-68.49315068493152,31.506849315068486,28.534774764106867,0.05243333333333333,0.05226391657430453,0.051171428571428576,0.05186211416905942,0.05532,0.056175102202068346,20033.0,16533265.430000005,52492.0,16548791.539999997
2019-09-11,0.0522,0.0578,0.051,0.0572,45341635.75,11704.0,23159072.11,0.05393333333333333,0.052700000000000004,0.054349999999999996,0.05474097914357613,0.053278689220095925,0.05593880248287227,61.20689655172415,0.06597981648948607,0.04272018351051392,-0.005161572859459347,-0.006892499974653863,0.0017309271151945155,0.0068000000000000005,0.004192857142857143,-599286145.7900002,0.008399999999999998,10.000000000000009,-5.940594059405906,94.0594059405941,53.65029021342601,9.578544061302678,0.0523,0.054,0.0515,0.0523,31591098.05,6114.0,16237831.87,0.0,34.5724907063197,0.06732856876861626,0.04218143123138377,-0.005953298731731171,-0.007325231753452491,0.0013719330217213197,0.0025000000000000022,0.004371428571428572,-644627781.5400002,0.001799999999999996,-13.696369636963702,-64.61538461538461,35.384615384615394,34.82369417802628,0.05273333333333333,0.052281958287152264,0.05155714285714286,0.05197158562679456,0.05475500000000001,0.05580604484949041,20476.0,17835562.940000005,52436.0,17545091.88
2019-09-12,0.0571,0.0572,0.0526,0.0532,34448610.44,8095.0,19014114.02,0.054233333333333335,0.05281428571428571,0.05373,0.053970489571788065,0.05325901691507194,0.05567796415117015,55.905511811023615,0.06408701643688276,0.04337298356311724,-0.004801541787343697,-0.00647430833719183,0.0016727665498481332,0.0046,0.004278571428571429,-633734756.2300003,0.003799999999999998,5.976095617529875,-45.54455445544555,54.45544554455445,61.29982228992134,-6.83012259194396,0.0522,0.0578,0.051,0.0572,45341635.75,11704.0,23159072.11,9.578544061302678,61.20689655172415,0.06597981648948607,0.04272018351051392,-0.005161572859459347,-0.006892499974653863,0.0017309271151945155,0.0068000000000000005,0.004192857142857143,-599286145.7900002,0.008399999999999998,10.000000000000009,-5.940594059405906,94.0594059405941,53.65029021342601,0.05393333333333333,0.05474097914357613,0.052700000000000004,0.053278689220095925,0.054349999999999996,0.05593880248287227,25462.0,20674809.55333334,56632.0,18568194.568571426
2019-09-13,0.0533,0.0567,0.0523,0.0565,27729686.96,7285.0,14119985.62,0.05563333333333333,0.05378571428571428,0.053189999999999994,0.05523524478589403,0.05406926268630395,0.05575625327963014,58.97435897435897,0.061489879517208426,0.04489012048279156,-0.004201499872867415,-0.006019746644326947,0.0018182467714595325,0.004400000000000001,0.004357142857142858,-606005069.2700002,0.006900000000000003,9.496124031007746,-12.87128712871283,87.12871287128718,78.54785478547859,6.003752345215762,0.0571,0.0572,0.0526,0.0532,34448610.44,8095.0,19014114.02,-6.83012259194396,55.905511811023615,0.06408701643688276,0.04337298356311724,-0.004801541787343697,-0.00647430833719183,0.0016727665498481332,0.0046,0.004278571428571429,-633734756.2300003,0.003799999999999998,5.976095617529875,-45.54455445544555,54.45544554455445,61.29982228992134,0.054233333333333335,0.053970489571788065,0.05281428571428571,0.05325901691507194,0.05373,0.05567796415117015,25913.0,19470339.33333334,53331.0,17843528.915714283
2019-09-14,0.0565,0.0567,0.0543,0.0554,20658962.85,5549.0,9751936.07,0.05503333333333333,0.05435714285714285,0.05283,0.05531762239294702,0.05440194701472796,0.05572232439585584,58.97435897435896,0.059952418276501294,0.04570758172349871,-0.003771250511122544,-0.005570047417686067,0.0017987969065635231,0.0023999999999999994,0.004221428571428572,-626664032.1200002,0.006199999999999997,9.70297029702969,-23.762376237623762,76.23762376237624,72.60726072607264,-1.9469026548672632,0.0533,0.0567,0.0523,0.0565,27729686.96,7285.0,14119985.62,6.003752345215762,58.97435897435897,0.061489879517208426,0.04489012048279156,-0.004201499872867415,-0.006019746644326947,0.0018182467714595325,0.004400000000000001,0.004357142857142858,-606005069.2700002,0.006900000000000003,9.496124031007746,-12.87128712871283,87.12871287128718,78.54785478547859,0.05563333333333333,0.05523524478589403,0.05378571428571428,0.05406926268630395,0.053189999999999994,0.05575625327963014,27084.0,18764390.58333334,53231.0,17447257.13
2019-09-15,0.0554,0.0603,0.0552,0.0599,31735041.77,6780.0,15712213.36,0.05726666666666667,0.05525714285714285,0.052790000000000004,0.057608811196473514,0.055776460261045976,0.05612019826291719,68.43853820598005,0.05973304650258219,0.04584695349741782,-0.003032208982563206,-0.005062479730661496,0.0020302707480982897,0.0051,0.0043357142857142865,-594928990.3500003,0.0075,22.745901639344268,-3.278688524590143,96.72131147540985,86.69588270302444,8.122743682310476,0.0565,0.0567,0.0543,0.0554,20658962.85,5549.0,9751936.07,-1.9469026548672632,58.97435897435896,0.059952418276501294,0.04570758172349871,-0.003771250511122544,-0.005570047417686067,0.0017987969065635231,0.0023999999999999994,0.004221428571428572,-626664032.1200002,0.006199999999999997,9.70297029702969,-23.762376237623762,76.23762376237624,72.60726072607264,0.05503333333333333,0.05531762239294702,0.05435714285714285,0.05440194701472796,0.05283,0.05572232439585584,20929.0,14295345.236666672,53109.0,17078828.09142857
2019-09-16,0.0598,0.0599,0.0563,0.0582,32392501.15,7609.0,16265496.25,0.05783333333333333,0.0561,0.052669999999999995,0.05790440559823676,0.05638234519578448,0.056318274618829836,64.1025641025641,0.05910938539075764,0.04623061460924235,-0.002554245289446193,-0.004560832842418435,0.0020065875529722424,0.003599999999999999,0.004378571428571429,-627321491.5000002,0.0085,17.81376518218625,-18.10344827586205,81.89655172413795,84.95182898730803,-2.675585284280932,0.0554,0.0603,0.0552,0.0599,31735041.77,6780.0,15712213.36,8.122743682310476,68.43853820598005,0.05973304650258219,0.04584695349741782,-0.003032208982563206,-0.005062479730661496,0.0020302707480982897,0.0051,0.0043357142857142865,-594928990.3500003,0.0075,22.745901639344268,-3.278688524590143,96.72131147540985,86.69588270302444,0.05726666666666667,0.057608811196473514,0.05525714285714285,0.055776460261045976,0.052790000000000004,0.05612019826291719,19614.0,13194711.683333337,53171.0,17231811.104285713
2019-09-17,0.0582,0.06,0.0566,0.0598,23088446.37,8318.0,12882029.14,0.0593,0.057171428571428574,0.053059999999999996,0.058852202799118375,0.05723675889683836,0.05664986751227461,65.64417177914109,0.06023169876375681,0.045888301236243184,-0.002023028774446302,-0.004053272028824008,0.0020302432543777066,0.0034000000000000002,0.004464285714285715,-604233045.1300002,0.008399999999999998,20.56451612903225,-4.310344827586212,95.6896551724138,91.43583945732054,2.7491408934707855,0.0598,0.0599,0.0563,0.0582,32392501.15,7609.0,16265496.25,-2.675585284280932,64.1025641025641,0.05910938539075764,0.04623061460924235,-0.002554245289446193,-0.004560832842418435,0.0020065875529722424,0.003599999999999999,0.004378571428571429,-627321491.5000002,0.0085,17.81376518218625,-18.10344827586205,81.89655172413795,84.95182898730803,0.05783333333333333,0.05790440559823676,0.0561,0.05638234519578448,0.052669999999999995,0.056318274618829836,19938.0,13909881.893333338,53136.0,16322949.899999997
2019-09-18,0.0597,0.063,0.0583,0.0621,32568075.21,9933.0,15926741.98,0.060033333333333334,0.057871428571428574,0.053654999999999994,0.06047610139955919,0.05845256917262877,0.057168927749200835,68.69565217391303,0.06174358194586123,0.04556641805413876,-0.0014003032567176457,-0.003522678274402736,0.00212237501768509,0.004700000000000003,0.004521428571428573,-571664969.9200002,0.0085,26.21951219512195,-6.293706293706281,93.70629370629372,90.43083353428183,4.020100502512562,0.0582,0.06,0.0566,0.0598,23088446.37,8318.0,12882029.14,2.7491408934707855,65.64417177914109,0.06023169876375681,0.045888301236243184,-0.002023028774446302,-0.004053272028824008,0.0020302432543777066,0.0034000000000000002,0.004464285714285715,-604233045.1300002,0.008399999999999998,20.56451612903225,-4.310344827586212,95.6896551724138,91.43583945732054,0.0593,0.058852202799118375,0.057171428571428574,0.05723675889683836,0.053059999999999996,0.05664986751227461,22707.0,14953246.250000006,55340.0,15843549.51
2019-09-19,0.062,0.0622,0.0563,0.0585,31221464.7,8856.0,13384600.21,0.06013333333333334,0.05862857142857143,0.054000000000000006,0.059488050699779596,0.05846442687947158,0.05729569653499123,58.73925501432664,0.062305229804492976,0.04569477019550704,-0.0011836345091328915,-0.003054869521348767,0.0018712350122158756,0.0058999999999999955,0.004307142857142858,-602886434.6200002,0.006200000000000004,11.641221374045795,-32.60869565217389,67.39130434782611,85.59575107551122,-5.645161290322574,0.0597,0.063,0.0583,0.0621,32568075.21,9933.0,15926741.98,4.020100502512562,68.69565217391303,0.06174358194586123,0.04556641805413876,-0.0014003032567176457,-0.003522678274402736,0.00212237501768509,0.004700000000000003,0.004521428571428573,-571664969.9200002,0.0085,26.21951219512195,-6.293706293706281,93.70629370629372,90.43083353428183,0.060033333333333334,0.06047610139955919,0.057871428571428574,0.05845256917262877,0.053654999999999994,0.057168927749200835,25860.0,15024755.790000007,53569.0,14810359.491428569
2019-09-20,0.0585,0.0586,0.0556,0.057,33480660.45,7244.0,14425079.49,0.0592,0.058699999999999995,0.054325,0.0582440253498898,0.058098320159603686,0.05726753496023016,60.830860534124625,0.06256198335175062,0.04608801664824938,-0.0011200491996675374,-0.0026679054570125215,0.001547856257344984,0.0030000000000000027,0.004100000000000001,-636367095.0700003,0.004700000000000003,14.68812877263581,-43.79562043795618,56.20437956204382,72.43399253872123,-2.564102564102566,0.062,0.0622,0.0563,0.0585,31221464.7,8856.0,13384600.21,-5.645161290322574,58.73925501432664,0.062305229804492976,0.04569477019550704,-0.0011836345091328915,-0.003054869521348767,0.0018712350122158756,0.0058999999999999955,0.004307142857142858,-602886434.6200002,0.006200000000000004,11.641221374045795,-32.60869565217389,67.39130434782611,85.59575107551122,0.06013333333333334,0.059488050699779596,0.05862857142857143,0.05846442687947158,0.054000000000000006,0.05729569653499123,27107.0,14064457.110000007,54330.0,14006143.232857142
2019-09-21,0.057,0.0595,0.0565,0.0574,24736909.16,6778.0,11177861.58,0.057633333333333335,0.058985714285714294,0.05475500000000001,0.0578220126749449,0.05792374011970276,0.05728015067830348,59.25925925925925,0.0626691379156256,0.04684086208437442,-0.001025558724164287,-0.0023394361104428748,0.0013138773862785879,0.0029999999999999957,0.004092857142857143,-611630185.9100003,0.0001999999999999988,11.673151750972766,-45.52845528455286,54.47154471544714,59.355742875105705,0.701754385964908,0.0585,0.0586,0.0556,0.057,33480660.45,7244.0,14425079.49,-2.564102564102566,60.830860534124625,0.06256198335175062,0.04608801664824938,-0.0011200491996675374,-0.0026679054570125215,0.001547856257344984,0.0030000000000000027,0.004100000000000001,-636367095.0700003,0.004700000000000003,14.68812877263581,-43.79562043795618,56.20437956204382,72.43399253872123,0.0592,0.0582440253498898,0.058699999999999995,0.058098320159603686,0.054325,0.05726753496023016,26033.0,14578807.226666674,54289.0,14049728.07142857
2019-09-22,0.0573,0.0574,0.0518,0.0532,28606091.21,6860.0,11586285.98,0.05586666666666667,0.05802857142857143,0.054945,0.05551100633747245,0.056742805089777075,0.05689156489941743,49.41860465116279,0.0624917594997815,0.0473982405002185,-0.0012748831809732547,-0.002126525524548951,0.0008516423435756962,0.005600000000000001,0.004242857142857143,-640236277.1200004,0.0,-0.7462686567164312,-79.67479674796752,20.325203252032484,43.66704250984116,-7.155322862129145,0.057,0.0595,0.0565,0.0574,24736909.16,6778.0,11177861.58,0.701754385964908,59.25925925925925,0.0626691379156256,0.04684086208437442,-0.001025558724164287,-0.0023394361104428748,0.0013138773862785879,0.0029999999999999957,0.004092857142857143,-611630185.9100003,0.0001999999999999988,11.673151750972766,-45.52845528455286,54.47154471544714,59.355742875105705,0.057633333333333335,0.0578220126749449,0.058985714285714294,0.05792374011970276,0.05475500000000001,0.05728015067830348,22878.0,12995847.09333334,55518.0,14253431.715714285
2019-09-23,0.0532,0.0532,0.0482,0.0493,28124444.4,6831.0,14281703.18,0.05329999999999999,0.05675714285714285,0.05492999999999999,0.052405503168736225,0.0548821038173328,0.05616855871852053,45.945945945945944,0.06252254481990584,0.04733745518009414,-0.0017668053829634905,-0.002054581496231859,0.00028777611326836865,0.0049999999999999975,0.004285714285714286,-668360721.5200003,-0.007200000000000005,-5.736137667304019,-92.5675675675676,7.43243243243241,27.409726799970695,-7.330827067669174,0.0573,0.0574,0.0518,0.0532,28606091.21,6860.0,11586285.98,-7.155322862129145,49.41860465116279,0.0624917594997815,0.0473982405002185,-0.0012748831809732547,-0.002126525524548951,0.0008516423435756962,0.005600000000000001,0.004242857142857143,-640236277.1200004,0.0,-0.7462686567164312,-79.67479674796752,20.325203252032484,43.66704250984116,0.05586666666666667,0.05551100633747245,0.05802857142857143,0.056742805089777075,0.054945,0.05689156489941743,20882.0,12396409.016666671,55598.0,13664013.518571427
2019-09-24,0.0493,0.0517,0.0345,0.0374,44057566.22,9246.0,21246952.88,0.04663333333333333,0.05355714285714286,0.05434,0.044902751584368114,0.050511577862999604,0.05438107693580428,34.76482617586913,0.06501538240410426,0.04366461759589574,-0.003081367730585885,-0.0022599387431026644,-0.0008214289874832205,0.0172,0.005335714285714285,-712418287.7400004,-0.017999999999999995,-28.489483747609935,-89.82456140350877,10.175438596491228,12.644358093652054,-24.137931034482747,0.0532,0.0532,0.0482,0.0493,28124444.4,6831.0,14281703.18,-7.330827067669174,45.945945945945944,0.06252254481990584,0.04733745518009414,-0.0017668053829634905,-0.002054581496231859,0.00028777611326836865,0.0049999999999999975,0.004285714285714286,-668360721.5200003,-0.007200000000000005,-5.736137667304019,-92.5675675675676,7.43243243243241,27.409726799970695,0.05329999999999999,0.052405503168736225,0.05675714285714285,0.0548821038173328,0.05492999999999999,0.05616855871852053,20469.0,12348616.91333334,54820.0,13380614.508571427
2019-09-25,0.0375,0.04,0.0347,0.038,41572634.08,7305.0,18688241.18,0.04156666666666667,0.050114285714285715,0.05362,0.04145137579218405,0.04738368339724971,0.05282097437048959,28.47533632286995,0.06655051877496218,0.04068948122503783,-0.0040283169461807974,-0.0026136143837182913,-0.0014147025624625061,0.005299999999999999,0.005228571428571428,-670845653.6600003,-0.021900000000000003,-33.566433566433574,-87.71929824561406,12.280701754385953,9.962857594436544,1.3333333333333346,0.0493,0.0517,0.0345,0.0374,44057566.22,9246.0,21246952.88,-24.137931034482747,34.76482617586913,0.06501538240410426,0.04366461759589574,-0.003081367730585885,-0.0022599387431026644,-0.0008214289874832205,0.0172,0.005335714285714285,-712418287.7400004,-0.017999999999999995,-28.489483747609935,-89.82456140350877,10.175438596491228,12.644358093652054,0.04663333333333333,0.044902751584368114,0.05355714285714286,0.050511577862999604,0.05434,0.05438107693580428,22937.0,15704980.680000005,55748.0,14575603.614285711
2019-09-26,0.038,0.0394,0.0314,0.0336,58369342.52,9747.0,29811560.6,0.036333333333333336,0.04655714285714285,0.052815,0.03752568789609202,0.04393776254793728,0.050990405382823914,28.22222222222223,0.06848707036335215,0.03714292963664785,-0.005075319129952537,-0.0031059553329651404,-0.0019693637969873962,0.008,0.0054714285714285715,-729214996.1800003,-0.024600000000000004,-36.8421052631579,-93.0379746835443,6.962025316455697,9.806055222444307,-11.578947368421055,0.0375,0.04,0.0347,0.038,41572634.08,7305.0,18688241.18,1.3333333333333346,28.47533632286995,0.06655051877496218,0.04068948122503783,-0.0040283169461807974,-0.0026136143837182913,-0.0014147025624625061,0.005299999999999999,0.005228571428571428,-670845653.6600003,-0.021900000000000003,-33.566433566433574,-87.71929824561406,12.280701754385953,9.962857594436544,0.04156666666666667,0.04145137579218405,0.050114285714285715,0.04738368339724971,0.05362,0.05282097437048959,23382.0,18072299.080000002,53120.0,14970103.499999998
2019-09-27,0.0336,0.0349,0.0321,0.0345,25513647.5,6014.0,14442733.78,0.035366666666666664,0.04334285714285714,0.05197,0.03601284394804601,0.04157832191095296,0.04941989058445973,24.17840375586856,0.06965628371306774,0.03428371628693226,-0.00576598671974575,-0.0036379616103212626,-0.0021280251094244872,0.002800000000000004,0.005357142857142856,-703701348.6800003,-0.025299999999999996,-38.938053097345126,-90.1898734177215,9.810126582278498,9.684284551040063,2.6785714285714435,0.038,0.0394,0.0314,0.0336,58369342.52,9747.0,29811560.6,-11.578947368421055,28.22222222222223,0.06848707036335215,0.03714292963664785,-0.005075319129952537,-0.0031059553329651404,-0.0019693637969873962,0.008,0.0054714285714285715,-729214996.1800003,-0.024600000000000004,-36.8421052631579,-93.0379746835443,6.962025316455697,9.806055222444307,0.036333333333333336,0.03752568789609202,0.04655714285714285,0.04393776254793728,0.052815,0.050990405382823914,26298.0,23248918.220000003,54011.0,17316812.127142854
2019-09-28,0.0345,0.0351,0.0327,0.0345,24882317.14,5467.0,12835627.65,0.0342,0.04007142857142857,0.051015,0.03525642197402301,0.03980874143321472,0.047998948624035,24.819277108433738,0.07031935184097562,0.03171064815902437,-0.006241398800412849,-0.00415864904833958,-0.002082749752073269,0.0023999999999999994,0.005357142857142858,-728583665.8200003,-0.0276,-37.72563176895306,-90.1898734177215,9.810126582278498,8.860759493670912,0.0,0.0336,0.0349,0.0321,0.0345,25513647.5,6014.0,14442733.78,2.6785714285714435,24.17840375586856,0.06965628371306774,0.03428371628693226,-0.00576598671974575,-0.0036379616103212626,-0.0021280251094244872,0.002800000000000004,0.005357142857142856,-703701348.6800003,-0.025299999999999996,-38.938053097345126,-90.1898734177215,9.810126582278498,9.684284551040063,0.035366666666666664,0.03601284394804601,0.04334285714285714,0.04157832191095296,0.05197,0.04941989058445973,23066.0,20980845.18666667,52781.0,17319334.168571424
2019-09-29,0.0345,0.0361,0.0335,0.0351,28322681.17,5558.0,16349721.67,0.0347,0.03748571428571429,0.050155000000000005,0.0351782109870115,0.03863155607491104,0.04677047732650785,17.02127659574468,0.07071028872910867,0.02959971127089133,-0.006494882353067548,-0.004625895709285174,-0.0018689866437823742,0.002599999999999998,0.005178571428571428,-700260984.6500003,-0.023400000000000004,-41.40233722871452,-88.29113924050633,11.708860759493676,10.443037974683572,1.739130434782598,0.0345,0.0351,0.0327,0.0345,24882317.14,5467.0,12835627.65,0.0,24.819277108433738,0.07031935184097562,0.03171064815902437,-0.006241398800412849,-0.00415864904833958,-0.002082749752073269,0.0023999999999999994,0.005357142857142858,-728583665.8200003,-0.0276,-37.72563176895306,-90.1898734177215,9.810126582278498,8.860759493670912,0.0342,0.03525642197402301,0.04007142857142857,0.03980874143321472,0.051015,0.047998948624035,21228.0,19029974.010000005,51470.0,17556157.89285714
2019-09-30,0.0351,0.0352,0.0322,0.0342,29408336.68,5991.0,15805243.0,0.0346,0.03532857142857143,0.04925,0.03468910549350575,0.037523667056183284,0.04557328900969758,17.391304347826093,0.0709685344082488,0.027531465591751215,-0.00669125969656547,-0.005038968506741233,-0.0016522911898242372,0.0030000000000000027,0.005135714285714285,-729669321.3300003,-0.0228,-41.23711340206185,-91.1392405063291,8.860759493670898,10.126582278481038,-2.5641025641025585,0.0345,0.0361,0.0335,0.0351,28322681.17,5558.0,16349721.67,1.739130434782598,17.02127659574468,0.07071028872910867,0.02959971127089133,-0.006494882353067548,-0.004625895709285174,-0.0018689866437823742,0.002599999999999998,0.005178571428571428,-700260984.6500003,-0.023400000000000004,-41.40233722871452,-88.29113924050633,11.708860759493676,10.443037974683572,0.0347,0.0351782109870115,0.03748571428571429,0.03863155607491104,0.050155000000000005,0.04677047732650785,17039.0,14542694.366666673,50168.0,18236648.705714285
2019-10-01,0.0342,0.036,0.0332,0.0343,18030774.57,4268.0,10851422.02,0.03453333333333333,0.03488571428571429,0.048104999999999995,0.03449455274675287,0.03671775029213746,0.04449964243734543,13.881019830028322,0.07046393557395303,0.025746064426046954,-0.006760885709886463,-0.005383351947370279,-0.001377533762516184,0.002799999999999997,0.005092857142857143,-711638546.7600002,-0.023100000000000002,-42.64214046822743,-90.82278481012659,9.177215189873417,9.91561181434601,0.2923976608187015,0.0351,0.0352,0.0322,0.0342,29408336.68,5991.0,15805243.0,-2.5641025641025585,17.391304347826093,0.0709685344082488,0.027531465591751215,-0.00669125969656547,-0.005038968506741233,-0.0016522911898242372,0.0030000000000000027,0.005135714285714285,-729669321.3300003,-0.0228,-41.23711340206185,-91.1392405063291,8.860759493670898,10.126582278481038,0.0346,0.03468910549350575,0.03532857142857143,0.037523667056183284,0.04925,0.04557328900969758,17016.0,14996864.106666671,49328.0,18454297.25142857
2019-10-02,0.0343,0.0352,0.0337,0.0347,22830546.93,4773.0,11311036.53,0.03440000000000001,0.03441428571428572,0.04718,0.03459727637337644,0.036213312719103094,0.04356634315759825,8.982035928143702,0.07017314314266607,0.024186856857333933,-0.006706480042717587,-0.005647977566439741,-0.0010585024762778464,0.0015000000000000013,0.004864285714285714,-688807999.8300003,-0.018499999999999996,-44.12238325281803,-89.28571428571426,10.714285714285728,9.584086799276696,1.166180758017506,0.0342,0.036,0.0332,0.0343,18030774.57,4268.0,10851422.02,0.2923976608187015,13.881019830028322,0.07046393557395303,0.025746064426046954,-0.006760885709886463,-0.005383351947370279,-0.001377533762516184,0.002799999999999997,0.005092857142857143,-711638546.7600002,-0.023100000000000002,-42.64214046822743,-90.82278481012659,9.177215189873417,9.91561181434601,0.03453333333333333,0.03449455274675287,0.03488571428571429,0.03671775029213746,0.048104999999999995,0.04449964243734543,15817.0,14335462.230000004,44350.0,16969221.414285712
2019-10-03,0.0348,0.0358,0.0335,0.0347,29549308.29,5367.0,14581429.72,0.03456666666666667,0.03457142857142857,0.04609,0.034648638186688216,0.03583498453932732,0.04272192952354127,10.067114093959717,0.06928881122181585,0.022891188778184152,-0.006587427397012999,-0.005835867532554393,-0.000751559864458606,0.0022999999999999965,0.004607142857142857,-718357308.1200002,-0.014599999999999995,-40.68376068376068,-88.2562277580071,11.743772241992897,10.545091048717362,-0.2873563218390688,0.0343,0.0352,0.0337,0.0347,22830546.93,4773.0,11311036.53,1.166180758017506,8.982035928143702,0.07017314314266607,0.024186856857333933,-0.006706480042717587,-0.005647977566439741,-0.0010585024762778464,0.0015000000000000013,0.004864285714285714,-688807999.8300003,-0.018499999999999996,-44.12238325281803,-89.28571428571426,10.714285714285728,9.584086799276696,0.03440000000000001,0.03459727637337644,0.03441428571428572,0.036213312719103094,0.04718,0.04356634315759825,15032.0,12655900.516666671,41818.0,15915335.035714285
2019-10-04,0.0347,0.0354,0.0337,0.0349,18408046.26,4722.0,11612927.23,0.03476666666666667,0.03462857142857143,0.045065,0.03477431909334411,0.035601238404495486,0.041976983854632575,11.228070175438575,0.06834320530250239,0.021786794697497613,-0.00640312771850355,-0.005949319569744225,-0.00045380814875932516,0.0017000000000000001,0.004514285714285714,-699949261.8600003,-0.0025000000000000022,-38.771929824561404,-87.54448398576511,12.455516014234886,11.637857990171184,0.5763688760806881,0.0348,0.0358,0.0335,0.0347,29549308.29,5367.0,14581429.72,-0.2873563218390688,10.067114093959717,0.06928881122181585,0.022891188778184152,-0.006587427397012999,-0.005835867532554393,-0.000751559864458606,0.0022999999999999965,0.004607142857142857,-718357308.1200002,-0.014599999999999995,-40.68376068376068,-88.2562277580071,11.743772241992897,10.545091048717362,0.03456666666666667,0.034648638186688216,0.03457142857142857,0.03583498453932732,0.04609,0.04272192952354127,14408.0,12247962.75666667,37438.0,13739602.052857142
2019-10-05,0.0349,0.0366,0.0344,0.0354,18228187.58,5182.0,12160140.19,0.034999999999999996,0.034757142857142855,0.043840000000000004,0.035087159546672055,0.035550928803371615,0.04135060443990567,11.538461538461533,0.06639859271460316,0.021281407285396847,-0.006145877227152811,-0.005988631101225942,-0.0001572461259268694,0.0022000000000000006,0.004457142857142857,-681721074.2800002,-0.002599999999999998,-38.327526132404174,-84.6153846153846,15.384615384615397,13.194634546947741,1.4326647564469928,0.0347,0.0354,0.0337,0.0349,18408046.26,4722.0,11612927.23,0.5763688760806881,11.228070175438575,0.06834320530250239,0.021786794697497613,-0.00640312771850355,-0.005949319569744225,-0.00045380814875932516,0.0017000000000000001,0.004514285714285714,-699949261.8600003,-0.0025000000000000022,-38.771929824561404,-87.54448398576511,12.455516014234886,11.637857990171184,0.03476666666666667,0.03477431909334411,0.03462857142857143,0.035601238404495486,0.045065,0.041976983854632575,14862.0,12501797.826666674,36146.0,13335343.974285712
2019-10-06,0.0355,0.0382,0.0342,0.0376,27150416.67,8204.0,17472577.97,0.03596666666666667,0.035114285714285716,0.04281,0.03634357977333603,0.03606319660252871,0.040993404017057505,20.67669172932331,0.0644712095691859,0.021148790430814114,-0.005698790634474558,-0.0059306630078756655,0.00023187237340110706,0.003999999999999997,0.004342857142857142,-654570657.6100003,0.0040000000000000036,-29.323308270676684,-71.55963302752292,28.440366972477083,18.760166123775804,5.915492957746492,0.0349,0.0366,0.0344,0.0354,18228187.58,5182.0,12160140.19,1.4326647564469928,11.538461538461533,0.06639859271460316,0.021281407285396847,-0.006145877227152811,-0.005988631101225942,-0.0001572461259268694,0.0022000000000000006,0.004457142857142857,-681721074.2800002,-0.002599999999999998,-38.327526132404174,-84.6153846153846,15.384615384615397,13.194634546947741,0.034999999999999996,0.035087159546672055,0.034757142857142855,0.035550928803371615,0.043840000000000004,0.04135060443990567,15271.0,12784832.380000005,35861.0,13238845.765714284
2019-10-07,0.0377,0.0404,0.0368,0.0398,45483101.67,12693.0,25089637.52,0.0376,0.03591428571428572,0.04181,0.03807178988666801,0.036997397451896535,0.04087974649162346,30.923694779116474,0.06196277439435239,0.02165722560564761,-0.005108067057481923,-0.0057661438177969175,0.0006580767603149946,0.003599999999999999,0.004242857142857143,-609087555.9400003,0.005299999999999999,-19.26977687626774,-58.6206896551724,41.379310344827594,28.401430900640037,5.570291777188341,0.0355,0.0382,0.0342,0.0376,27150416.67,8204.0,17472577.97,5.915492957746492,20.67669172932331,0.0644712095691859,0.021148790430814114,-0.005698790634474558,-0.0059306630078756655,0.00023187237340110706,0.003999999999999997,0.004342857142857142,-654570657.6100003,0.0040000000000000036,-29.323308270676684,-71.55963302752292,28.440366972477083,18.760166123775804,0.03596666666666667,0.03634357977333603,0.035114285714285716,0.03606319660252871,0.04281,0.040993404017057505,18108.0,13748548.463333338,38507.0,13399253.808571428
2019-10-08,0.0398,0.05,0.0398,0.0427,57170458.14,17552.0,30034732.49,0.04003333333333334,0.03711428571428572,0.04084,0.04038589494333401,0.0384230480889224,0.0410531039686117,66.66666666666666,0.05860707777412403,0.023072922225875973,-0.004355698818442312,-0.005484054817925996,0.0011283559994836843,0.0102,0.0037428571428571424,-551917097.8000003,0.008199999999999999,14.171122994652396,-39.247311827956985,60.752688172043015,43.52412182978258,7.2864321608040195,0.0377,0.0404,0.0368,0.0398,45483101.67,12693.0,25089637.52,5.570291777188341,30.923694779116474,0.06196277439435239,0.02165722560564761,-0.005108067057481923,-0.0057661438177969175,0.0006580767603149946,0.003599999999999999,0.004242857142857143,-609087555.9400003,0.005299999999999999,-19.26977687626774,-58.6206896551724,41.379310344827594,28.401430900640037,0.0376,0.03807178988666801,0.03591428571428572,0.036997397451896535,0.04181,0.04087974649162346,26079.0,18240785.22666667,45209.0,14725595.882857142
2019-10-09,0.0427,0.0448,0.0405,0.0417,45798485.17,16048.0,26067198.73,0.0414,0.03811428571428572,0.04,0.04104294747166701,0.0392422860666918,0.041114713114458204,61.34969325153375,0.05572246130457564,0.02427753869542436,-0.003796371009297979,-0.005146518056200393,0.0013501470469024146,0.004299999999999998,0.003671428571428571,-597715582.9700003,0.006600000000000002,9.736842105263154,-44.623655913978496,55.37634408602151,52.50278086763072,-2.3419203747072617,0.0398,0.05,0.0398,0.0427,57170458.14,17552.0,30034732.49,7.2864321608040195,66.66666666666666,0.05860707777412403,0.023072922225875973,-0.004355698818442312,-0.005484054817925996,0.0011283559994836843,0.0102,0.0037428571428571424,-551917097.8000003,0.008199999999999999,14.171122994652396,-39.247311827956985,60.752688172043015,43.52412182978258,0.04003333333333334,0.04038589494333401,0.03711428571428572,0.0384230480889224,0.04084,0.0410531039686117,38449.0,24198982.660000008,58493.0,17466068.807142854
2019-10-10,0.0417,0.0446,0.0394,0.0439,31041586.67,12421.0,17776752.33,0.042766666666666675,0.03942857142857143,0.039345000000000005,0.0424714737358335,0.040406714550018846,0.04137997853212885,86.52482269503547,0.053047166559389354,0.025642833440610656,-0.0031393891530248075,-0.0047450922755652766,0.001605703122540469,0.005200000000000003,0.003471428571428571,-566673996.3000003,0.0097,30.654761904761905,-34.07821229050279,65.92178770949721,60.68360665585393,5.275779376498802,0.0427,0.0448,0.0405,0.0417,45798485.17,16048.0,26067198.73,-2.3419203747072617,61.34969325153375,0.05572246130457564,0.02427753869542436,-0.003796371009297979,-0.005146518056200393,0.0013501470469024146,0.004299999999999998,0.003671428571428571,-597715582.9700003,0.006600000000000002,9.736842105263154,-44.623655913978496,55.37634408602151,52.50278086763072,0.0414,0.04104294747166701,0.03811428571428572,0.0392422860666918,0.04,0.041114713114458204,46293.0,27063856.24666667,69768.0,19574091.978571426
2019-10-11,0.0439,0.0472,0.0418,0.0443,54719970.95,20426.0,33409415.53,0.0433,0.040771428571428577,0.03869,0.04338573686791675,0.041380035912514136,0.041658075814783244,86.02941176470588,0.04975723946943773,0.027622760530562274,-0.0025569744319785884,-0.004307468706847939,0.0017504942748693504,0.005400000000000002,0.0036571428571428566,-511954025.3500003,0.010000000000000002,28.40579710144926,-32.02247191011238,67.97752808988763,63.09188662846879,0.9111617312072837,0.0417,0.0446,0.0394,0.0439,31041586.67,12421.0,17776752.33,5.275779376498802,86.52482269503547,0.053047166559389354,0.025642833440610656,-0.0031393891530248075,-0.0047450922755652766,0.001605703122540469,0.005200000000000003,0.003471428571428571,-566673996.3000003,0.0097,30.654761904761905,-34.07821229050279,65.92178770949721,60.68360665585393,0.042766666666666675,0.0424714737358335,0.03942857142857143,0.040406714550018846,0.039345000000000005,0.04137997853212885,46021.0,24626227.850000005,76822.0,20030566.637142856
2019-10-12,0.0444,0.046,0.0431,0.0455,54669743.52,14600.0,26734605.31,0.04456666666666667,0.04221428571428571,0.038305,0.04444286843395837,0.0424100269343856,0.04202397335623246,87.16216216216216,0.04764838493831116,0.028961615061688838,-0.0019758007966064403,-0.0038411351247996392,0.001865334328193199,0.0029,0.0036928571428571427,-457284281.83000034,0.010799999999999997,31.884057971014478,-25.28089887640451,74.7191011235955,69.53947230766012,2.4774774774774704,0.0439,0.0472,0.0418,0.0443,54719970.95,20426.0,33409415.53,0.9111617312072837,86.02941176470588,0.04975723946943773,0.027622760530562274,-0.0025569744319785884,-0.004307468706847939,0.0017504942748693504,0.005400000000000002,0.0036571428571428566,-511954025.3500003,0.010000000000000002,28.40579710144926,-32.02247191011238,67.97752808988763,63.09188662846879,0.0433,0.04338573686791675,0.040771428571428577,0.041380035912514136,0.03869,0.041658075814783244,48895.0,25751122.196666673,92526.0,23144350.68
2019-10-13,0.0454,0.0454,0.0417,0.0428,43762596.16,11583.0,20784434.53,0.044199999999999996,0.04295714285714286,0.03798,0.043621434216979185,0.0425075202007892,0.042097880655638895,72.7810650887574,0.046082916953671185,0.029877083046328815,-0.0017133336942880203,-0.003415574838697316,0.0017022411444092955,0.003700000000000002,0.0037714285714285714,-501046877.99000037,0.008099999999999996,21.93732193732194,-40.449438202247215,59.550561797752785,67.41573033707864,-5.726872246696046,0.0444,0.046,0.0431,0.0455,54669743.52,14600.0,26734605.31,2.4774774774774704,87.16216216216216,0.04764838493831116,0.028961615061688838,-0.0019758007966064403,-0.0038411351247996392,0.001865334328193199,0.0029,0.0036928571428571427,-457284281.83000034,0.010799999999999997,31.884057971014478,-25.28089887640451,74.7191011235955,69.53947230766012,0.04456666666666667,0.04444286843395837,0.04221428571428571,0.0424100269343856,0.038305,0.04202397335623246,47447.0,25973591.056666672,101944.0,25226417.125714283
2019-10-14,0.0428,0.0533,0.0425,0.0459,76064615.17,22307.0,37662723.94,0.044733333333333326,0.04382857142857143,0.038405,0.0447607171084896,0.0433556401505919,0.04245998725986376,80.6282722513089,0.04723854253311813,0.029571457466881872,-0.0012408784580637544,-0.0029806355625706035,0.0017397571045068491,0.010799999999999997,0.004328571428571428,-424982262.82000035,0.011000000000000003,34.210526315789465,-36.81592039800993,63.184079601990064,65.81791417444613,7.242990654205621,0.0454,0.0454,0.0417,0.0428,43762596.16,11583.0,20784434.53,-5.726872246696046,72.7810650887574,0.046082916953671185,0.029877083046328815,-0.0017133336942880203,-0.003415574838697316,0.0017022411444092955,0.003700000000000002,0.0037714285714285714,-501046877.99000037,0.008099999999999996,21.93732193732194,-40.449438202247215,59.550561797752785,67.41573033707864,0.044199999999999996,0.043621434216979185,0.04295714285714286,0.0425075202007892,0.03798,0.042097880655638895,46609.0,26976151.790000003,105323.0,25699539.491428573
2019-10-15,0.0459,0.0477,0.043,0.0437,39372004.77,15297.0,17965144.8,0.04413333333333334,0.04397142857142857,0.03869,0.0442303585542448,0.04344173011294393,0.04257808371130531,72.16981132075472,0.0478309777203758,0.029549022279624207,-0.001032078732155127,-0.002590924196487508,0.0015588454643323812,0.004700000000000003,0.004464285714285714,-464354267.59000033,0.008300000000000002,27.405247813411094,-48.48484848484848,51.51515151515152,58.08326430496481,-4.793028322440088,0.0428,0.0533,0.0425,0.0459,76064615.17,22307.0,37662723.94,7.242990654205621,80.6282722513089,0.04723854253311813,0.029571457466881872,-0.0012408784580637544,-0.0029806355625706035,0.0017397571045068491,0.010799999999999997,0.004328571428571428,-424982262.82000035,0.011000000000000003,34.210526315789465,-36.81592039800993,63.184079601990064,65.81791417444613,0.044733333333333326,0.0447607171084896,0.04382857142857143,0.0433556401505919,0.038405,0.04245998725986376,48490.0,28393921.26,114937.0,27495694.694285713
2019-10-16,0.0437,0.0443,0.038,0.04,28341961.58,9036.0,12487102.75,0.043199999999999995,0.04372857142857143,0.03901,0.0421151792771224,0.042581297584707946,0.042332551929276235,60.81632653061224,0.047843643821101824,0.030176356178898182,-0.0011518843174728038,-0.0023031162206845674,0.0011512319032117636,0.0063,0.004807142857142857,-492696229.1700003,0.0023999999999999994,15.27377521613833,-67.17171717171718,32.82828282828282,49.17583798180815,-8.466819221967967,0.0459,0.0477,0.043,0.0437,39372004.77,15297.0,17965144.8,-4.793028322440088,72.16981132075472,0.0478309777203758,0.029549022279624207,-0.001032078732155127,-0.002590924196487508,0.0015588454643323812,0.004700000000000003,0.004464285714285714,-464354267.59000033,0.008300000000000002,27.405247813411094,-48.48484848484848,51.51515151515152,58.08326430496481,0.04413333333333334,0.0442303585542448,0.04397142857142857,0.04344173011294393,0.03869,0.04257808371130531,49187.0,25470767.75666667,112682.0,25771467.881428573
2019-10-17,0.0399,0.0422,0.0397,0.0408,30607103.35,6297.0,14513824.86,0.0415,0.04328571428571428,0.039325000000000006,0.0414575896385612,0.04213597318853096,0.0421865946026785,62.055335968379445,0.04792778412707406,0.03072221587292595,-0.0011688045416678866,-0.0020762538848812313,0.0009074493432133447,0.0025000000000000022,0.004821428571428572,-462089125.8200003,0.0010000000000000009,17.579250720461093,-63.77551020408162,36.22448979591838,40.18930804645092,2.2556390977443734,0.0437,0.0443,0.038,0.04,28341961.58,9036.0,12487102.75,-8.466819221967967,60.81632653061224,0.047843643821101824,0.030176356178898182,-0.0011518843174728038,-0.0023031162206845674,0.0011512319032117636,0.0063,0.004807142857142857,-492696229.1700003,0.0023999999999999994,15.27377521613833,-67.17171717171718,32.82828282828282,49.17583798180815,0.043199999999999995,0.0421151792771224,0.04372857142857143,0.042581297584707946,0.03901,0.042332551929276235,46640.0,22704990.49666667,105670.0,23831454.169999998
2019-10-18,0.0408,0.0419,0.0383,0.0395,52186828.62,6861.0,22354565.76,0.040100000000000004,0.04259999999999999,0.039575,0.0404787948192806,0.04147697989139822,0.041930728450042455,58.712121212121204,0.04787259001157534,0.03127740998842466,-0.001272445121402857,-0.0019154921321855565,0.0006430470107826995,0.003599999999999999,0.004957142857142856,-514275954.4400003,-0.0032000000000000015,13.180515759312318,-72.25130890052355,27.748691099476435,32.26715457455923,-3.1862745098039276,0.0399,0.0422,0.0397,0.0408,30607103.35,6297.0,14513824.86,2.2556390977443734,62.055335968379445,0.04792778412707406,0.03072221587292595,-0.0011688045416678866,-0.0020762538848812313,0.0009074493432133447,0.0025000000000000022,0.004821428571428572,-462089125.8200003,0.0010000000000000009,17.579250720461093,-63.77551020408162,36.22448979591838,40.18930804645092,0.0415,0.0414575896385612,0.04328571428571428,0.04213597318853096,0.039325000000000006,0.0421865946026785,30630.0,14988690.803333336,99546.0,23365321.674285714
2019-10-19,0.0393,0.0407,0.039,0.0403,59604192.08,8118.0,23856831.57,0.04020000000000001,0.04185714285714286,0.039835,0.0403893974096403,0.041182734918548666,0.04177542097860984,59.176029962546814,0.047863705080108024,0.03180629491989198,-0.0012753265428886301,-0.0017874590143261712,0.0005121324714375411,0.0017000000000000001,0.004921428571428571,-454671762.3600003,-0.0013999999999999985,13.841807909604519,-68.06282722513089,31.937172774869115,31.97011789008799,2.5445292620865163,0.0408,0.0419,0.0383,0.0395,52186828.62,6861.0,22354565.76,-3.1862745098039276,58.712121212121204,0.04787259001157534,0.03127740998842466,-0.001272445121402857,-0.0019154921321855565,0.0006430470107826995,0.003599999999999999,0.004957142857142856,-514275954.4400003,-0.0032000000000000015,13.180515759312318,-72.25130890052355,27.748691099476435,32.26715457455923,0.040100000000000004,0.0404787948192806,0.04259999999999999,0.04147697989139822,0.039575,0.041930728450042455,22194.0,16451831.12333334,85981.0,21786057.42142857
2019-10-20,0.0403,0.0405,0.0383,0.04,81497207.42,11467.0,40212850.54,0.039933333333333335,0.04145714285714286,0.04012500000000001,0.04019469870482015,0.0408870511889115,0.04160633326636128,54.83870967741936,0.04770305001998913,0.032546949980010884,-0.0012869820549599453,-0.0016873636224529263,0.000400381567492981,0.0022000000000000006,0.004792857142857145,-536168969.7800003,-0.0039000000000000007,6.382978723404253,-80.60606060606061,19.3939393939394,26.359934422761665,-0.7444168734491355,0.0393,0.0407,0.039,0.0403,59604192.08,8118.0,23856831.57,2.5445292620865163,59.176029962546814,0.047863705080108024,0.03180629491989198,-0.0012753265428886301,-0.0017874590143261712,0.0005121324714375411,0.0017000000000000001,0.004921428571428571,-454671762.3600003,-0.0013999999999999985,13.841807909604519,-68.06282722513089,31.937172774869115,31.97011789008799,0.04020000000000001,0.0403893974096403,0.04185714285714286,0.041182734918548666,0.039835,0.04177542097860984,21276.0,20241740.730000004,79499.0,21374946.887142856
2019-10-21,0.0399,0.04154,0.0391,0.0405,55078222.99,7435.0,26065397.49,0.04026666666666667,0.04068571428571428,0.040435000000000006,0.04034734935241008,0.040790288391683624,0.041500968193374496,51.515151515151516,0.04749959668459446,0.03337040331540555,-0.0012415613643610018,-0.0015982031708345415,0.00035664180647353963,0.0024399999999999977,0.00471,-481090746.7900003,-0.003799999999999998,1.7587939698492372,-83.66013071895424,16.339869281045765,22.556993816618107,1.503759398496249,0.0403,0.0405,0.0383,0.04,81497207.42,11467.0,40212850.54,-0.7444168734491355,54.83870967741936,0.04770305001998913,0.032546949980010884,-0.0012869820549599453,-0.0016873636224529263,0.000400381567492981,0.0022000000000000006,0.004792857142857145,-536168969.7800003,-0.0039000000000000007,6.382978723404253,-80.60606060606061,19.3939393939394,26.359934422761665,0.039933333333333335,0.04019469870482015,0.04145714285714286,0.0408870511889115,0.04012500000000001,0.04160633326636128,26446.0,28808082.62333334,79383.0,24150434.888571423
2019-10-22,0.0405,0.0412,0.04003,0.04073,55652464.9,6842.0,27760890.8,0.04041,0.04026142857142857,0.040736499999999995,0.04053867467620504,0.04077521629376272,0.041427542651148355,45.17865883504651,0.047264887485289744,0.034208112514710245,-0.0011734789274033125,-0.0015132583221482959,0.00033977939474498335,0.0011699999999999974,0.004065,-425438281.89000034,-0.0047699999999999965,-4.613583138173305,-82.15686274509801,17.84313725490198,17.858981976629064,0.5679012345679038,0.0399,0.04154,0.0391,0.0405,55078222.99,7435.0,26065397.49,1.503759398496249,51.515151515151516,0.04749959668459446,0.03337040331540555,-0.0012415613643610018,-0.0015982031708345415,0.00035664180647353963,0.0024399999999999977,0.00471,-481090746.7900003,-0.003799999999999998,1.7587939698492372,-83.66013071895424,16.339869281045765,22.556993816618107,0.04026666666666667,0.04034734935241008,0.04068571428571428,0.040790288391683624,0.040435000000000006,0.041500968193374496,27020.0,30045026.533333335,64511.0,22493673.967142854
2019-10-23,0.04071,0.04095,0.03489,0.03595,70658306.22,8489.0,30477888.56,0.039060000000000004,0.039682857142857145,0.040799,0.03824433733810252,0.03956891222032204,0.04090587192246756,38.12474184221397,0.047104175484863994,0.03449382451513601,-0.001488075548847806,-0.0015082217674881981,2.0146218640392215e-05,0.006060000000000003,0.004190714285714286,-496096588.1100004,-0.006849999999999995,-13.78896882494004,-94.24225964149916,5.757740358500843,13.31358229814954,-11.692458855318105,0.0405,0.0412,0.04003,0.04073,55652464.9,6842.0,27760890.8,0.5679012345679038,45.17865883504651,0.047264887485289744,0.034208112514710245,-0.0011734789274033125,-0.0015132583221482959,0.00033977939474498335,0.0011699999999999974,0.004065,-425438281.89000034,-0.0047699999999999965,-4.613583138173305,-82.15686274509801,17.84313725490198,17.858981976629064,0.04041,0.04053867467620504,0.04026142857142857,0.04077521629376272,0.040736499999999995,0.041427542651148355,25744.0,31346379.610000003,56056.0,23893066.252857145
2019-10-24,0.03598,0.03695,0.03524,0.03622,78775745.9,6544.0,23292891.7,0.03763333333333333,0.039028571428571426,0.040865,0.03723216866905126,0.03873168416524153,0.04045959840604208,32.76481149012568,0.046933370109812564,0.03479662989018743,-0.0016960577958616066,-0.00154578897316288,-0.0001502688226987267,0.0017099999999999962,0.003941428571428571,-417320842.2100004,-0.009680000000000001,-17.49430523917995,-92.77566539923951,7.22433460076048,10.275070738054447,0.6670372429127407,0.04071,0.04095,0.03489,0.03595,70658306.22,8489.0,30477888.56,-11.692458855318105,38.12474184221397,0.047104175484863994,0.03449382451513601,-0.001488075548847806,-0.0015082217674881981,2.0146218640392215e-05,0.006060000000000003,0.004190714285714286,-496096588.1100004,-0.006849999999999995,-13.78896882494004,-94.24225964149916,5.757740358500843,13.31358229814954,0.039060000000000004,0.03824433733810252,0.039682857142857145,0.03956891222032204,0.040799,0.04090587192246756,22766.0,28101392.283333335,55509.0,26463178.511428572
2019-10-25,0.03632,0.03967,0.03553,0.0383,76764122.97,7675.0,20009049.37,0.03682333333333334,0.03885714285714286,0.041010000000000005,0.037766084334525635,0.03862376312393115,0.0402539223673714,37.47913188647748,0.04665216830288565,0.03536783169711436,-0.0016737526298939431,-0.0015713817045090927,-0.00010237092538485041,0.004139999999999998,0.003851428571428571,-340556719.24000037,-0.005400000000000002,-13.544018058690742,-81.4774579033134,18.522542096686596,10.501539018649321,5.451541850220272,0.03598,0.03695,0.03524,0.03622,78775745.9,6544.0,23292891.7,0.6670372429127407,32.76481149012568,0.046933370109812564,0.03479662989018743,-0.0016960577958616066,-0.00154578897316288,-0.0001502688226987267,0.0017099999999999962,0.003941428571428571,-417320842.2100004,-0.009680000000000001,-17.49430523917995,-92.77566539923951,7.22433460076048,10.275070738054447,0.03763333333333333,0.03723216866905126,0.039028571428571426,0.03873168416524153,0.040865,0.04045959840604208,21875.0,27177223.68666667,55756.0,27717330.917142857
2019-10-26,0.03828,0.03989,0.0372,0.0386,48761236.0,6756.0,14860255.1,0.037706666666666666,0.03861428571428571,0.04106,0.038183042167262815,0.03861782234294836,0.04009640595143127,35.039028620988745,0.046591570634494615,0.03552842936550538,-0.0016132713445358784,-0.00157975963251445,-3.351171202142854e-05,0.002690000000000005,0.0038364285714285714,-291795483.24000037,-0.0013999999999999985,-15.164835164835155,-79.84790874524712,20.152091254752875,15.299655984066666,0.8359456635318726,0.03632,0.03967,0.03553,0.0383,76764122.97,7675.0,20009049.37,5.451541850220272,37.47913188647748,0.04665216830288565,0.03536783169711436,-0.0016737526298939431,-0.0015713817045090927,-0.00010237092538485041,0.004139999999999998,0.003851428571428571,-340556719.24000037,-0.005400000000000002,-13.544018058690742,-81.4774579033134,18.522542096686596,10.501539018649321,0.03682333333333334,0.037766084334525635,0.03885714285714286,0.03862376312393115,0.041010000000000005,0.0402539223673714,22708.0,24593276.543333337,56570.0,27382257.147142857
2019-10-27,0.03863,0.0409,0.03701,0.03999,25397880.0,4820.0,9168902.5,0.03896333333333333,0.03861285714285715,0.041069499999999995,0.039086521083631406,0.03896086675721127,0.040086272051294954,43.54022988505748,0.04659260543846513,0.03554639456153486,-0.001436617672593954,-0.0015511312405303507,0.00011451356793639681,0.0038899999999999976,0.0038499999999999997,-266397603.24000037,-0.0008100000000000052,-6.5654205607476595,-72.29766431287345,27.70233568712656,22.12565634618869,3.520579860212271,0.03828,0.03989,0.0372,0.0386,48761236.0,6756.0,14860255.1,0.8359456635318726,35.039028620988745,0.046591570634494615,0.03552842936550538,-0.0016132713445358784,-0.00157975963251445,-3.351171202142854e-05,0.002690000000000005,0.0038364285714285714,-291795483.24000037,-0.0013999999999999985,-15.164835164835155,-79.84790874524712,20.152091254752875,15.299655984066666,0.037706666666666666,0.038183042167262815,0.03861428571428571,0.03861782234294836,0.04106,0.04009640595143127,20975.0,19387398.723333336,55208.0,26097031.937142853
2019-10-28,0.03999,0.0427,0.0394,0.03953,20538267.04,4267.0,7509659.92,0.03937333333333334,0.03847428571428572,0.040911,0.0393082605418157,0.03910315006790845,0.040033293760695435,33.33333333333333,0.04641901100791845,0.03540298899208156,-0.0013185372438919499,-0.0015046124412026708,0.00018607519731072089,0.0033000000000000043,0.0033142857142857145,-286935870.2800004,3.0000000000002247e-05,-13.877995642701524,-63.77829820452767,36.22170179547232,28.025376245783935,-1.150287571892961,0.03863,0.0409,0.03701,0.03999,25397880.0,4820.0,9168902.5,3.520579860212271,43.54022988505748,0.04659260543846513,0.03554639456153486,-0.001436617672593954,-0.0015511312405303507,0.00011451356793639681,0.0038899999999999976,0.0038499999999999997,-266397603.24000037,-0.0008100000000000052,-6.5654205607476595,-72.29766431287345,27.70233568712656,22.12565634618869,0.03896333333333333,0.039086521083631406,0.03861285714285715,0.03896086675721127,0.041069499999999995,0.040086272051294954,19251.0,14679402.323333338,48561.0,21662182.217142854
2019-10-29,0.0395,0.04212,0.0389,0.0411,41279626.9,7216.0,12254910.3,0.04020666666666667,0.03852714285714286,0.040881,0.04020413027090785,0.03960236255093134,0.04013488483110539,42.96536796536795,0.046377440570729504,0.0353845594292705,-0.0010857558568018663,-0.00142084112432251,0.0003350852675206436,0.0032200000000000006,0.0032085714285714287,-245656243.38000038,0.0007999999999999952,-5.949656750572096,-34.006376195536674,65.99362380446333,43.30588709568741,4.050632911392398,0.03999,0.0427,0.0394,0.03953,20538267.04,4267.0,7509659.92,-1.150287571892961,33.33333333333333,0.04641901100791845,0.03540298899208156,-0.0013185372438919499,-0.0015046124412026708,0.00018607519731072089,0.0033000000000000043,0.0033142857142857145,-286935870.2800004,3.0000000000002247e-05,-13.877995642701524,-63.77829820452767,36.22170179547232,28.025376245783935,0.03937333333333334,0.0393082605418157,0.03847428571428572,0.03910315006790845,0.040911,0.040033293760695435,15843.0,10512939.173333338,45393.0,19011362.564285714
2019-10-30,0.04109,0.0412,0.03844,0.03908,46363110.5,6037.0,9865377.1,0.03990333333333334,0.03897428571428572,0.04064,0.03964206513545392,0.039471771913198506,0.04003441960909535,47.26190476190475,0.04600007069868767,0.03527992930131234,-0.001052143592195083,-0.0013471016178970246,0.00029495802570194156,0.0027599999999999986,0.002955714285714286,-292019353.88000035,-0.0009200000000000041,-2.300000000000013,-46.35083226632526,53.649167733674744,51.954831111203475,-4.891701143830628,0.0395,0.04212,0.0389,0.0411,41279626.9,7216.0,12254910.3,4.050632911392398,42.96536796536795,0.046377440570729504,0.0353845594292705,-0.0010857558568018663,-0.00142084112432251,0.0003350852675206436,0.0032200000000000006,0.0032085714285714287,-245656243.38000038,0.0007999999999999952,-5.949656750572096,-34.006376195536674,65.99362380446333,43.30588709568741,0.04020666666666667,0.04020413027090785,0.03852714285714286,0.03960236255093134,0.040881,0.04013488483110539,16303.0,9644490.906666672,45767.0,16796222.49285714
2019-10-31,0.03904,0.03943,0.03702,0.03776,25661774.3,4659.0,11385965.9,0.03931333333333333,0.039194285714285716,0.040313,0.03870103256772696,0.03904382893489888,0.03981780821775294,41.22401847575057,0.045528955682749256,0.03509704431725075,-0.0011191181017801421,-0.0013015049146736482,0.00018238681289350607,0.0024100000000000024,0.002949285714285714,-317681128.18000036,-0.0027399999999999994,-7.45098039215687,-63.252240717029416,36.74775928297059,52.13018360703624,-3.278688524590155,0.04109,0.0412,0.03844,0.03908,46363110.5,6037.0,9865377.1,-4.891701143830628,47.26190476190475,0.04600007069868767,0.03527992930131234,-0.001052143592195083,-0.0013471016178970246,0.00029495802570194156,0.0027599999999999986,0.002955714285714286,-292019353.88000035,-0.0009200000000000041,-2.300000000000013,-46.35083226632526,53.649167733674744,51.954831111203475,0.03990333333333334,0.03964206513545392,0.03897428571428572,0.039471771913198506,0.04064,0.04003441960909535,17520.0,9876649.106666671,43315.0,13851577.998571428
2019-11-01,0.03776,0.03882,0.03713,0.03876,36120845.9,5735.0,17970122.5,0.038533333333333336,0.03926,0.039976,0.03873051628386348,0.03897287170117417,0.03971706457796695,47.82608695652175,0.044620518670907106,0.03533148132909289,-0.0010790654457367502,-0.0012570170208862687,0.00017795157514951848,0.001689999999999997,0.0028128571428571426,-281560282.2800004,-0.0019699999999999995,-1.8734177215189773,-50.448143405889844,49.551856594110156,46.64959453691851,2.648305084745765,0.03904,0.03943,0.03702,0.03776,25661774.3,4659.0,11385965.9,-3.278688524590155,41.22401847575057,0.045528955682749256,0.03509704431725075,-0.0011191181017801421,-0.0013015049146736482,0.00018238681289350607,0.0024100000000000024,0.002949285714285714,-317681128.18000036,-0.0027399999999999994,-7.45098039215687,-63.252240717029416,36.74775928297059,52.13018360703624,0.03931333333333333,0.03870103256772696,0.039194285714285716,0.03904382893489888,0.040313,0.03981780821775294,17912.0,11168751.100000003,41430.0,12150588.598571425
2019-11-02,0.03878,0.03966,0.03821,0.03871,47812126.5,7120.0,23586461.7,0.03841,0.03927571428571429,0.0397715,0.03872025814193174,0.038907153775880624,0.03962115366577962,45.11370620774431,0.04424966350988294,0.03529333649011706,-0.0010393767215348196,-0.001213488961015979,0.00017411223948115943,0.00145,0.0027949999999999997,-329372408.7800004,0.0027599999999999986,-3.9454094292804,-51.08834827144684,48.91165172855316,45.07042253521132,-0.18050541516245647,0.03776,0.03882,0.03713,0.03876,36120845.9,5735.0,17970122.5,2.648305084745765,47.82608695652175,0.044620518670907106,0.03533148132909289,-0.0010790654457367502,-0.0012570170208862687,0.00017795157514951848,0.001689999999999997,0.0028128571428571426,-281560282.2800004,-0.0019699999999999995,-1.8734177215189773,-50.448143405889844,49.551856594110156,46.64959453691851,0.038533333333333336,0.03873051628386348,0.03926,0.03897287170117417,0.039976,0.03971706457796695,16431.0,13073821.833333338,39490.0,11859313.33142857
2019-11-03,0.03869,0.04047,0.03843,0.04025,41932593.0,6569.0,21274354.1,0.039240000000000004,0.03931285714285714,0.039489,0.039485129070965866,0.039242865331910466,0.03968104379284823,50.713877784123355,0.04293269996862083,0.03604530003137918,-0.0008735878154331952,-0.0011455087318994223,0.00027192091646622706,0.00204,0.0027835714285714282,-287439815.7800004,0.004029999999999999,0.6250000000000089,-31.370038412291922,68.62996158770808,55.69782330345714,4.032049625226153,0.03878,0.03966,0.03821,0.03871,47812126.5,7120.0,23586461.7,-0.18050541516245647,45.11370620774431,0.04424966350988294,0.03529333649011706,-0.0010393767215348196,-0.001213488961015979,0.00017411223948115943,0.00145,0.0027949999999999997,-329372408.7800004,0.0027599999999999986,-3.9454094292804,-51.08834827144684,48.91165172855316,45.07042253521132,0.03841,0.03872025814193174,0.03927571428571429,0.038907153775880624,0.0397715,0.03962115366577962,17514.0,17647516.700000003,39854.0,13105914.274285713
2019-11-04,0.0403,0.043,0.03993,0.04229,68852785.3,9726.0,34658475.7,0.04041666666666666,0.03970714285714285,0.0394185,0.04088756453548294,0.04000464899893285,0.03992951581257698,54.6981627296588,0.04254206931463876,0.03629493068536124,-0.0005710057628984869,-0.0010306081380992353,0.00045960237520074844,0.0030699999999999963,0.002828571428571428,-218587030.48000038,0.0039900000000000005,4.419753086419753,-8.754623921085024,91.24537607891497,69.59566313172542,4.937965260545902,0.03869,0.04047,0.03843,0.04025,41932593.0,6569.0,21274354.1,4.032049625226153,50.713877784123355,0.04293269996862083,0.03604530003137918,-0.0008735878154331952,-0.0011455087318994223,0.00027192091646622706,0.00204,0.0027835714285714282,-287439815.7800004,0.004029999999999999,0.6250000000000089,-31.370038412291922,68.62996158770808,55.69782330345714,0.039240000000000004,0.039485129070965866,0.03931285714285714,0.039242865331910466,0.039489,0.03968104379284823,19424.0,20943646.100000005,41603.0,14835264.50285714
2019-11-05,0.04221,0.04298,0.04,0.04267,72453257.2,8760.0,34913644.5,0.041736666666666665,0.03993142857142857,0.039552000000000004,0.04177878226774147,0.04067098674919964,0.04019051430661726,55.052083333333336,0.04299237696835759,0.03611162303164242,-0.0002971194737285826,-0.0008839104052251048,0.0005867909314965222,0.0029799999999999965,0.0029578571428571427,-146133773.2800004,0.004069999999999997,4.76307390130124,-4.069050554870493,95.93094944512951,85.2687623705842,1.089789149490647,0.0403,0.043,0.03993,0.04229,68852785.3,9726.0,34658475.7,4.937965260545902,54.6981627296588,0.04254206931463876,0.03629493068536124,-0.0005710057628984869,-0.0010306081380992353,0.00045960237520074844,0.0030699999999999963,0.002828571428571428,-218587030.48000038,0.0039900000000000005,4.419753086419753,-8.754623921085024,91.24537607891497,69.59566313172542,0.04041666666666666,0.04088756453548294,0.03970714285714285,0.04000464899893285,0.0394185,0.03992951581257698,23415.0,26506430.500000004,47062.0,18713666.75714286
2019-11-06,0.04277,0.04452,0.042,0.04246,67881746.91,8086.0,33987868.01,0.04247333333333333,0.04041428571428572,0.039635,0.04211939113387073,0.04111824006189973,0.04040665580122515,72.2488038277512,0.043276373367315504,0.03599362663268449,-9.590235858147195e-05,-0.0007263087958963783,0.0006304064373149063,0.0025199999999999945,0.002704999999999999,-214015520.19000039,0.00247,18.108484005563263,-22.198275862068968,77.80172413793103,88.32601655399185,-0.7248071077858422,0.04221,0.04298,0.04,0.04267,72453257.2,8760.0,34913644.5,1.089789149490647,55.052083333333336,0.04299237696835759,0.03611162303164242,-0.0002971194737285826,-0.0008839104052251048,0.0005867909314965222,0.0029799999999999965,0.0029578571428571427,-146133773.2800004,0.004069999999999997,4.76307390130124,-4.069050554870493,95.93094944512951,85.2687623705842,0.041736666666666665,0.04177878226774147,0.03993142857142857,0.04067098674919964,0.039552000000000004,0.04019051430661726,25055.0,30282158.100000005,48606.0,21950628.785714287
2019-11-07,0.04245,0.0427,0.04,0.04174,72628699.3,7557.0,35537228.6,0.042289999999999994,0.04098285714285715,0.039747,0.04192969556693536,0.041273680046424795,0.04053364096301323,68.30238726790452,0.04350675979078518,0.035987240209214816,5.403385292555851e-06,-0.0005799663596585915,0.0005853697449511474,0.002700000000000001,0.002775714285714285,-286644219.49000037,0.0022099999999999967,15.240198785201532,-30.923248053392637,69.07675194660736,80.93647517655599,-1.6725559481743282,0.04277,0.04452,0.042,0.04246,67881746.91,8086.0,33987868.01,-0.7248071077858422,72.2488038277512,0.043276373367315504,0.03599362663268449,-9.590235858147195e-05,-0.0007263087958963783,0.0006304064373149063,0.0025199999999999945,0.002704999999999999,-214015520.19000039,0.00247,18.108484005563263,-22.198275862068968,77.80172413793103,88.32601655399185,0.04247333333333333,0.04211939113387073,0.04041428571428572,0.04111824006189973,0.039635,0.04040665580122515,26572.0,34519996.07,50655.0,25396698.915714286
2019-11-08,0.04174,0.04196,0.038,0.03901,68353722.7,7326.0,33340174.7,0.04107,0.041018571428571425,0.039682499999999996,0.04046984778346768,0.0407077600348186,0.040388532299869113,52.2568340750159,0.04344657324166462,0.03591842675833537,-0.00013306537247329692,-0.0004905861622215326,0.0003575207897482357,0.003959999999999998,0.0027628571428571424,-354997942.19000036,-0.0020899999999999946,1.853785900783289,-73.36884154460715,26.63115845539285,57.836544846643754,-6.540488739817913,0.04245,0.0427,0.04,0.04174,72628699.3,7557.0,35537228.6,-1.6725559481743282,68.30238726790452,0.04350675979078518,0.035987240209214816,5.403385292555851e-06,-0.0005799663596585915,0.0005853697449511474,0.002700000000000001,0.002775714285714285,-286644219.49000037,0.0022099999999999967,15.240198785201532,-30.923248053392637,69.07675194660736,80.93647517655599,0.042289999999999994,0.04192969556693536,0.04098285714285715,0.041273680046424795,0.039747,0.04053364096301323,24403.0,34812913.70333334,53553.0,28846879.301428568
2019-11-09,0.03901,0.04006,0.0387,0.03998,65257215.5,6195.0,33663283.7,0.04024333333333333,0.0412,0.039681499999999995,0.04022492389173384,0.04052582002611395,0.04034962446178634,54.207317073170735,0.04344522869431433,0.03591777130568566,-0.00016265695907077826,-0.00042500032159138176,0.0002623433625206035,0.00136,0.002667857142857142,-289740726.69000036,0.000900000000000005,3.575129533678756,-60.452729693741645,39.54727030625835,45.0850602360862,2.486541912330168,0.04174,0.04196,0.038,0.03901,68353722.7,7326.0,33340174.7,-6.540488739817913,52.2568340750159,0.04344657324166462,0.03591842675833537,-0.00013306537247329692,-0.0004905861622215326,0.0003575207897482357,0.003959999999999998,0.0027628571428571424,-354997942.19000036,-0.0020899999999999946,1.853785900783289,-73.36884154460715,26.63115845539285,57.836544846643754,0.04107,0.04046984778346768,0.041018571428571425,0.0407077600348186,0.039682499999999996,0.040388532299869113,22969.0,34288423.77,55144.0,31042601.044285715
2019-11-10,0.04003,0.0408,0.03956,0.04049,43405097.1,5502.0,21650026.4,0.03982666666666667,0.041234285714285716,0.039681,0.040357461945866924,0.04051686501958546,0.040362993560663835,51.61082474226804,0.04344427349107338,0.03591772650892662,-0.00014330384932155493,-0.0003686610271374164,0.00022535717781586146,0.001240000000000005,0.002478571428571428,-246335629.59000036,0.0027299999999999963,1.2503125781445412,-53.73333333333332,46.26666666666668,37.481698476105976,1.149138146390195,0.03901,0.04006,0.0387,0.03998,65257215.5,6195.0,33663283.7,2.486541912330168,54.207317073170735,0.04344522869431433,0.03591777130568566,-0.00016265695907077826,-0.00042500032159138176,0.0002623433625206035,0.00136,0.002667857142857142,-289740726.69000036,0.000900000000000005,3.575129533678756,-60.452729693741645,39.54727030625835,45.0850602360862,0.04024333333333333,0.04022492389173384,0.0412,0.04052582002611395,0.039681499999999995,0.04034962446178634,21078.0,34180229.00000001,54219.0,32482147.044285715
2019-11-11,0.04041,0.041,0.03844,0.04073,54213734.9,6125.0,26949469.9,0.0404,0.041011428571428574,0.03968100000000001,0.04054373097293346,0.04057014876468909,0.04039794655488633,53.92156862745099,0.04344427349107339,0.03591772650892663,-0.00010736276505283332,-0.0003164013747204998,0.0002090386096676665,0.0025599999999999998,0.002425714285714285,-192121894.69000036,0.0019699999999999995,3.0356691120667856,-50.53333333333326,49.46666666666674,45.093534546530606,0.7918831972284108,0.04003,0.0408,0.03956,0.04049,43405097.1,5502.0,21650026.4,1.149138146390195,51.61082474226804,0.04344427349107338,0.03591772650892662,-0.00014330384932155493,-0.0003686610271374164,0.00022535717781586146,0.001240000000000005,0.002478571428571428,-246335629.59000036,0.0027299999999999963,1.2503125781445412,-53.73333333333332,46.26666666666668,37.481698476105976,0.03982666666666667,0.040357461945866924,0.041234285714285716,0.04051686501958546,0.039681,0.040362993560663835,19023.0,29551161.600000005,53152.0,32535814.515714284
2019-11-12,0.04072,0.04152,0.03916,0.04034,67130085.8,6846.0,33537160.6,0.04052,0.04067857142857143,0.0399005,0.040441865486466735,0.04051261157351682,0.04039242783537334,47.3087818696884,0.043235194651875475,0.03656580534812452,-0.00010909139971349013,-0.0002749393797190979,0.00016584798000560775,0.002360000000000001,0.0023642857142857137,-259251980.49000037,0.0016299999999999995,-1.8491484184914753,-55.73333333333329,44.266666666666715,46.66666666666672,-0.9332023575638467,0.04041,0.041,0.03844,0.04073,54213734.9,6125.0,26949469.9,0.7918831972284108,53.92156862745099,0.04344427349107339,0.03591772650892663,-0.00010736276505283332,-0.0003164013747204998,0.0002090386096676665,0.0025599999999999998,0.002425714285714285,-192121894.69000036,0.0019699999999999995,3.0356691120667856,-50.53333333333326,49.46666666666674,45.093534546530606,0.0404,0.04054373097293346,0.041011428571428574,0.04057014876468909,0.03968100000000001,0.04039794655488633,17822.0,27420926.66666667,49551.0,31434527.972857144
2019-11-13,0.04046,0.04267,0.04009,0.04198,78673319.9,7145.0,40742979.9,0.04101666666666667,0.04061,0.0401885,0.04121093274323337,0.04087945868013762,0.0405436251843854,60.55312954876277,0.043159952063994124,0.03721704793600588,2.162367455196129e-05,-0.00021562676886488608,0.00023725044341684737,0.002579999999999999,0.0023514285714285707,-180578660.59000036,0.0017300000000000024,7.420675537359278,-33.86666666666658,66.13333333333343,53.28888888888897,3.7567968363816124,0.04072,0.04152,0.03916,0.04034,67130085.8,6846.0,33537160.6,-0.9332023575638467,47.3087818696884,0.043235194651875475,0.03656580534812452,-0.00010909139971349013,-0.0002749393797190979,0.00016584798000560775,0.002360000000000001,0.0023642857142857137,-259251980.49000037,0.0016299999999999995,-1.8491484184914753,-55.73333333333329,44.266666666666715,46.66666666666672,0.04052,0.040441865486466735,0.04067857142857143,0.04051261157351682,0.0399005,0.04039242783537334,18473.0,27378885.633333337,47637.0,31237887.415714286
2019-11-14,0.04199,0.0439,0.0408,0.04378,86108529.1,9634.0,43083269.0,0.04203333333333333,0.040901428571428575,0.0404625,0.042495466371616684,0.04160459401010322,0.04085185135730108,71.16736990154712,0.04369949584575833,0.03722550415424167,0.00026737908972231106,-0.00011902559714744666,0.0003864046868697577,0.0030999999999999986,0.0024007142857142847,-94470131.49000037,0.0014899999999999983,15.942796610169484,-10.013531799729341,89.98646820027066,66.79548940009029,4.262919742795904,0.04046,0.04267,0.04009,0.04198,78673319.9,7145.0,40742979.9,3.7567968363816124,60.55312954876277,0.043159952063994124,0.03721704793600588,2.162367455196129e-05,-0.00021562676886488608,0.00023725044341684737,0.002579999999999999,0.0023514285714285707,-180578660.59000036,0.0017300000000000024,7.420675537359278,-33.86666666666658,66.13333333333343,53.28888888888897,0.04101666666666667,0.04121093274323337,0.04061,0.04087945868013762,0.0401885,0.0405436251843854,20116.0,33743203.46666667,46696.0,32202903.400000002
2019-11-15,0.04372,0.04879,0.0428,0.04623,167667920.12,20332.0,82859475.65,0.04399666666666666,0.04193285714285715,0.040844000000000005,0.04436273318580834,0.04276094550757741,0.04136405598993907,73.83535417996171,0.044861212440196155,0.036826787559803856,0.0006523170464543815,3.5242931572918956e-05,0.0006170741148814625,0.005990000000000002,0.0027078571428571425,73197788.62999964,0.0035600000000000007,19.272445820433436,-23.725671918443,76.274328081557,77.46470987172037,5.741079597438239,0.04199,0.0439,0.0408,0.04378,86108529.1,9634.0,43083269.0,4.262919742795904,71.16736990154712,0.04369949584575833,0.03722550415424167,0.00026737908972231106,-0.00011902559714744666,0.0003864046868697577,0.0030999999999999986,0.0024007142857142847,-94470131.49000037,0.0014899999999999983,15.942796610169484,-10.013531799729341,89.98646820027066,66.79548940009029,0.04203333333333333,0.042495466371616684,0.040901428571428575,0.04160459401010322,0.0404625,0.04085185135730108,23625.0,39121136.5,48773.0,33280909.17142857
2019-11-16,0.04625,0.051,0.0462,0.04935,184800665.5,22806.0,92570247.62,0.046453333333333326,0.04327142857142857,0.041312,0.04685636659290417,0.04440820913068306,0.04212462208613535,78.38847385272146,0.046816021878798963,0.03580797812120104,0.001195361690088284,0.000267266683275992,0.0009280950068122921,0.004799999999999999,0.0029471428571428565,257998454.12999964,0.00689,27.486437613019877,-12.692307692307683,87.30769230769232,84.52282952984001,6.702702702702699,0.04372,0.04879,0.0428,0.04623,167667920.12,20332.0,82859475.65,5.741079597438239,73.83535417996171,0.044861212440196155,0.036826787559803856,0.0006523170464543815,3.5242931572918956e-05,0.0006170741148814625,0.005990000000000002,0.0027078571428571425,73197788.62999964,0.0035600000000000007,19.272445820433436,-23.725671918443,76.274328081557,77.46470987172037,0.04399666666666666,0.04436273318580834,0.04193285714285715,0.04276094550757741,0.040844000000000005,0.04136405598993907,37111.0,55561908.18333334,61779.0,40355095.02142857
2019-11-17,0.04938,0.04946,0.0447,0.04569,141100047.7,18002.0,69192916.9,0.04709,0.04401428571428572,0.041620000000000004,0.04627318329645208,0.0447286568480123,0.04246418188745579,63.03930968360499,0.04738727245577486,0.035852727544225145,0.001315235850313276,0.0004768605166834488,0.0008383753336298273,0.00476,0.0031414285714285706,116898406.42999965,0.003950000000000002,13.515527950310569,-40.84615384615382,59.15384615384618,74.24528884769852,-7.472660996354798,0.04625,0.051,0.0462,0.04935,184800665.5,22806.0,92570247.62,6.702702702702699,78.38847385272146,0.046816021878798963,0.03580797812120104,0.001195361690088284,0.000267266683275992,0.0009280950068122921,0.004799999999999999,0.0029471428571428565,257998454.12999964,0.00689,27.486437613019877,-12.692307692307683,87.30769230769232,84.52282952984001,0.046453333333333326,0.04685636659290417,0.04327142857142857,0.04440820913068306,0.041312,0.04212462208613535,52772.0,72837664.09,78390.0,48770375.58142857
2019-11-18,0.04568,0.04671,0.0421,0.04257,133538004.1,16025.0,65521745.9,0.04587,0.044277142857142855,0.0416935,0.04442159164822604,0.04418899263600922,0.04247425980293619,50.638103919781216,0.047470329489223334,0.03591667051077667,0.0011452770202865503,0.0006105438174040692,0.0005347332028824811,0.004610000000000003,0.0032514285714285713,-16639597.670000345,0.0035599999999999937,0.6620950579333096,-64.84615384615385,35.15384615384614,60.53846153846157,-6.8082311733800385,0.04938,0.04946,0.0447,0.04569,141100047.7,18002.0,69192916.9,-7.472660996354798,63.03930968360499,0.04738727245577486,0.035852727544225145,0.001315235850313276,0.0004768605166834488,0.0008383753336298273,0.00476,0.0031414285714285706,116898406.42999965,0.003950000000000002,13.515527950310569,-40.84615384615382,59.15384615384618,74.24528884769852,0.04709,0.04627318329645208,0.04401428571428572,0.0447286568480123,0.041620000000000004,0.04246418188745579,61140.0,81540880.05666667,90890.0,55562217.08142857
2019-11-19,0.04249,0.04344,0.04002,0.04286,127769998.3,13901.0,66232169.4,0.04370666666666667,0.04463714285714286,0.0418825,0.043640795824113024,0.043856744477006916,0.042510996964561315,50.43478260869566,0.04754552457778639,0.03621947542221362,0.0010222007059318555,0.0006928751951096265,0.000329325510822229,0.0034199999999999994,0.003282857142857143,111130400.62999965,0.0028800000000000006,0.4452777126787044,-62.615384615384585,37.384615384615415,43.89743589743593,0.8707931277947806,0.04568,0.04671,0.0421,0.04257,133538004.1,16025.0,65521745.9,-6.8082311733800385,50.638103919781216,0.047470329489223334,0.03591667051077667,0.0011452770202865503,0.0006105438174040692,0.0005347332028824811,0.004610000000000003,0.0032514285714285713,-16639597.670000345,0.0035599999999999937,0.6620950579333096,-64.84615384615385,35.15384615384614,60.53846153846157,0.04587,0.04442159164822604,0.044277142857142855,0.04418899263600922,0.0416935,0.04247425980293619,56833.0,75761636.80666667,100790.0,61072542.224285714
2019-11-20,0.04286,0.04441,0.04016,0.04031,29670614.6,4443.0,12116155.6,0.04191333333333333,0.04439857142857143,0.042010000000000006,0.04197539791205651,0.04297005835775519,0.042301378206031665,45.55601488218272,0.04738997065147365,0.03663002934852636,0.0007107055798028852,0.0006964412720482783,1.4264307754606898e-05,0.004249999999999997,0.0034064285714285715,81459786.02999964,-0.0001799999999999996,-5.06358926048045,-82.23076923076923,17.769230769230766,30.102564102564116,-5.949603359776024,0.04249,0.04344,0.04002,0.04286,127769998.3,13901.0,66232169.4,0.8707931277947806,50.43478260869566,0.04754552457778639,0.03621947542221362,0.0010222007059318555,0.0006928751951096265,0.000329325510822229,0.0034199999999999994,0.003282857142857143,111130400.62999965,0.0028800000000000006,0.4452777126787044,-62.615384615384585,37.384615384615415,43.89743589743593,0.04370666666666667,0.043640795824113024,0.04463714285714286,0.043856744477006916,0.0418825,0.042510996964561315,47928.0,66982277.4,107845.0,65743257.767142855
2019-11-21,0.0403,0.0425,0.03612,0.03937,98621241.5,13039.0,47209098.5,0.04084666666666666,0.04376857142857143,0.0420405,0.04067269895602826,0.0420700437683164,0.04202219932926674,45.145432199918076,0.0473493386082657,0.036731661391734304,0.0003835717279377024,0.0006338673632261631,-0.0002502956352884607,0.006380000000000004,0.0036692857142857148,-17161455.470000356,-0.00136,-5.678006708193573,-78.15860215053762,21.84139784946239,25.665081334436206,-2.3076923076923084,0.04286,0.04441,0.04016,0.04031,29670614.6,4443.0,12116155.6,-5.949603359776024,45.55601488218272,0.04738997065147365,0.03663002934852636,0.0007107055798028852,0.0006964412720482783,1.4264307754606898e-05,0.004249999999999997,0.0034064285714285715,81459786.02999964,-0.0001799999999999996,-5.06358926048045,-82.23076923076923,17.769230769230766,30.102564102564116,0.04191333333333333,0.04197539791205651,0.04439857142857143,0.04297005835775519,0.042010000000000006,0.042301378206031665,34369.0,47956690.300000004,105143.0,61653711.43857143
2019-11-22,0.03937,0.03999,0.03217,0.03461,148974377.73,15893.0,76638056.81,0.03809666666666667,0.04210857142857143,0.041835500000000005,0.03764134947801413,0.040205032826237296,0.04131627558362229,41.67927382753405,0.04794248469831511,0.0357285153016849,-0.0002568160104516881,0.0004557306884905929,-0.000712546698942281,0.00782,0.003945000000000001,-166135833.20000035,-0.005729999999999999,-11.279159189951294,-87.04195432819965,12.958045671800345,17.522891430164517,-12.090424180848363,0.0403,0.0425,0.03612,0.03937,98621241.5,13039.0,47209098.5,-2.3076923076923084,45.145432199918076,0.0473493386082657,0.036731661391734304,0.0003835717279377024,0.0006338673632261631,-0.0002502956352884607,0.006380000000000004,0.0036692857142857148,-17161455.470000356,-0.00136,-5.678006708193573,-78.15860215053762,21.84139784946239,25.665081334436206,0.04084666666666666,0.04067269895602826,0.04376857142857143,0.0420700437683164,0.0420405,0.04202219932926674,31383.0,41852474.5,108548.0,62243115.65285714
2019-11-23,0.03456,0.03945,0.03382,0.03913,128717242.5,13085.0,63382578.5,0.03770333333333333,0.04064857142857143,0.041779500000000004,0.038385674739007065,0.03993627461967797,0.041108058861372546,48.58286095365121,0.047967700911937784,0.035591299088062224,-0.0003950478167630139,0.00028557498743987154,-0.0006806228042028855,0.005629999999999996,0.00425,-37418590.700000346,-0.0028500000000000053,-2.126063031515768,-63.037705788635144,36.96229421136485,23.92057924420921,13.223379629629623,0.03937,0.03999,0.03217,0.03461,148974377.73,15893.0,76638056.81,-12.090424180848363,41.67927382753405,0.04794248469831511,0.0357285153016849,-0.0002568160104516881,0.0004557306884905929,-0.000712546698942281,0.00782,0.003945000000000001,-166135833.20000035,-0.005729999999999999,-11.279159189951294,-87.04195432819965,12.958045671800345,17.522891430164517,0.03809666666666667,0.03764134947801413,0.04210857142857143,0.040205032826237296,0.041835500000000005,0.04131627558362229,33375.0,45321103.63666668,104109.0,61354341.532857135
2019-11-24,0.03913,0.04011,0.03517,0.03709,133481548.1,16136.0,66282533.3,0.036943333333333335,0.03942,0.0415195,0.037737837369503535,0.03922470596475848,0.04072538658886088,44.606598984771566,0.048045149715600616,0.034993850284399386,-0.0006615821628272942,9.614355738643839e-05,-0.0007577257202137325,0.00494,0.004514285714285715,-170900138.80000034,-0.0066900000000000015,-8.397135095085206,-73.87148167817313,26.128518321826878,25.34961940166404,-5.213391259902888,0.03456,0.03945,0.03382,0.03913,128717242.5,13085.0,63382578.5,13.223379629629623,48.58286095365121,0.047967700911937784,0.035591299088062224,-0.0003950478167630139,0.00028557498743987154,-0.0006806228042028855,0.005629999999999996,0.00425,-37418590.700000346,-0.0028500000000000053,-2.126063031515768,-63.037705788635144,36.96229421136485,23.92057924420921,0.03770333333333333,0.038385674739007065,0.04064857142857143,0.03993627461967797,0.041779500000000004,0.041108058861372546,42017.0,62409911.27,94388.0,57184674.51571429
2019-11-25,0.03705,0.04766,0.0347,0.04635,186877296.7,21377.0,92973546.3,0.040856666666666666,0.039959999999999996,0.0417035,0.04204391868475177,0.041006029473568864,0.041261064056588415,56.93142575234336,0.048564640844233,0.03484235915576699,-0.00012417651187677375,5.207954353379596e-05,-0.0001762560554105697,0.01296,0.005257142857142857,15977157.899999648,0.00012000000000000205,13.798183157377863,-24.694636218799758,75.30536378120024,46.132058771463996,25.101214574898794,0.03913,0.04011,0.03517,0.03709,133481548.1,16136.0,66282533.3,-5.213391259902888,44.606598984771566,0.048045149715600616,0.034993850284399386,-0.0006615821628272942,9.614355738643839e-05,-0.0007577257202137325,0.00494,0.004514285714285715,-170900138.80000034,-0.0066900000000000015,-8.397135095085206,-73.87148167817313,26.128518321826878,25.34961940166404,0.036943333333333335,0.037737837369503535,0.03942,0.03922470596475848,0.0415195,0.04072538658886088,45114.0,68767722.87,92522.0,56768905.43
2019-11-26,0.04635,0.0519,0.04335,0.04927,142576426.7,22343.0,69746473.6,0.04423666666666667,0.040875714285714286,0.042044000000000005,0.04565695934237589,0.04307202210517665,0.04202381986072285,60.36684467146505,0.049693812932021825,0.034394187067978185,0.0005312173914249416,0.00014790711311202508,0.0003833102783129165,0.008550000000000002,0.005699285714285714,158553584.59999964,-7.999999999999674e-05,22.13683688646504,-13.329954384186518,86.67004561581348,62.70130923961354,6.299892125134841,0.03705,0.04766,0.0347,0.04635,186877296.7,21377.0,92973546.3,25.101214574898794,56.93142575234336,0.048564640844233,0.03484235915576699,-0.00012417651187677375,5.207954353379596e-05,-0.0001762560554105697,0.01296,0.005257142857142857,15977157.899999648,0.00012000000000000205,13.798183157377863,-24.694636218799758,75.30536378120024,46.132058771463996,0.040856666666666666,0.04204391868475177,0.039959999999999996,0.041006029473568864,0.0417035,0.041261064056588415,50598.0,74212886.03333335,97874.0,60690591.20142857
2019-11-27,0.04923,0.057,0.0425,0.05594,165386961.39,25796.0,81095742.75,0.05052,0.043108571428571434,0.042754,0.050798479671187946,0.046289016578882486,0.04334917035017782,64.5114345114345,0.05260438262682863,0.03290361737317137,0.0015707286559328293,0.00043247142167618597,0.0011382572342566433,0.014499999999999999,0.006550714285714286,323940545.98999965,0.010249999999999995,33.2539304430681,-4.269029399919473,95.73097060008052,85.9021266656981,13.629900467194785,0.04635,0.0519,0.04335,0.04927,142576426.7,22343.0,69746473.6,6.299892125134841,60.36684467146505,0.049693812932021825,0.034394187067978185,0.0005312173914249416,0.00014790711311202508,0.0003833102783129165,0.008550000000000002,0.005699285714285714,158553584.59999964,-7.999999999999674e-05,22.13683688646504,-13.329954384186518,86.67004561581348,62.70130923961354,0.04423666666666667,0.04565695934237589,0.040875714285714286,0.04307202210517665,0.042044000000000005,0.04202381986072285,59856.0,76334184.39999999,106316.0,61192634.65857142
2019-11-28,0.05591,0.06135,0.05252,0.05357,154090180.23,26786.0,76978776.76,0.05292666666666667,0.045137142857142855,0.04348200000000001,0.052184239835593976,0.048109262434161866,0.04432258269777992,60.057530306143406,0.05427440785777718,0.032689592142222834,0.0021782006876021748,0.0007816172748613837,0.001396583412740791,0.008830000000000005,0.00696,169850365.75999966,0.011000000000000003,22.36180904522613,-26.662097326936262,73.33790267306374,85.24630629631926,-4.185297800035775,0.04923,0.057,0.0425,0.05594,165386961.39,25796.0,81095742.75,13.629900467194785,64.5114345114345,0.05260438262682863,0.03290361737317137,0.0015707286559328293,0.00043247142167618597,0.0011382572342566433,0.014499999999999999,0.006550714285714286,323940545.98999965,0.010249999999999995,33.2539304430681,-4.269029399919473,95.73097060008052,85.9021266656981,0.05052,0.050798479671187946,0.043108571428571434,0.046289016578882486,0.042754,0.04334917035017782,69516.0,81271920.88333333,127669.0,71046861.39428571
2019-11-29,0.05346,0.0579,0.0517,0.05511,104542230.5,17892.0,53046036.1,0.05487333333333333,0.04806571428571428,0.0442385,0.053647119917796984,0.0498594468256214,0.045349955774181834,59.29648241206031,0.056068540752707265,0.032408459247292735,0.0027521665165442313,0.0011757271231979532,0.001576439393346278,0.006199999999999997,0.006975,274392596.25999963,0.012249999999999997,19.208306294613877,-21.38450993831392,78.61549006168607,82.56145444494346,3.086419753086417,0.05591,0.06135,0.05252,0.05357,154090180.23,26786.0,76978776.76,-4.185297800035775,60.057530306143406,0.05427440785777718,0.032689592142222834,0.0021782006876021748,0.0007816172748613837,0.001396583412740791,0.008830000000000005,0.00696,169850365.75999966,0.011000000000000003,22.36180904522613,-26.662097326936262,73.33790267306374,85.24630629631926,0.05292666666666667,0.052184239835593976,0.045137142857142855,0.048109262434161866,0.04348200000000001,0.04432258269777992,74925.0,75940331.03666668,141416.0,75299672.57428572
2019-11-30,0.05536,0.06251,0.05453,0.06061,96199582.77,20379.0,51814373.26,0.05643,0.05113428571428572,0.0452445,0.05712855995889849,0.05254708511921605,0.04680329331949785,61.22856003191065,0.05899793704411747,0.03149106295588253,0.00360923756182311,0.0016624292109229848,0.0019468083509001253,0.007979999999999994,0.0072021428571428575,370592179.0299996,0.0203,22.816616008105363,-6.262359920896503,93.7376400791035,81.89701093795112,9.483381502890168,0.05346,0.0579,0.0517,0.05511,104542230.5,17892.0,53046036.1,3.086419753086417,59.29648241206031,0.056068540752707265,0.032408459247292735,0.0027521665165442313,0.0011757271231979532,0.001576439393346278,0.006199999999999997,0.006975,274392596.25999963,0.012249999999999997,19.208306294613877,-21.38450993831392,78.61549006168607,82.56145444494346,0.05487333333333333,0.053647119917796984,0.04806571428571428,0.0498594468256214,0.0442385,0.045349955774181834,70474.0,70373518.53666668,143415.0,71929383.90142857
2019-12-01,0.06064,0.06078,0.05206,0.056,73344990.8,16762.0,35419193.5,0.05723999999999999,0.053835714285714285,0.046008,0.056564279979449246,0.053410313839412034,0.04767917014621234,60.09003718927383,0.06038735157019026,0.03162864842980974,0.003871851770382656,0.002104313722814919,0.001767538047567737,0.008719999999999999,0.0074849999999999995,297247188.2299996,0.01663,22.565112716130443,-21.456822676334856,78.54317732366515,83.63210248815159,-7.651715039577834,0.05536,0.06251,0.05453,0.06061,96199582.77,20379.0,51814373.26,9.483381502890168,61.22856003191065,0.05899793704411747,0.03149106295588253,0.00360923756182311,0.0016624292109229848,0.0019468083509001253,0.007979999999999994,0.0072021428571428575,370592179.0299996,0.0203,22.816616008105363,-6.262359920896503,93.7376400791035,81.89701093795112,0.05643,0.05712855995889849,0.05113428571428572,0.05254708511921605,0.0452445,0.04680329331949785,65057.0,60613062.04,150709.0,70276783.15285714
2019-12-02,0.05601,0.06377,0.055,0.06326,57432915.06,14593.0,29596432.06,0.059956666666666665,0.05625142857142857,0.047154,0.059912139989724625,0.05587273537955903,0.04916305870371593,68.73076226688394,0.06318933125386679,0.031118668746133216,0.004612625275432068,0.002605976033338349,0.0020066492420937193,0.008769999999999993,0.007782142857142856,354680103.2899996,0.028649999999999995,48.60230209067418,-1.6139240506329005,98.3860759493671,90.22229778404527,12.944117121942512,0.06064,0.06078,0.05206,0.056,73344990.8,16762.0,35419193.5,-7.651715039577834,60.09003718927383,0.06038735157019026,0.03162864842980974,0.003871851770382656,0.002104313722814919,0.001767538047567737,0.008719999999999999,0.0074849999999999995,297247188.2299996,0.01663,22.565112716130443,-21.456822676334856,78.54317732366515,83.63210248815159,0.05723999999999999,0.056564279979449246,0.053835714285714285,0.053410313839412034,0.046008,0.04767917014621234,55033.0,46759867.620000005,151335.0,65867734.61
2019-12-03,0.06325,0.065,0.0592,0.06202,98917702.95,19839.0,49059230.25,0.06042666666666666,0.05807285714285715,0.048156,0.060966069994862315,0.05740955153466927,0.05038752930336203,67.05233179067284,0.06529643468097628,0.031015565319023716,0.00504152046855702,0.0030930849203820833,0.001948435548174937,0.0058,0.007952142857142856,255762400.33999962,0.02289,44.70368642090526,-9.077063661285418,90.92293633871458,89.28406320391564,-1.9446640316205563,0.05601,0.06377,0.055,0.06326,57432915.06,14593.0,29596432.06,12.944117121942512,68.73076226688394,0.06318933125386679,0.031118668746133216,0.004612625275432068,0.002605976033338349,0.0020066492420937193,0.008769999999999993,0.007782142857142856,354680103.2899996,0.028649999999999995,48.60230209067418,-1.6139240506329005,98.3860759493671,90.22229778404527,0.059956666666666665,0.059912139989724625,0.05625142857142857,0.05587273537955903,0.047154,0.04916305870371593,51734.0,38943332.940000005,144551.0,56813861.14714285
2019-12-04,0.06194,0.06219,0.05555,0.05599,108364784.3,19246.0,56957296.8,0.060423333333333336,0.05808000000000001,0.0487665,0.05847803499743116,0.05705466365100195,0.05092109794113707,63.14113308749581,0.06611913884073613,0.03141386115926387,0.004839070600281055,0.003442282056361878,0.001396788543919177,0.00664,0.008122857142857142,147397616.0399996,0.0189,38.89853634333913,-27.444410600060927,72.55558939993907,87.2882005626736,-9.606070390700685,0.06325,0.065,0.0592,0.06202,98917702.95,19839.0,49059230.25,-1.9446640316205563,67.05233179067284,0.06529643468097628,0.031015565319023716,0.00504152046855702,0.0030930849203820833,0.001948435548174937,0.0058,0.007952142857142856,255762400.33999962,0.02289,44.70368642090526,-9.077063661285418,90.92293633871458,89.28406320391564,0.06042666666666666,0.060966069994862315,0.05807285714285715,0.05740955153466927,0.048156,0.05038752930336203,51194.0,38024951.936666675,142047.0,53858540.66857142
2019-12-05,0.05593,0.05609,0.05045,0.05177,105615006.3,19018.0,52857485.3,0.05659333333333333,0.05782285714285714,0.049043500000000004,0.05512401749871558,0.05573349773825147,0.051001945756266875,59.850651414045124,0.0664025228623913,0.031684477137608705,0.004288671750773888,0.00361155999524428,0.0006771117555296083,0.005639999999999999,0.008069999999999999,41782609.73999961,0.005419999999999994,31.49606299212597,-40.29850746268658,59.70149253731341,74.39333942532237,-7.437868764527095,0.06194,0.06219,0.05555,0.05599,108364784.3,19246.0,56957296.8,-9.606070390700685,63.14113308749581,0.06611913884073613,0.03141386115926387,0.004839070600281055,0.003442282056361878,0.001396788543919177,0.00664,0.008122857142857142,147397616.0399996,0.0189,38.89853634333913,-27.444410600060927,72.55558939993907,87.2882005626736,0.060423333333333336,0.05847803499743116,0.05808000000000001,0.05705466365100195,0.0487665,0.05092109794113707,53678.0,45204319.70333334,135497.0,50410191.24714285
2019-12-06,0.05177,0.0586,0.05061,0.0571,51304907.8,11521.0,27466587.3,0.05495333333333333,0.05810714285714286,0.049430999999999996,0.05611200874935779,0.05607512330368859,0.0515827128270986,67.70587309085184,0.06716087119614128,0.03170112880385872,0.004233759013971702,0.0037359997989897644,0.000497759214981938,0.007989999999999997,0.008082142857142855,93087517.5399996,0.007829999999999997,64.98121930078011,-25.33675432969854,74.66324567030146,68.97344253585133,10.295537956345377,0.05593,0.05609,0.05045,0.05177,105615006.3,19018.0,52857485.3,-7.437868764527095,59.850651414045124,0.0664025228623913,0.031684477137608705,0.004288671750773888,0.00361155999524428,0.0006771117555296083,0.005639999999999999,0.008069999999999999,41782609.73999961,0.005419999999999994,31.49606299212597,-40.29850746268658,59.70149253731341,74.39333942532237,0.05659333333333333,0.05512401749871558,0.05782285714285714,0.05573349773825147,0.049043500000000004,0.051001945756266875,58103.0,52958004.116666675,127729.0,46964292.46714286
2019-12-07,0.05702,0.07049,0.05609,0.06898,89589793.14,19885.0,49431472.64,0.05928333333333333,0.05930285714285715,0.050595499999999995,0.06254600437467889,0.059301342477766444,0.053239597319755874,71.05968675038804,0.0702461418537242,0.030944858146275785,0.005090180556203937,0.004006835950432599,0.0010833446057713376,0.014399999999999996,0.008708571428571427,182677310.6799996,0.013040000000000003,76.28418093534373,-4.2190556021234915,95.78094439787651,76.7152275351638,20.975096457383373,0.05177,0.0586,0.05061,0.0571,51304907.8,11521.0,27466587.3,10.295537956345377,67.70587309085184,0.06716087119614128,0.03170112880385872,0.004233759013971702,0.0037359997989897644,0.000497759214981938,0.007989999999999997,0.008082142857142855,93087517.5399996,0.007829999999999997,64.98121930078011,-25.33675432969854,74.66324567030146,68.97344253585133,0.05495333333333333,0.05611200874935779,0.05810714285714286,0.05607512330368859,0.049430999999999996,0.0515827128270986,49785.0,45760456.46666667,121358.0,43310085.495714284
2019-12-08,0.06887,0.07191,0.064,0.06571,87203553.7,19865.0,45793039.79,0.06393,0.06069,0.0517525,0.06412800218733944,0.06090350685832484,0.05442725471787436,69.84743411927879,0.07212517610254297,0.031379823897457026,0.005442303638508908,0.004293929488047861,0.001148374150461047,0.00791,0.008920714285714284,95473756.97999959,0.012140000000000005,77.16365597196011,-16.662187583982792,83.33781241601721,84.59400082806508,-4.5883548714970175,0.05702,0.07049,0.05609,0.06898,89589793.14,19885.0,49431472.64,20.975096457383373,71.05968675038804,0.0702461418537242,0.030944858146275785,0.005090180556203937,0.004006835950432599,0.0010833446057713376,0.014399999999999996,0.008708571428571427,182677310.6799996,0.013040000000000003,76.28418093534373,-4.2190556021234915,95.78094439787651,76.7152275351638,0.05928333333333333,0.06254600437467889,0.05930285714285715,0.059301342477766444,0.050595499999999995,0.053239597319755874,50424.0,43251848.413333334,120864.0,42969671.121428564
2019-12-09,0.06586,0.06989,0.06241,0.06441,47175821.1,13736.0,23754161.5,0.06636666666666667,0.06085428571428571,0.05283,0.06426900109366972,0.061780130143743624,0.05537799236379108,64.07857811038353,0.07349975313681853,0.03216024686318148,0.005552459288309011,0.004545635448100091,0.0010068238402089202,0.007479999999999994,0.008529285714285713,48297935.879999585,0.009299999999999996,38.964401294498366,-25.50153009180553,74.49846990819447,84.53907557402941,-2.201639842089291,0.06887,0.07191,0.064,0.06571,87203553.7,19865.0,45793039.79,-4.5883548714970175,69.84743411927879,0.07212517610254297,0.031379823897457026,0.005442303638508908,0.004293929488047861,0.001148374150461047,0.00791,0.008920714285714284,95473756.97999959,0.012140000000000005,77.16365597196011,-16.662187583982792,83.33781241601721,84.59400082806508,0.06393,0.06412800218733944,0.06069,0.06090350685832484,0.0517525,0.05442725471787436,51271.0,40897033.24333334,123967.0,44451649.16285714
2019-12-10,0.06434,0.06443,0.04673,0.04942,72351356.7,19013.0,32853250.0,0.059846666666666666,0.05905428571428571,0.053285500000000006,0.05684450054683486,0.05869009760780772,0.0548105645196205,50.098412281852774,0.07318055040271304,0.03339044959728697,0.004379704207231487,0.004512449199926371,-0.0001327449926948835,0.0177,0.009182857142857142,-24053420.820000418,-0.011189999999999999,0.30444489547392095,-76.47058823529413,23.52941176470587,60.45523136297252,-23.1893068075847,0.06586,0.06989,0.06241,0.06441,47175821.1,13736.0,23754161.5,-2.201639842089291,64.07857811038353,0.07349975313681853,0.03216024686318148,0.005552459288309011,0.004545635448100091,0.0010068238402089202,0.007479999999999994,0.008529285714285713,48297935.879999585,0.009299999999999996,38.964401294498366,-25.50153009180553,74.49846990819447,84.53907557402941,0.06636666666666667,0.06426900109366972,0.06085428571428571,0.061780130143743624,0.05283,0.05537799236379108,53486.0,39659557.97666667,123110.0,43617039.08285714
2019-12-11,0.04942,0.05786,0.04903,0.05377,123837031.0,22770.0,62179589.3,0.05586666666666667,0.058737142857142856,0.0540055,0.05530725027341743,0.05746007320585579,0.0547114631367995,48.53160102855596,0.07279148298844862,0.035219517011551384,0.0037579763892108473,0.004361554637783266,-0.0006035782485724192,0.008830000000000005,0.008777857142857141,99783610.17999959,-0.002230000000000003,-3.879156238827308,-72.04130262112788,27.95869737887211,41.99552635059083,8.802104411169566,0.06434,0.06443,0.04673,0.04942,72351356.7,19013.0,32853250.0,-23.1893068075847,50.098412281852774,0.07318055040271304,0.03339044959728697,0.004379704207231487,0.004512449199926371,-0.0001327449926948835,0.0177,0.009182857142857142,-24053420.820000418,-0.011189999999999999,0.30444489547392095,-76.47058823529413,23.52941176470587,60.45523136297252,0.059846666666666666,0.05684450054683486,0.05905428571428571,0.05869009760780772,0.053285500000000006,0.0548105645196205,52614.0,34133483.76333334,122284.0,41301899.047142856
2019-12-12,0.05378,0.05421,0.04945,0.05188,96673017.8,17754.0,48986771.4,0.05168999999999999,0.05875285714285715,0.054869,0.05359362513670872,0.05606505490439185,0.05444179998091383,48.84893066339736,0.07134710144915352,0.03839089855084648,0.003077272527351814,0.004104698215696976,-0.0010274256883451623,0.00476,0.008487142857142856,3110592.379999593,-0.011379999999999994,-3.1547507933544883,-79.5472597299444,20.452740270055607,23.980283137877876,-3.5329118631461487,0.04942,0.05786,0.04903,0.05377,123837031.0,22770.0,62179589.3,8.802104411169566,48.53160102855596,0.07279148298844862,0.035219517011551384,0.0037579763892108473,0.004361554637783266,-0.0006035782485724192,0.008830000000000005,0.008777857142857141,99783610.17999959,-0.002230000000000003,-3.879156238827308,-72.04130262112788,27.95869737887211,41.99552635059083,0.05586666666666667,0.05530725027341743,0.058737142857142856,0.05746007320585579,0.0540055,0.0547114631367995,55519.0,39595666.93333334,125808.0,42047940.83285713
2019-12-13,0.052,0.0544,0.05012,0.05118,65516957.0,12233.0,33656295.8,0.05227666666666667,0.05790714285714286,0.05547150000000001,0.05238681256835436,0.05484379117829389,0.05413115236368394,47.29226953286482,0.07032793333977308,0.040615066660226934,0.0024530484472360253,0.003774368262004786,-0.0013213198147687608,0.004279999999999999,0.008349999999999998,-62406364.62000041,-0.010839999999999995,-7.1311921611322715,-82.32724384432089,17.67275615567912,22.02806460153563,-1.576923076923066,0.05378,0.05421,0.04945,0.05188,96673017.8,17754.0,48986771.4,-3.5329118631461487,48.84893066339736,0.07134710144915352,0.03839089855084648,0.003077272527351814,0.004104698215696976,-0.0010274256883451623,0.00476,0.008487142857142856,3110592.379999593,-0.011379999999999994,-3.1547507933544883,-79.5472597299444,20.452740270055607,23.980283137877876,0.05168999999999999,0.05359362513670872,0.05875285714285715,0.05606505490439185,0.054869,0.05444179998091383,59537.0,48006536.900000006,124544.0,41494981.7042857
2019-12-14,0.05117,0.05323,0.0448,0.04585,46289763.9,10964.0,23729095.2,0.04963666666666666,0.05460285714285714,0.0559095,0.049118406284177185,0.05259534338372042,0.053342471186190225,39.806629834254146,0.06888110051806148,0.04293789948193852,0.0015108438437580057,0.00332166337835543,-0.0018108195345974245,0.00843,0.008382142857142855,-108696128.5200004,-0.010139999999999996,-24.352417092888956,-96.12689044632975,3.8731095536702407,13.999535326468338,-10.396716826265386,0.052,0.0544,0.05012,0.05118,65516957.0,12233.0,33656295.8,-1.576923076923066,47.29226953286482,0.07032793333977308,0.040615066660226934,0.0024530484472360253,0.003774368262004786,-0.0013213198147687608,0.004279999999999999,0.008349999999999998,-62406364.62000041,-0.010839999999999995,-7.1311921611322715,-82.32724384432089,17.67275615567912,22.02806460153563,0.05227666666666667,0.05238681256835436,0.05790714285714286,0.05484379117829389,0.05547150000000001,0.05413115236368394,52757.0,48274218.833333336,125256.0,42379225.77571428
2019-12-15,0.04586,0.04798,0.04401,0.04795,20871255.7,5427.0,10669142.4,0.048326666666666664,0.052065714285714285,0.05598949999999999,0.04853420314208859,0.051434007537790316,0.05282890250179116,44.240950064386894,0.06873054924210115,0.04324845075789883,0.0009229531277138783,0.00284192132822712,-0.0019189682005132415,0.003970000000000001,0.008042857142857142,-87824872.8200004,-0.003819999999999997,-14.375000000000004,-85.87813620071685,14.12186379928315,11.889243169544185,4.55734845180986,0.05117,0.05323,0.0448,0.04585,46289763.9,10964.0,23729095.2,-10.396716826265386,39.806629834254146,0.06888110051806148,0.04293789948193852,0.0015108438437580057,0.00332166337835543,-0.0018108195345974245,0.00843,0.008382142857142855,-108696128.5200004,-0.010139999999999996,-24.352417092888956,-96.12689044632975,3.8731095536702407,13.999535326468338,0.04963666666666666,0.049118406284177185,0.05460285714285714,0.05259534338372042,0.0559095,0.053342471186190225,40951.0,35457387.46666667,116335.0,38707457.56999999
2019-12-16,0.04795,0.05373,0.04586,0.05071,134323975.2,22061.0,66716988.0,0.04817,0.05010857142857143,0.0560615,0.0496221015710443,0.05125300565334274,0.052627102263525335,40.4037314574094,0.06865812323173469,0.04346487676826531,0.0006720079441726035,0.0024079386514162166,-0.0017359307072436132,0.007870000000000002,0.007978571428571429,46499102.37999959,-0.00639,-19.838760670249766,-75.98566308243728,24.014336917562716,14.003103423505385,5.755995828988527,0.04586,0.04798,0.04401,0.04795,20871255.7,5427.0,10669142.4,4.55734845180986,44.240950064386894,0.06873054924210115,0.04324845075789883,0.0009229531277138783,0.00284192132822712,-0.0019189682005132415,0.003970000000000001,0.008042857142857142,-87824872.8200004,-0.003819999999999997,-14.375000000000004,-85.87813620071685,14.12186379928315,11.889243169544185,0.048326666666666664,0.04853420314208859,0.052065714285714285,0.051434007537790316,0.05598949999999999,0.05282890250179116,28624.0,22684844.46666667,101897.0,33689757.94285714
2019-12-17,0.05074,0.0555,0.04805,0.05052,223631214.0,32358.0,111235293.6,0.04972666666666667,0.05026571428571429,0.0557905,0.05007105078552215,0.05106975424000706,0.052426425857475305,41.0631022691949,0.06862901520354873,0.042951984796451265,0.0004525835645414339,0.00201686763404126,-0.001564284069499826,0.007449999999999998,0.00809642857142857,-177132111.62000042,-0.018459999999999997,-18.542405675588512,-76.66666666666666,23.33333333333334,20.489844683393084,-0.43358297201418594,0.04795,0.05373,0.04586,0.05071,134323975.2,22061.0,66716988.0,5.755995828988527,40.4037314574094,0.06865812323173469,0.04346487676826531,0.0006720079441726035,0.0024079386514162166,-0.0017359307072436132,0.007870000000000002,0.007978571428571429,46499102.37999959,-0.00639,-19.838760670249766,-75.98566308243728,24.014336917562716,14.003103423505385,0.04817,0.0496221015710443,0.05010857142857143,0.05125300565334274,0.0560615,0.052627102263525335,38452.0,33705075.20000001,110222.0,39827304.58571428
2019-12-18,0.05035,0.05245,0.04252,0.04886,206705175.9,28007.0,103721361.3,0.05003,0.04956428571428572,0.055555,0.04946552539276108,0.050517315680005295,0.05208676625200147,44.055361013840255,0.06873331152830345,0.04237668847169655,0.0001430905769153959,0.0016421122226160873,-0.0014990216457006914,0.009929999999999994,0.008331428571428571,-383837287.52000046,-0.016850000000000004,-12.734416860153598,-78.42803674719293,21.571963252807073,22.97321116790106,-2.95928500496524,0.05074,0.0555,0.04805,0.05052,223631214.0,32358.0,111235293.6,-0.43358297201418594,41.0631022691949,0.06862901520354873,0.042951984796451265,0.0004525835645414339,0.00201686763404126,-0.001564284069499826,0.007449999999999998,0.00809642857142857,-177132111.62000042,-0.018459999999999997,-18.542405675588512,-76.66666666666666,23.33333333333334,20.489844683393084,0.04972666666666667,0.05007105078552215,0.05026571428571429,0.05106975424000706,0.0557905,0.052426425857475305,59846.0,62873808.0,123567.0,51024739.38571428
2019-12-19,0.0489,0.05229,0.0461,0.05169,151625125.2,20883.0,77608925.3,0.05035666666666667,0.049537142857142856,0.055384,0.050577762696380535,0.05081048676000398,0.05204897898990609,49.931717309662005,0.06867489819150745,0.042093101808492565,0.00012473463986462097,0.0013386367060657942,-0.0012139020662011732,0.006190000000000001,0.008370714285714285,-232212162.32000047,-0.012719999999999995,-0.15452965037665578,-68.79891119428378,31.20108880571622,25.368795130618892,5.70552147239264,0.05035,0.05245,0.04252,0.04886,206705175.9,28007.0,103721361.3,-2.95928500496524,44.055361013840255,0.06873331152830345,0.04237668847169655,0.0001430905769153959,0.0016421122226160873,-0.0014990216457006914,0.009929999999999994,0.008331428571428571,-383837287.52000046,-0.016850000000000004,-12.734416860153598,-78.42803674719293,21.571963252807073,22.97321116790106,0.05003,0.04946552539276108,0.04956428571428572,0.050517315680005295,0.055555,0.05208676625200147,82426.0,93891214.3,128804.0,56959278.242857136
2019-12-20,0.05169,0.05596,0.05,0.05374,104546837.7,15369.0,56269435.1,0.05143,0.04990285714285714,0.05504049999999999,0.05215888134819027,0.05154286507000298,0.05221002860991504,46.9620253164557,0.06811606737221895,0.041964932627781025,0.0002724644938577256,0.0011254022636241806,-0.000852937769766455,0.00596,0.008225714285714284,-127665324.62000047,0.004320000000000004,-5.884413309982484,-61.82374957468526,38.176250425314734,30.316434161279357,3.965950860901535,0.0489,0.05229,0.0461,0.05169,151625125.2,20883.0,77608925.3,5.70552147239264,49.931717309662005,0.06867489819150745,0.042093101808492565,0.00012473463986462097,0.0013386367060657942,-0.0012139020662011732,0.006190000000000001,0.008370714285714285,-232212162.32000047,-0.012719999999999995,-0.15452965037665578,-68.79891119428378,31.20108880571622,25.368795130618892,0.05035666666666667,0.050577762696380535,0.049537142857142856,0.05081048676000398,0.055384,0.05204897898990609,81248.0,97521860.06666666,131933.0,61048157.371428564
2019-12-21,0.05374,0.05506,0.0495,0.05012,62627249.7,10778.0,33976997.4,0.05185000000000001,0.050512857142857144,0.05474650000000001,0.051139440674095135,0.05118714880250223,0.0520109782661136,29.953231292517003,0.06799451200578555,0.04149848799421448,9.632731970578984e-05,0.0009195872748405025,-0.0008232599551347127,0.0055599999999999955,0.007594285714285713,-190292574.32000047,-0.0036500000000000005,-27.341258335749497,-74.14086423953728,25.859135760462728,31.745491663831235,-6.7361369557127,0.05169,0.05596,0.05,0.05374,104546837.7,15369.0,56269435.1,3.965950860901535,46.9620253164557,0.06811606737221895,0.041964932627781025,0.0002724644938577256,0.0011254022636241806,-0.000852937769766455,0.00596,0.008225714285714284,-127665324.62000047,0.004320000000000004,-5.884413309982484,-61.82374957468526,38.176250425314734,30.316434161279357,0.05143,0.05215888134819027,0.04990285714285714,0.05154286507000298,0.05504049999999999,0.05221002860991504,64259.0,79199907.23333333,135069.0,64278605.84285714
2019-12-22,0.05014,0.0522,0.04905,0.04996,67138620.5,10928.0,36164256.7,0.05127333333333333,0.0508,0.054081500000000005,0.05054972033704756,0.05088036160187667,0.05181564700267421,32.073753699066685,0.06685695389038834,0.04130604610961167,-5.553317080875253e-05,0.0007245631857106515,-0.000780096356519404,0.00315,0.007254285714285714,-257431194.82000047,-0.001920000000000005,-23.968954497032424,-72.81695286810377,27.183047131896227,30.406144439224576,-0.35899481451934506,0.05374,0.05506,0.0495,0.05012,62627249.7,10778.0,33976997.4,-6.7361369557127,29.953231292517003,0.06799451200578555,0.04149848799421448,9.632731970578984e-05,0.0009195872748405025,-0.0008232599551347127,0.0055599999999999955,0.007594285714285713,-190292574.32000047,-0.0036500000000000005,-27.341258335749497,-74.14086423953728,25.859135760462728,31.745491663831235,0.05185000000000001,0.051139440674095135,0.050512857142857144,0.05118714880250223,0.05474650000000001,0.0520109782661136,47030.0,55951785.93333334,134883.0,65742591.871428564
2019-12-23,0.05,0.05148,0.04818,0.04919,32460529.1,6762.0,17341506.3,0.049756666666666664,0.050582857142857145,0.05344,0.04986986016852378,0.0504577712014075,0.05156558538337191,32.465437788018434,0.06581939374419686,0.04106060625580315,-0.00023530383237075486,0.0005325897820943703,-0.0007678936144651251,0.0032999999999999974,0.0069557142857142856,-289891723.9200005,-0.0019900000000000057,-23.62987113802204,-69.55727978092197,30.44272021907803,27.82830103714568,-1.6200000000000103,0.05014,0.0522,0.04905,0.04996,67138620.5,10928.0,36164256.7,-0.35899481451934506,32.073753699066685,0.06685695389038834,0.04130604610961167,-5.553317080875253e-05,0.0007245631857106515,-0.000780096356519404,0.00315,0.007254285714285714,-257431194.82000047,-0.001920000000000005,-23.968954497032424,-72.81695286810377,27.183047131896227,30.406144439224576,0.05127333333333333,0.05054972033704756,0.0508,0.05088036160187667,0.054081500000000005,0.05181564700267421,37075.0,42136896.400000006,140384.0,69384751.05714284
2019-12-24,0.04902,0.04992,0.0476,0.04847,32274160.9,7047.0,19550776.9,0.04920666666666667,0.05029,0.053064,0.04916993008426189,0.04996082840105563,0.05127076772781268,48.3693786474425,0.0655734110257319,0.0405545889742681,-0.00043090416456467717,0.00033989099276256077,-0.0007707951573272379,0.0023199999999999957,0.005857142857142857,-322165884.82000047,0.0026199999999999973,-1.922298664508293,-61.21251629726208,38.78748370273792,32.13775035123741,-1.1219910240718112,0.05,0.05148,0.04818,0.04919,32460529.1,6762.0,17341506.3,-1.6200000000000103,32.465437788018434,0.06581939374419686,0.04106060625580315,-0.00023530383237075486,0.0005325897820943703,-0.0007678936144651251,0.0032999999999999974,0.0069557142857142856,-289891723.9200005,-0.0019900000000000057,-23.62987113802204,-69.55727978092197,30.44272021907803,27.82830103714568,0.049756666666666664,0.04986986016852378,0.050582857142857145,0.0504577712014075,0.05344,0.05156558538337191,28468.0,29160920.13333334,125085.0,62331110.8142857
2019-12-25,0.04848,0.04888,0.04471,0.04577,52451273.3,8844.0,28273820.5,0.04781,0.04984857142857142,0.052764,0.04746996504213094,0.04891312130079172,0.050746885087068615,35.44395924308587,0.06568508419763149,0.03984291580236851,-0.0007946263146930838,0.00011298753127143184,-0.0009076138459645156,0.00417,0.005524285714285713,-374617158.1200005,-0.0021800000000000014,-14.878184861446908,-75.81845238095242,24.18154761904759,31.137250513621193,-5.589933993399348,0.04902,0.04992,0.0476,0.04847,32274160.9,7047.0,19550776.9,-1.1219910240718112,48.3693786474425,0.0655734110257319,0.0405545889742681,-0.00043090416456467717,0.00033989099276256077,-0.0007707951573272379,0.0023199999999999957,0.005857142857142857,-322165884.82000047,0.0026199999999999973,-1.922298664508293,-61.21251629726208,38.78748370273792,32.13775035123741,0.04920666666666667,0.04916993008426189,0.05029,0.04996082840105563,0.053064,0.05127076772781268,24737.0,24352179.966666672,99774.0,49233322.71428571
2019-12-26,0.04577,0.04688,0.04414,0.04496,36425623.2,6700.0,19573459.5,0.0464,0.04888714285714286,0.052156999999999995,0.04621498252106547,0.04792484097559379,0.050195753174014465,36.893939393939384,0.06535800490593399,0.038955995094066,-0.001135153625310012,-0.00013664070004485693,-0.000998512925265155,0.0027399999999999994,0.005379999999999998,-411042781.32000047,-0.005749999999999998,-13.338473400154205,-81.84523809523812,18.154761904761887,27.041264408849145,-1.7697181559973745,0.04848,0.04888,0.04471,0.04577,52451273.3,8844.0,28273820.5,-5.589933993399348,35.44395924308587,0.06568508419763149,0.03984291580236851,-0.0007946263146930838,0.00011298753127143184,-0.0009076138459645156,0.00417,0.005524285714285713,-374617158.1200005,-0.0021800000000000014,-14.878184861446908,-75.81845238095242,24.18154761904759,31.137250513621193,0.04781,0.04746996504213094,0.04984857142857142,0.04891312130079172,0.052764,0.050746885087068615,22653.0,21722034.566666674,80611.0,38455102.59999999
2019-12-27,0.04498,0.04556,0.04303,0.04425,13773783.6,3084.0,7529440.4,0.04499333333333333,0.04753142857142857,0.0509205,0.045232491260532734,0.047006130731695336,0.049629490966965464,36.87996970844377,0.061939093806555504,0.0399019061934445,-0.001445650479778425,-0.00039844265599157057,-0.0010472078237868544,0.0025300000000000045,0.005255,-424816564.9200005,-0.006270000000000005,-13.540445486518182,-87.12797619047622,12.872023809523775,18.402777777777764,-1.622943530457985,0.04577,0.04688,0.04414,0.04496,36425623.2,6700.0,19573459.5,-1.7697181559973745,36.893939393939384,0.06535800490593399,0.038955995094066,-0.001135153625310012,-0.00013664070004485693,-0.000998512925265155,0.0027399999999999994,0.005379999999999998,-411042781.32000047,-0.005749999999999998,-13.338473400154205,-81.84523809523812,18.154761904761887,27.041264408849145,0.0464,0.04621498252106547,0.04888714285714286,0.04792484097559379,0.052156999999999995,0.050195753174014465,22591.0,22466018.966666672,66428.0,30164321.771428566
2019-12-28,0.0442,0.04666,0.04359,0.0453,12681162.3,3478.0,6386262.4,0.044836666666666664,0.046842857142857144,0.0499,0.045266245630266363,0.0465795980487715,0.04921715849392114,48.757342973339355,0.05871060365935761,0.04108939634064239,-0.0015886819129969504,-0.0006364905073926465,-0.0009521914056043039,0.0030700000000000033,0.004872142857142857,-412135402.6200005,-0.0035600000000000007,-1.199563794983649,-79.3154761904762,20.684523809523792,17.237103174603167,2.4886877828054224,0.04498,0.04556,0.04303,0.04425,13773783.6,3084.0,7529440.4,-1.622943530457985,36.87996970844377,0.061939093806555504,0.0399019061934445,-0.001445650479778425,-0.00039844265599157057,-0.0010472078237868544,0.0025300000000000045,0.005255,-424816564.9200005,-0.006270000000000005,-13.540445486518182,-87.12797619047622,12.872023809523775,18.402777777777764,0.04499333333333333,0.045232491260532734,0.04753142857142857,0.047006130731695336,0.0509205,0.049629490966965464,18628.0,18458906.800000004,54143.0,23201465.385714285
2019-12-29,0.0453,0.0463,0.0419,0.04297,13249200.2,3638.0,6197616.8,0.044173333333333335,0.04584428571428572,0.048827999999999996,0.04411812281513318,0.04567719853657863,0.0486221910183096,38.86404293381038,0.05503882450668293,0.04261717549331706,-0.0018685078858832957,-0.0008828939830907764,-0.0009856139027925193,0.004400000000000001,0.004902857142857144,-425384602.82000047,-0.008719999999999999,-10.385818561001036,-92.38975817923185,7.610241820768146,13.72226314660525,-5.143487858719644,0.0442,0.04666,0.04359,0.0453,12681162.3,3478.0,6386262.4,2.4886877828054224,48.757342973339355,0.05871060365935761,0.04108939634064239,-0.0015886819129969504,-0.0006364905073926465,-0.0009521914056043039,0.0030700000000000033,0.004872142857142857,-412135402.6200005,-0.0035600000000000007,-1.199563794983649,-79.3154761904762,20.684523809523792,17.237103174603167,0.044836666666666664,0.045266245630266363,0.046842857142857144,0.0465795980487715,0.0499,0.04921715849392114,13262.0,11163054.100000005,46843.0,19259931.814285714
2019-12-30,0.04295,0.04345,0.04,0.0406,30810470.1,7522.0,16498969.4,0.042956666666666664,0.044617142857142855,0.048387,0.04235906140756659,0.04440789890243397,0.04785817282608963,26.991351843422848,0.055593547023379666,0.04118045297662033,-0.0022555110511260634,-0.0011574173966978339,-0.0010980936544282296,0.0034500000000000017,0.004587142857142857,-456195072.9200005,-0.013140000000000006,-19.936896075724707,-96.24060150375942,3.7593984962405784,10.684721375510854,-5.471478463329464,0.0453,0.0463,0.0419,0.04297,13249200.2,3638.0,6197616.8,-5.143487858719644,38.86404293381038,0.05503882450668293,0.04261717549331706,-0.0018685078858832957,-0.0008828939830907764,-0.0009856139027925193,0.004400000000000001,0.004902857142857144,-425384602.82000047,-0.008719999999999999,-10.385818561001036,-92.38975817923185,7.610241820768146,13.72226314660525,0.044173333333333335,0.04411812281513318,0.04584428571428572,0.04567719853657863,0.048827999999999996,0.0486221910183096,10200.0,6704439.866666672,39553.0,14978983.257142853
2019-12-31,0.04045,0.04079,0.037,0.0371,21568850.8,5641.0,9975100.3,0.04022333333333333,0.042992857142857145,0.0475535,0.039729530703783295,0.04258092417682548,0.04683358493789062,23.457278481012665,0.055903895578412605,0.03920310442158739,-0.0028122171087820585,-0.001488377339114679,-0.0013238397696673796,0.0037900000000000017,0.004325714285714285,-477763923.7200005,-0.013019999999999997,-26.563737133808395,-99.47257383966243,0.5274261603375677,3.9656888257821117,-8.281829419035844,0.04295,0.04345,0.04,0.0406,30810470.1,7522.0,16498969.4,-5.471478463329464,26.991351843422848,0.055593547023379666,0.04118045297662033,-0.0022555110511260634,-0.0011574173966978339,-0.0010980936544282296,0.0034500000000000017,0.004587142857142857,-456195072.9200005,-0.013140000000000006,-19.936896075724707,-96.24060150375942,3.7593984962405784,10.684721375510854,0.042956666666666664,0.04235906140756659,0.044617142857142855,0.04440789890243397,0.048387,0.04785817282608963,14638.0,9694282.866666673,40313.0,14858620.84285714
2020-01-01,0.03723,0.03967,0.03708,0.03832,20204234.8,5269.0,9791959.5,0.03867333333333333,0.041928571428571426,0.0468755,0.039024765351891644,0.04151569313261911,0.04602276732475818,28.784219001610325,0.05591993411282524,0.03783106588717476,-0.003119012827928133,-0.00181450443687737,-0.0013045083910507632,0.002589999999999995,0.003801428571428571,-457559688.9200005,-0.011639999999999998,-21.571837904216128,-93.0379746835443,6.962025316455704,3.7496166576779637,2.927746441042172,0.04045,0.04079,0.037,0.0371,21568850.8,5641.0,9975100.3,-8.281829419035844,23.457278481012665,0.055903895578412605,0.03920310442158739,-0.0028122171087820585,-0.001488377339114679,-0.0013238397696673796,0.0037900000000000017,0.004325714285714285,-477763923.7200005,-0.013019999999999997,-26.563737133808395,-99.47257383966243,0.5274261603375677,3.9656888257821117,0.04022333333333333,0.039729530703783295,0.042992857142857145,0.04258092417682548,0.0475535,0.04683358493789062,16801.0,10890562.166666672,38907.0,13490667.042857138
2020-01-02,0.03852,0.03918,0.036,0.03642,30680298.8,6396.0,14796820.3,0.03728,0.04070857142857143,0.046137500000000005,0.037722382675945826,0.040241769849464336,0.04510821805573359,18.067754077791733,0.05606835966492306,0.03620664033507695,-0.0034754024901886907,-0.0021466840475396344,-0.0013287184426490563,0.0031800000000000023,0.003586428571428571,-488239987.7200005,-0.012769999999999997,-29.541497388276262,-97.89579158316631,2.104208416833685,3.1978866312089997,-5.451713395638624,0.03723,0.03967,0.03708,0.03832,20204234.8,5269.0,9791959.5,2.927746441042172,28.784219001610325,0.05591993411282524,0.03783106588717476,-0.003119012827928133,-0.00181450443687737,-0.0013045083910507632,0.002589999999999995,0.003801428571428571,-457559688.9200005,-0.011639999999999998,-21.571837904216128,-93.0379746835443,6.962025316455704,3.7496166576779637,0.03867333333333333,0.039024765351891644,0.041928571428571426,0.04151569313261911,0.0468755,0.04602276732475818,18432.0,12088676.400000006,35332.0,10850401.18571428
2020-01-03,0.03645,0.0396,0.03556,0.03906,27496334.2,6703.0,13283947.1,0.03793333333333334,0.039967142857142854,0.045798,0.03839119133797291,0.039946327387098246,0.04453219728852087,20.040816326530603,0.056222238152153714,0.03537376184784628,-0.003504421143068752,-0.0024182314666454582,-0.0010861896764232937,0.004040000000000002,0.003449285714285714,-460743653.5200005,-0.009410000000000002,-27.31671008559733,-82.05128205128207,17.94871794871793,9.004983894002455,7.160493827160478,0.03852,0.03918,0.036,0.03642,30680298.8,6396.0,14796820.3,-5.451713395638624,18.067754077791733,0.05606835966492306,0.03620664033507695,-0.0034754024901886907,-0.0021466840475396344,-0.0013287184426490563,0.0031800000000000023,0.003586428571428571,-488239987.7200005,-0.012769999999999997,-29.541497388276262,-97.89579158316631,2.104208416833685,3.1978866312089997,0.03728,0.037722382675945826,0.04070857142857143,0.040241769849464336,0.046137500000000005,0.04510821805573359,17306.0,11521293.366666673,35028.0,10168024.157142852
2020-01-04,0.03919,0.04248,0.039,0.04027,33250936.0,7172.0,18162758.9,0.03858333333333333,0.039248571428571424,0.045413999999999996,0.03933059566898646,0.040027245540323685,0.044126273737233164,27.704843820733373,0.05606774735160192,0.03476025264839807,-0.0033906959150623167,-0.00261272435632883,-0.0007779715587334867,0.003479999999999997,0.0033007142857142857,-427492717.5200005,-0.005499999999999998,-19.65283320031923,-71.69471153846155,28.305288461538453,16.11940494236337,2.755805052309256,0.03645,0.0396,0.03556,0.03906,27496334.2,6703.0,13283947.1,7.160493827160478,20.040816326530603,0.056222238152153714,0.03537376184784628,-0.003504421143068752,-0.0024182314666454582,-0.0010861896764232937,0.004040000000000002,0.003449285714285714,-460743653.5200005,-0.009410000000000002,-27.31671008559733,-82.05128205128207,17.94871794871793,9.004983894002455,0.03793333333333334,0.03839119133797291,0.039967142857142854,0.039946327387098246,0.045798,0.04453219728852087,18368.0,12624242.300000004,38647.0,10990096.542857138
2020-01-05,0.04027,0.04095,0.0381,0.03847,23547132.8,6042.0,9875235.3,0.039266666666666665,0.038605714285714285,0.044801999999999995,0.038900297834493225,0.03963793415524276,0.043587581000353814,25.790139064475355,0.055580308821555374,0.034023691178444615,-0.0034065442872502974,-0.0027714883425131237,-0.0006350559447371737,0.0028499999999999984,0.003279285714285714,-451039850.3200005,-0.006490000000000003,-22.998398718975178,-81.72110552763822,18.278894472361788,21.510966960872736,-4.469828656568172,0.03919,0.04248,0.039,0.04027,33250936.0,7172.0,18162758.9,2.755805052309256,27.704843820733373,0.05606774735160192,0.03476025264839807,-0.0033906959150623167,-0.00261272435632883,-0.0007779715587334867,0.003479999999999997,0.0033007142857142857,-427492717.5200005,-0.005499999999999998,-19.65283320031923,-71.69471153846155,28.305288461538453,16.11940494236337,0.03858333333333333,0.03933059566898646,0.039248571428571424,0.040027245540323685,0.045413999999999996,0.044126273737233164,20271.0,15414508.766666671,42341.0,12672453.185714284
2020-01-06,0.03844,0.04025,0.03831,0.03949,34933787.7,6737.0,16141448.3,0.03941,0.03844714285714285,0.0442505,0.03919514891724661,0.03960095061643207,0.043197335190796306,29.774812343619686,0.05492516745446178,0.03357583254553822,-0.0032987725641810475,-0.0028769451868467084,-0.0004218273773343392,0.0019400000000000042,0.0031821428571428578,-416106062.62000054,-0.00476,-19.719455173815813,-72.6323119777159,27.3676880222841,24.65062365206146,2.7315296566076883,0.04027,0.04095,0.0381,0.03847,23547132.8,6042.0,9875235.3,-4.469828656568172,25.790139064475355,0.055580308821555374,0.034023691178444615,-0.0034065442872502974,-0.0027714883425131237,-0.0006350559447371737,0.0028499999999999984,0.003279285714285714,-451039850.3200005,-0.006490000000000003,-22.998398718975178,-81.72110552763822,18.278894472361788,21.510966960872736,0.039266666666666665,0.038900297834493225,0.038605714285714285,0.03963793415524276,0.044801999999999995,0.043587581000353814,19917.0,13773980.433333337,44745.0,13197827.257142853
2020-01-07,0.03951,0.03957,0.03713,0.0372,37420845.9,8014.0,16834324.2,0.038386666666666666,0.03846142857142857,0.0436675,0.038197574458623304,0.03900071296232405,0.04262616041072046,27.945205479452056,0.05455370348496104,0.03278129651503896,-0.0033594212419566366,-0.002973440397868694,-0.0003859808440879425,0.0024399999999999977,0.0031907142857142863,-453526908.5200005,-0.008100000000000003,-23.251495770579744,-87.68768768768773,12.312312312312281,19.319631602319404,-5.8466211085801225,0.03844,0.04025,0.03831,0.03949,34933787.7,6737.0,16141448.3,2.7315296566076883,29.774812343619686,0.05492516745446178,0.03357583254553822,-0.0032987725641810475,-0.0028769451868467084,-0.0004218273773343392,0.0019400000000000042,0.0031821428571428578,-416106062.62000054,-0.00476,-19.719455173815813,-72.6323119777159,27.3676880222841,24.65062365206146,0.03941,0.03919514891724661,0.03844714285714285,0.03960095061643207,0.0442505,0.043197335190796306,19951.0,14726480.833333338,43960.0,13146752.81428571
2020-01-08,0.03736,0.03795,0.03594,0.03686,35717356.5,7506.0,16903970.7,0.037849999999999995,0.03825285714285714,0.042926,0.03752878722931165,0.038465534721743036,0.04207700227636613,30.789133247089268,0.05352793507660797,0.03232406492339203,-0.003395776516658802,-0.003057907621626716,-0.00033786889503208605,0.002009999999999998,0.003036428571428572,-489244265.0200005,-0.006110000000000004,-19.466899715971163,-88.51590106007072,11.484098939929293,17.054699758175236,-1.3383297644539627,0.03951,0.03957,0.03713,0.0372,37420845.9,8014.0,16834324.2,-5.8466211085801225,27.945205479452056,0.05455370348496104,0.03278129651503896,-0.0033594212419566366,-0.002973440397868694,-0.0003859808440879425,0.0024399999999999977,0.0031907142857142863,-453526908.5200005,-0.008100000000000003,-23.251495770579744,-87.68768768768773,12.312312312312281,19.319631602319404,0.038386666666666666,0.038197574458623304,0.03846142857142857,0.03900071296232405,0.0436675,0.04262616041072046,20793.0,14283669.266666671,46333.0,14126641.94285714
2020-01-09,0.03686,0.03874,0.03648,0.0374,33356944.3,6132.0,16128419.6,0.03715333333333334,0.03839285714285714,0.042108999999999994,0.037464393614655825,0.03819915104130728,0.041631573488140776,33.50785340314138,0.051669325693647225,0.03254867430635276,-0.003342484763030479,-0.003114823049907469,-0.00022766171312300996,0.002259999999999998,0.0030021428571428573,-455887320.7200005,-0.0031999999999999945,-16.814946619217075,-83.4234234234234,16.576576576576592,13.457662609606068,1.4650027129680026,0.03736,0.03795,0.03594,0.03686,35717356.5,7506.0,16903970.7,-1.3383297644539627,30.789133247089268,0.05352793507660797,0.03232406492339203,-0.003395776516658802,-0.003057907621626716,-0.00033786889503208605,0.002009999999999998,0.003036428571428572,-489244265.0200005,-0.006110000000000004,-19.466899715971163,-88.51590106007072,11.484098939929293,17.054699758175236,0.037849999999999995,0.03752878722931165,0.03825285714285714,0.038465534721743036,0.042926,0.04207700227636613,22257.0,16626581.06666667,48570.0,15142643.542857137
2020-01-10,0.03749,0.0375,0.03588,0.03619,14366760.4,3469.0,6410250.5,0.036816666666666664,0.037982857142857145,0.041412500000000005,0.03682719680732791,0.03769686328098046,0.04111332839403213,32.79248505550812,0.05053511937223721,0.0322898806277628,-0.0033591651866774624,-0.003163691477261468,-0.00019547370941599453,0.0016199999999999964,0.002937142857142857,-470254081.1200005,-0.0009100000000000011,-18.21468926553672,-94.32432432432434,5.675675675675664,11.245450397393862,-3.4675913576953916,0.03686,0.03874,0.03648,0.0374,33356944.3,6132.0,16128419.6,1.4650027129680026,33.50785340314138,0.051669325693647225,0.03254867430635276,-0.003342484763030479,-0.003114823049907469,-0.00022766171312300996,0.002259999999999998,0.0030021428571428573,-455887320.7200005,-0.0031999999999999945,-16.814946619217075,-83.4234234234234,16.576576576576592,13.457662609606068,0.03715333333333334,0.037464393614655825,0.03839285714285714,0.03819915104130728,0.042108999999999994,0.041631573488140776,21652.0,16622238.16666667,48306.0,15332872.01428571
2020-01-11,0.0361,0.03961,0.03605,0.03779,55569199.6,9721.0,22824335.7,0.03712666666666666,0.03762857142857142,0.040804,0.037308598403663955,0.03772014746073534,0.04079682092793383,34.3345848977889,0.04911331854829469,0.03249468145170531,-0.003206317482279196,-0.0031722166782650134,-3.4100804014182504e-05,0.0035600000000000007,0.002972142857142857,-414684881.52000046,-0.0005300000000000027,-16.578366445916124,-79.23649906890134,20.76350093109866,14.338584394450317,4.681440443213289,0.03749,0.0375,0.03588,0.03619,14366760.4,3469.0,6410250.5,-3.4675913576953916,32.79248505550812,0.05053511937223721,0.0322898806277628,-0.0033591651866774624,-0.003163691477261468,-0.00019547370941599453,0.0016199999999999964,0.002937142857142857,-470254081.1200005,-0.0009100000000000011,-18.21468926553672,-94.32432432432434,5.675675675675664,11.245450397393862,0.036816666666666664,0.03682719680732791,0.037982857142857145,0.03769686328098046,0.041412500000000005,0.04111332839403213,17107.0,13147546.933333337,45072.0,14350915.357142853
2020-01-12,0.03774,0.03987,0.03744,0.03987,63155272.3,13313.0,18566832.5,0.03795,0.03782857142857143,0.040338,0.038589299201831975,0.03825761059555151,0.04070855226813061,43.465430016863415,0.047652972676869715,0.03302302732313028,-0.002884099850830088,-0.0031145933127780284,0.00023049346194794042,0.0024300000000000016,0.002831428571428571,-351529609.22000045,0.0034500000000000017,-7.214335582964859,-45.37389100126742,54.62610899873258,27.021761868502313,5.643879173290937,0.0361,0.03961,0.03605,0.03779,55569199.6,9721.0,22824335.7,4.681440443213289,34.3345848977889,0.04911331854829469,0.03249468145170531,-0.003206317482279196,-0.0031722166782650134,-3.4100804014182504e-05,0.0035600000000000007,0.002972142857142857,-414684881.52000046,-0.0005300000000000027,-16.578366445916124,-79.23649906890134,20.76350093109866,14.338584394450317,0.03712666666666666,0.037308598403663955,0.03762857142857142,0.03772014746073534,0.040804,0.04079682092793383,19322.0,15121001.933333337,47621.0,15016854.899999993
2020-01-13,0.0398,0.04198,0.03852,0.04063,31765690.2,7668.0,13996720.3,0.03943,0.03799142857142857,0.039946,0.03960964960091599,0.038850707946663635,0.04070107109973722,50.067842605156045,0.04618761719936036,0.03370438280063964,-0.0025381561241867093,-0.002999305875059765,0.0004611497508730557,0.0034600000000000047,0.002832142857142857,-319763919.02000046,0.001570000000000002,0.073891625615774,-26.734104046242756,73.26589595375724,49.551835294529496,2.085427135678385,0.03774,0.03987,0.03744,0.03987,63155272.3,13313.0,18566832.5,5.643879173290937,43.465430016863415,0.047652972676869715,0.03302302732313028,-0.002884099850830088,-0.0031145933127780284,0.00023049346194794042,0.0024300000000000016,0.002831428571428571,-351529609.22000045,0.0034500000000000017,-7.214335582964859,-45.37389100126742,54.62610899873258,27.021761868502313,0.03795,0.038589299201831975,0.03782857142857143,0.03825761059555151,0.040338,0.04070855226813061,26503.0,15933806.233333334,54892.0,16258511.642857138
2020-01-14,0.0407,0.0407,0.03829,0.03899,47659813.1,10538.0,21975268.5,0.03983,0.03824714285714286,0.039606999999999996,0.03929982480045799,0.03888553095999772,0.04053811194738129,54.66666666666665,0.04522175537267034,0.03399224462732965,-0.002369018946626382,-0.002873248489373088,0.0005042295427467062,0.0024100000000000024,0.0027335714285714285,-367423732.1200005,-0.0012800000000000034,5.094339622641497,-50.43352601156072,49.56647398843928,59.15282631364304,-4.201474201474209,0.0398,0.04198,0.03852,0.04063,31765690.2,7668.0,13996720.3,2.085427135678385,50.067842605156045,0.04618761719936036,0.03370438280063964,-0.0025381561241867093,-0.002999305875059765,0.0004611497508730557,0.0034600000000000047,0.002832142857142857,-319763919.02000046,0.001570000000000002,0.073891625615774,-26.734104046242756,73.26589595375724,49.551835294529496,0.03943,0.03960964960091599,0.03799142857142857,0.038850707946663635,0.039946,0.04070107109973722,30702.0,18462629.500000004,55823.0,15952121.928571424
2020-01-15,0.03899,0.04095,0.0388,0.04001,31846389.9,8994.0,15774414.7,0.039876666666666664,0.03869714285714286,0.0393595,0.03965491240022899,0.03916664821999829,0.04048781557144022,54.21446384039899,0.04438634781424328,0.03433265218575672,-0.00212813917564178,-0.0027242266266268265,0.0005960874509850465,0.002149999999999999,0.0027021428571428574,-335577342.2200005,0.0015399999999999997,4.410229645093944,-35.69364161849713,64.30635838150287,62.3795761078998,2.616055398820211,0.0407,0.0407,0.03829,0.03899,47659813.1,10538.0,21975268.5,-4.201474201474209,54.66666666666665,0.04522175537267034,0.03399224462732965,-0.002369018946626382,-0.002873248489373088,0.0005042295427467062,0.0024100000000000024,0.0027335714285714285,-367423732.1200005,-0.0012800000000000034,5.094339622641497,-50.43352601156072,49.56647398843928,59.15282631364304,0.03983,0.03929982480045799,0.03824714285714286,0.03888553095999772,0.039606999999999996,0.04053811194738129,31519.0,18179607.100000005,58347.0,16686542.542857138
2020-01-16,0.04005,0.0404,0.03882,0.03962,33754861.6,7569.0,14549468.6,0.03954,0.03901428571428572,0.039128,0.039637456200114496,0.03927998616499871,0.04040516646939829,58.629989212513486,0.04360267070240159,0.034653329297598415,-0.0019462745211593427,-0.00256863620553333,0.0006223616843739873,0.001579999999999998,0.0025878571428571426,-369332203.8200005,0.0001300000000000051,8.786381109280628,-41.32947976878608,58.67052023121393,57.514450867052034,-1.0736579275905114,0.03899,0.04095,0.0388,0.04001,31846389.9,8994.0,15774414.7,2.616055398820211,54.21446384039899,0.04438634781424328,0.03433265218575672,-0.00212813917564178,-0.0027242266266268265,0.0005960874509850465,0.002149999999999999,0.0027021428571428574,-335577342.2200005,0.0015399999999999997,4.410229645093944,-35.69364161849713,64.30635838150287,62.3795761078998,0.039876666666666664,0.03965491240022899,0.03869714285714286,0.03916664821999829,0.0393595,0.04048781557144022,27200.0,17248801.16666667,59835.0,16525177.399999993
2020-01-17,0.03975,0.04289,0.03911,0.0422,47293870.5,9089.0,21764190.0,0.04061,0.03987285714285715,0.038973,0.04091872810005725,0.040009989623749034,0.040576102996122264,58.495670995671006,0.04269974035645161,0.03524625964354839,-0.001575796236067302,-0.0023700682116401246,0.0007942719755728227,0.0037799999999999986,0.002569285714285714,-322038333.3200005,0.0050000000000000044,8.038914490527404,-9.843081312410794,90.15691868758921,71.04459910010202,6.1635220125786185,0.04005,0.0404,0.03882,0.03962,33754861.6,7569.0,14549468.6,-1.0736579275905114,58.629989212513486,0.04360267070240159,0.034653329297598415,-0.0019462745211593427,-0.00256863620553333,0.0006223616843739873,0.001579999999999998,0.0025878571428571426,-369332203.8200005,0.0001300000000000051,8.786381109280628,-41.32947976878608,58.67052023121393,57.514450867052034,0.03954,0.039637456200114496,0.03901428571428572,0.03927998616499871,0.039128,0.04040516646939829,27101.0,17433050.600000005,61272.0,16299612.971428568
2020-01-18,0.0422,0.04232,0.04062,0.04109,36008780.0,7684.0,18436546.6,0.040970000000000006,0.040344285714285714,0.038879,0.04100436405002862,0.040279992217811776,0.04062504556792014,52.230685527747546,0.04226005495840775,0.035497945041592247,-0.00135612468807704,-0.0021672795069275076,0.0008111548188504676,0.0017000000000000001,0.002442142857142857,-358047113.3200005,0.004230000000000005,2.0362552768810493,-25.677603423680416,74.32239657631958,74.38327849837424,-2.6303317535545023,0.03975,0.04289,0.03911,0.0422,47293870.5,9089.0,21764190.0,6.1635220125786185,58.495670995671006,0.04269974035645161,0.03524625964354839,-0.001575796236067302,-0.0023700682116401246,0.0007942719755728227,0.0037799999999999986,0.002569285714285714,-322038333.3200005,0.0050000000000000044,8.038914490527404,-9.843081312410794,90.15691868758921,71.04459910010202,0.04061,0.04091872810005725,0.03987285714285715,0.040009989623749034,0.038973,0.040576102996122264,25652.0,17362691.100000005,66892.0,18493032.899999995
2020-01-19,0.04115,0.04115,0.0362,0.03771,37177795.9,9016.0,15108709.3,0.04033333333333333,0.040035714285714286,0.0387345,0.039357182025014315,0.03963749416335883,0.04034742218049917,48.09619238476955,0.04205229555859247,0.03541670444140753,-0.0014381925671379317,-0.0020214621189695923,0.0005832695518316606,0.004949999999999996,0.0025921428571428567,-395224909.2200005,0.0003099999999999978,-1.9755653756173608,-73.8944365192582,26.10556348074179,63.52829291488354,-8.359659781287968,0.0422,0.04232,0.04062,0.04109,36008780.0,7684.0,18436546.6,-2.6303317535545023,52.230685527747546,0.04226005495840775,0.035497945041592247,-0.00135612468807704,-0.0021672795069275076,0.0008111548188504676,0.0017000000000000001,0.002442142857142857,-358047113.3200005,0.004230000000000005,2.0362552768810493,-25.677603423680416,74.32239657631958,74.38327849837424,0.040970000000000006,0.04100436405002862,0.040344285714285714,0.040279992217811776,0.038879,0.04062504556792014,24342.0,18250068.400000002,64855.0,17866205.88571428
2020-01-20,0.03771,0.03803,0.0364,0.03734,36097815.0,7158.0,17095422.3,0.038713333333333336,0.03956571428571428,0.0387465,0.038348591012507156,0.039063120622519126,0.04006100102045163,44.43293630243398,0.042041058671855785,0.03545194132814422,-0.0015156167736142673,-0.0019202930498985274,0.0004046762762842601,0.0016299999999999995,0.0025699999999999994,-431322724.2200005,0.0011499999999999982,-5.444416307926058,-79.17261055634812,20.827389443651885,40.41844983357109,-0.9811721028904861,0.04115,0.04115,0.0362,0.03771,37177795.9,9016.0,15108709.3,-8.359659781287968,48.09619238476955,0.04205229555859247,0.03541670444140753,-0.0014381925671379317,-0.0020214621189695923,0.0005832695518316606,0.004949999999999996,0.0025921428571428567,-395224909.2200005,0.0003099999999999978,-1.9755653756173608,-73.8944365192582,26.10556348074179,63.52829291488354,0.04033333333333333,0.039357182025014315,0.040035714285714286,0.03963749416335883,0.0387345,0.04034742218049917,25789.0,18436481.966666672,60558.0,17372188.28571428
2020-01-21,0.0374,0.039,0.03713,0.03802,35310804.2,7200.0,14990992.8,0.03769,0.03942714285714286,0.038731499999999995,0.038184295506253574,0.038802340466889344,0.03986661997088481,52.31638418079096,0.04203694861199061,0.03542605138800938,-0.0015047597641741975,-0.0018371863927536614,0.0003324266285794639,0.0018699999999999967,0.0025292857142857135,-396011920.0200005,0.00023000000000000104,2.204301075268811,-69.47218259629105,30.52781740370895,25.820256776034213,1.6577540106951751,0.03771,0.03803,0.0364,0.03734,36097815.0,7158.0,17095422.3,-0.9811721028904861,44.43293630243398,0.042041058671855785,0.03545194132814422,-0.0015156167736142673,-0.0019202930498985274,0.0004046762762842601,0.0016299999999999995,0.0025699999999999994,-431322724.2200005,0.0011499999999999982,-5.444416307926058,-79.17261055634812,20.827389443651885,40.41844983357109,0.038713333333333336,0.038348591012507156,0.03956571428571428,0.039063120622519126,0.0387465,0.04006100102045163,23858.0,16880226.066666674,60048.0,17814859.999999996
2020-01-22,0.03798,0.03989,0.03772,0.03952,35758005.1,6772.0,16572089.0,0.03829333333333333,0.03935714285714286,0.0388865,0.03885214775312679,0.038981755350167006,0.03983360854508625,57.05196182396607,0.04202192257710771,0.03575107742289228,-0.0013594471811180162,-0.0017416385504265325,0.0003821913693085163,0.0021700000000000053,0.0025407142857142855,-360253914.9200005,-0.0003500000000000031,7.2164948453608435,-48.07417974322397,51.925820256776035,34.42700903471229,4.054765666140073,0.0374,0.039,0.03713,0.03802,35310804.2,7200.0,14990992.8,1.6577540106951751,52.31638418079096,0.04203694861199061,0.03542605138800938,-0.0015047597641741975,-0.0018371863927536614,0.0003324266285794639,0.0018699999999999967,0.0025292857142857135,-396011920.0200005,0.00023000000000000104,2.204301075268811,-69.47218259629105,30.52781740370895,25.820256776034213,0.03769,0.038184295506253574,0.03942714285714286,0.038802340466889344,0.038731499999999995,0.03986661997088481,23374.0,15731708.133333338,56710.0,16817106.328571424
2020-01-23,0.03953,0.03976,0.03709,0.03775,32755381.6,7995.0,13709264.4,0.03843,0.03909,0.038821,0.038301073876563396,0.038673816512625254,0.03963516963603042,50.87108013937281,0.04199564892384472,0.03564635107615528,-0.0013713025968874817,-0.0016675713597187225,0.0002962687628312408,0.0026699999999999988,0.00257,-393009296.5200005,-0.0028800000000000006,0.9358288770053402,-73.32382310984312,26.67617689015689,36.376604850213965,-4.502909182899073,0.03798,0.03989,0.03772,0.03952,35758005.1,6772.0,16572089.0,4.054765666140073,57.05196182396607,0.04202192257710771,0.03575107742289228,-0.0013594471811180162,-0.0017416385504265325,0.0003821913693085163,0.0021700000000000053,0.0025407142857142855,-360253914.9200005,-0.0003500000000000031,7.2164948453608435,-48.07417974322397,51.925820256776035,34.42700903471229,0.03829333333333333,0.03885214775312679,0.03935714285714286,0.038981755350167006,0.0388865,0.03983360854508625,21130.0,16219501.366666669,54488.0,16931059.799999993
2020-01-24,0.03777,0.03929,0.0368,0.03893,35827414.9,6848.0,13131644.7,0.038733333333333335,0.03862285714285714,0.038754,0.038615536938281694,0.03873786238446894,0.03956801062307515,56.82951146560319,0.041855608411298394,0.0356523915887016,-0.001270832593893323,-0.0015882236065536428,0.0003173910126603198,0.002489999999999999,0.002632142857142857,-357181881.62000054,-5.9999999999997555e-05,7.57115225200331,-57.894736842105246,42.105263157894754,40.23575343494256,3.071220545406411,0.03953,0.03976,0.03709,0.03775,32755381.6,7995.0,13709264.4,-4.502909182899073,50.87108013937281,0.04199564892384472,0.03564635107615528,-0.0013713025968874817,-0.0016675713597187225,0.0002962687628312408,0.0026699999999999988,0.00257,-393009296.5200005,-0.0028800000000000006,0.9358288770053402,-73.32382310984312,26.67617689015689,36.376604850213965,0.03843,0.038301073876563396,0.03909,0.038673816512625254,0.038821,0.03963516963603042,21967.0,15090782.06666667,54914.0,16811030.628571425
2020-01-25,0.03893,0.0409,0.03803,0.03989,39111811.7,8196.0,15270203.2,0.03885666666666667,0.038451428571428574,0.038825000000000005,0.039252768469140845,0.03902589678835171,0.03959867627802037,55.40679711637489,0.041964020967080934,0.03568597903291908,-0.0011010531602780385,-0.001490789517298522,0.0003897363570204834,0.0028699999999999976,0.002582857142857143,-318070069.92000055,-0.00011999999999999511,5.5570256681662045,-44.84304932735424,55.15695067264576,41.31279690689914,2.465964551759575,0.03777,0.03929,0.0368,0.03893,35827414.9,6848.0,13131644.7,3.071220545406411,56.82951146560319,0.041855608411298394,0.0356523915887016,-0.001270832593893323,-0.0015882236065536428,0.0003173910126603198,0.002489999999999999,0.002632142857142857,-357181881.62000054,-5.9999999999997555e-05,7.57115225200331,-57.894736842105246,42.105263157894754,40.23575343494256,0.038733333333333335,0.038615536938281694,0.03862285714285714,0.03873786238446894,0.038754,0.03956801062307515,21615.0,14470999.366666669,52673.0,15577809.871428568
2020-01-26,0.03985,0.04053,0.0385,0.03889,34305760.4,6746.0,11766041.9,0.03923666666666666,0.03862,0.038795,0.03907138423457042,0.03899192259126378,0.03953118329916129,47.32824427480915,0.04191869214740726,0.035671307852592746,-0.001035259550918162,-0.00139968352402245,0.0003644239731042881,0.002029999999999997,0.002554285714285714,-352375830.3200005,-0.0007300000000000015,-2.4579884625031356,-59.79073243647235,40.20926756352765,45.82382713135606,-2.409033877038885,0.03893,0.0409,0.03803,0.03989,39111811.7,8196.0,15270203.2,2.465964551759575,55.40679711637489,0.041964020967080934,0.03568597903291908,-0.0011010531602780385,-0.001490789517298522,0.0003897363570204834,0.0028699999999999976,0.002582857142857143,-318070069.92000055,-0.00011999999999999511,5.5570256681662045,-44.84304932735424,55.15695067264576,41.31279690689914,0.03885666666666667,0.039252768469140845,0.038451428571428574,0.03902589678835171,0.038825000000000005,0.03959867627802037,23039.0,14037037.433333337,53185.0,15125475.099999994
2020-01-27,0.03901,0.03955,0.03875,0.03892,35556384.2,7722.0,9284296.2,0.039233333333333335,0.03884571428571428,0.038881,0.03899569211728521,0.03897394194344784,0.03947297536590783,45.14480408858604,0.04191316372287183,0.03584883627712817,-0.0009695208592439761,-0.0013136509910667555,0.00034413013182277947,0.0008000000000000021,0.0023642857142857137,-316819446.12000054,-0.003279999999999998,-4.20871277381244,-59.34230194319877,40.65769805680123,45.341305430991554,-0.23071007433991234,0.03985,0.04053,0.0385,0.03889,34305760.4,6746.0,11766041.9,-2.409033877038885,47.32824427480915,0.04191869214740726,0.035671307852592746,-0.001035259550918162,-0.00139968352402245,0.0003644239731042881,0.002029999999999997,0.002554285714285714,-352375830.3200005,-0.0007300000000000015,-2.4579884625031356,-59.79073243647235,40.20926756352765,45.82382713135606,0.03923666666666666,0.03907138423457042,0.03862,0.03899192259126378,0.038795,0.03953118329916129,21790.0,13389296.600000003,50915.0,14647951.18571428
2020-01-28,0.03892,0.03966,0.0372,0.03767,38248559.1,7346.0,12799818.9,0.03849333333333333,0.03879571428571429,0.0389215,0.03833284605864261,0.03864795645758588,0.03930126342629756,46.167247386759605,0.04186020200494688,0.03598279799505311,-0.0010066826152343583,-0.0012522573159002763,0.000245574700665918,0.002460000000000004,0.0023678571428571425,-355068005.22000057,-0.0034199999999999994,-3.385483457296734,-78.0269058295964,21.97309417040359,34.28001993024416,-3.211716341212747,0.03901,0.03955,0.03875,0.03892,35556384.2,7722.0,9284296.2,-0.23071007433991234,45.14480408858604,0.04191316372287183,0.03584883627712817,-0.0009695208592439761,-0.0013136509910667555,0.00034413013182277947,0.0008000000000000021,0.0023642857142857137,-316819446.12000054,-0.003279999999999998,-4.20871277381244,-59.34230194319877,40.65769805680123,45.341305430991554,0.039233333333333335,0.03899569211728521,0.03884571428571428,0.03897394194344784,0.038881,0.03947297536590783,22664.0,12106847.100000003,51479.0,13532076.028571425
2020-01-29,0.0377,0.03795,0.0369,0.03698,35117278.1,7045.0,11548622.3,0.03785666666666667,0.038432857142857144,0.0389005,0.037656423029321304,0.03823096734318941,0.03908019071903113,41.03019538188278,0.04189053590898784,0.03591046409101215,-0.0010793685196116218,-0.0012176795566425456,0.0001383110370309238,0.0010499999999999954,0.0022892857142857133,-390185283.3200006,-0.0007300000000000015,-7.573106723319167,-88.34080717488794,11.659192825112056,24.763328350772298,-1.9098143236074232,0.03892,0.03966,0.0372,0.03767,38248559.1,7346.0,12799818.9,-3.211716341212747,46.167247386759605,0.04186020200494688,0.03598279799505311,-0.0010066826152343583,-0.0012522573159002763,0.000245574700665918,0.002460000000000004,0.0023678571428571425,-355068005.22000057,-0.0034199999999999994,-3.385483457296734,-78.0269058295964,21.97309417040359,34.28001993024416,0.03849333333333333,0.03833284605864261,0.03879571428571429,0.03864795645758588,0.0389215,0.03930126342629756,21814.0,11283385.666666672,51625.0,13219051.18571428
2020-01-30,0.03698,0.0391,0.03621,0.0383,37129415.2,6990.0,17478773.2,0.037649999999999996,0.03851142857142858,0.039006,0.03797821151466065,0.038248225507392056,0.03900588684102816,46.2962962962963,0.04173045764765737,0.03628154235234263,-0.001018716524242104,-0.0011778869501624573,0.00015917042592035338,0.0028900000000000037,0.0023828571428571423,-353055868.1200006,0.0009600000000000025,-3.3316506814740077,-68.60986547085203,31.39013452914797,21.67414050822121,3.56949702541915,0.0377,0.03795,0.0369,0.03698,35117278.1,7045.0,11548622.3,-1.9098143236074232,41.03019538188278,0.04189053590898784,0.03591046409101215,-0.0010793685196116218,-0.0012176795566425456,0.0001383110370309238,0.0010499999999999954,0.0022892857142857133,-390185283.3200006,-0.0007300000000000015,-7.573106723319167,-88.34080717488794,11.659192825112056,24.763328350772298,0.03785666666666667,0.037656423029321304,0.038432857142857144,0.03823096734318941,0.0389005,0.03908019071903113,22113.0,11210912.46666667,51898.0,12501413.085714282
2020-01-31,0.03837,0.03898,0.03751,0.0389,35769624.9,7195.0,11166756.9,0.038060000000000004,0.03850714285714286,0.0390615,0.038439105757330325,0.03841116913054404,0.03899580237997786,39.58333333333332,0.04172622690418336,0.03639677309581664,-0.0009117246016677807,-0.0011246544804635222,0.0002129298787957414,0.001469999999999999,0.0022178571428571425,-317286243.2200006,0.0008799999999999988,-7.81990521327015,-55.88235294117657,44.11764705882343,29.05565813769449,1.3812874641647008,0.03698,0.0391,0.03621,0.0383,37129415.2,6990.0,17478773.2,3.56949702541915,46.2962962962963,0.04173045764765737,0.03628154235234263,-0.001018716524242104,-0.0011778869501624573,0.00015917042592035338,0.0028900000000000037,0.0023828571428571423,-353055868.1200006,0.0009600000000000025,-3.3316506814740077,-68.60986547085203,31.39013452914797,21.67414050822121,0.037649999999999996,0.03797821151466065,0.03851142857142858,0.038248225507392056,0.039006,0.03900588684102816,21381.0,13942404.800000003,50893.0,13039914.34285714
2020-02-01,0.0389,0.03945,0.0379,0.03862,34464424.5,5669.0,11612729.5,0.03860666666666667,0.03832571428571429,0.038999,0.03852955287866516,0.03846337684790803,0.038960011677122826,41.77215189873418,0.041642433970820764,0.036355566029179234,-0.000839845179688832,-0.001067692620308584,0.00022784744061975204,0.0015499999999999958,0.0022071428571428563,-351750667.7200006,-0.000899999999999998,-6.0111949379411005,-51.11111111111111,48.8888888888889,41.465556825620105,-0.7197943444729963,0.03837,0.03898,0.03751,0.0389,35769624.9,7195.0,11166756.9,1.3812874641647008,39.58333333333332,0.04172622690418336,0.03639677309581664,-0.0009117246016677807,-0.0011246544804635222,0.0002129298787957414,0.001469999999999999,0.0022178571428571425,-317286243.2200006,0.0008799999999999988,-7.81990521327015,-55.88235294117657,44.11764705882343,29.05565813769449,0.038060000000000004,0.038439105757330325,0.03850714285714286,0.03841116913054404,0.0390615,0.03899580237997786,21230.0,13398050.800000004,51240.0,12759216.08571428
2020-02-02,0.0386,0.04029,0.03785,0.0394,36092415.0,7616.0,14437850.3,0.03897333333333333,0.03839857142857143,0.0389375,0.03896477643933258,0.03869753263593102,0.03900191532692065,56.80902497985495,0.04147632587868878,0.03639867412131122,-0.0007117362857772605,-0.0009965013534023195,0.00028476506762505896,0.0024399999999999977,0.0020278571428571424,-315658252.7200006,0.0016499999999999987,4.4815698753646105,-31.982942430703652,68.01705756929634,53.67453117233623,2.0725388601036143,0.0389,0.03945,0.0379,0.03862,34464424.5,5669.0,11612729.5,-0.7197943444729963,41.77215189873418,0.041642433970820764,0.036355566029179234,-0.000839845179688832,-0.001067692620308584,0.00022784744061975204,0.0015499999999999958,0.0022071428571428563,-351750667.7200006,-0.000899999999999998,-6.0111949379411005,-51.11111111111111,48.8888888888889,41.465556825620105,0.03860666666666667,0.03852955287866516,0.03832571428571429,0.03846337684790803,0.038999,0.038960011677122826,19854.0,13419419.866666669,48713.0,12236719.84285714
2020-02-03,0.03939,0.04112,0.03903,0.04111,36619792.6,7796.0,14095165.8,0.03971,0.03871142857142857,0.039043499999999995,0.04003738821966629,0.039300649476948266,0.03920268529578535,63.70909090909092,0.04176220925260397,0.03632479074739602,-0.00046684485851573865,-0.0008905700544250034,0.00042372519590926474,0.0020899999999999946,0.0020607142857142846,-279038460.1200006,0.0021800000000000014,10.096411355115166,-0.20366598777996187,99.79633401222003,72.2340934901351,4.366590505204364,0.0386,0.04029,0.03785,0.0394,36092415.0,7616.0,14437850.3,2.0725388601036143,56.80902497985495,0.04147632587868878,0.03639867412131122,-0.0007117362857772605,-0.0009965013534023195,0.00028476506762505896,0.0024399999999999977,0.0020278571428571424,-315658252.7200006,0.0016499999999999987,4.4815698753646105,-31.982942430703652,68.01705756929634,53.67453117233623,0.03897333333333333,0.03896477643933258,0.03839857142857143,0.03869753263593102,0.0389375,0.03900191532692065,20480.0,12405778.900000004,49583.0,12618406.757142853
2020-02-04,0.0411,0.04272,0.03942,0.04117,45756578.8,7660.0,20195560.5,0.04055999999999999,0.03921142857142857,0.0391015,0.040603694109833145,0.0397679871077112,0.03939004860094865,61.99543031226199,0.0419532641816186,0.036249735818381396,-0.00026487186156137765,-0.0007654304158522783,0.0005005585542909006,0.0033000000000000043,0.0021628571428571426,-233281881.3200006,0.0012799999999999964,8.28511309836928,-23.809523809523846,76.19047619047615,81.33462259066418,0.17031630170316453,0.03939,0.04112,0.03903,0.04111,36619792.6,7796.0,14095165.8,4.366590505204364,63.70909090909092,0.04176220925260397,0.03632479074739602,-0.00046684485851573865,-0.0008905700544250034,0.00042372519590926474,0.0020899999999999946,0.0020607142857142846,-279038460.1200006,0.0021800000000000014,10.096411355115166,-0.20366598777996187,99.79633401222003,72.2340934901351,0.03971,0.04003738821966629,0.03871142857142857,0.039300649476948266,0.039043499999999995,0.03920268529578535,21081.0,13381915.200000005,49657.0,13305673.84285714
2020-02-05,0.04119,0.04178,0.04004,0.04095,51881282.8,8251.0,25355229.7,0.04107666666666667,0.03977857142857143,0.039167999999999994,0.040776847054916576,0.040063490330783394,0.039538615400858304,56.03375527426161,0.042130549400020645,0.036205450599979344,-0.00012116228432862419,-0.0006365767895475475,0.0005154145052189233,0.0017399999999999985,0.0021321428571428563,-285163164.1200006,0.0020599999999999993,3.6184210526315708,-27.188940092165904,72.81105990783409,82.93262337017676,-0.5826656955571673,0.0411,0.04272,0.03942,0.04117,45756578.8,7660.0,20195560.5,0.17031630170316453,61.99543031226199,0.0419532641816186,0.036249735818381396,-0.00026487186156137765,-0.0007654304158522783,0.0005005585542909006,0.0033000000000000043,0.0021628571428571426,-233281881.3200006,0.0012799999999999964,8.28511309836928,-23.809523809523846,76.19047619047615,81.33462259066418,0.04055999999999999,0.040603694109833145,0.03921142857142857,0.0397679871077112,0.0391015,0.03939004860094865,23072.0,16242858.866666673,49971.0,14362208.357142853
2020-02-06,0.04098,0.04749,0.04052,0.04684,70005396.8,13326.0,35851333.6,0.042986666666666666,0.040998571428571426,0.039400000000000004,0.043808423527458284,0.04175761774808755,0.04023398536268132,78.45961177207263,0.04375960886707492,0.03504039113292509,0.0004626690059173072,-0.0004167276304545766,0.0008793966363718837,0.006969999999999997,0.0024392857142857133,-215157767.3200006,0.007919999999999996,24.07947019867549,-5.762411347517712,94.23758865248229,81.07970825026418,14.299658369936546,0.04119,0.04178,0.04004,0.04095,51881282.8,8251.0,25355229.7,-0.5826656955571673,56.03375527426161,0.042130549400020645,0.036205450599979344,-0.00012116228432862419,-0.0006365767895475475,0.0005154145052189233,0.0017399999999999985,0.0021321428571428563,-285163164.1200006,0.0020599999999999993,3.6184210526315708,-27.188940092165904,72.81105990783409,82.93262337017676,0.04107666666666667,0.040776847054916576,0.03977857142857143,0.040063490330783394,0.039167999999999994,0.039538615400858304,23707.0,19881985.33333334,51177.0,16334580.842857137
2020-02-07,0.04697,0.04944,0.04558,0.04669,52065289.9,9505.0,25397896.7,0.044826666666666674,0.04211142857142857,0.03968,0.04524921176372915,0.04299071331106566,0.04084884389956882,75.97054886211515,0.04508953154895514,0.03427046845104486,0.0009028482902305873,-0.0001528124463175438,0.001055660736548131,0.0038599999999999954,0.002537142857142856,-267223057.2200006,0.00902,19.93321346005652,-20.78609221466361,79.21390778533639,82.08751878188427,-0.5961251862891113,0.04098,0.04749,0.04052,0.04684,70005396.8,13326.0,35851333.6,14.299658369936546,78.45961177207263,0.04375960886707492,0.03504039113292509,0.0004626690059173072,-0.0004167276304545766,0.0008793966363718837,0.006969999999999997,0.0024392857142857133,-215157767.3200006,0.007919999999999996,24.07947019867549,-5.762411347517712,94.23758865248229,81.07970825026418,0.042986666666666666,0.043808423527458284,0.040998571428571426,0.04175761774808755,0.039400000000000004,0.04023398536268132,29237.0,27134041.26666667,57513.0,18959232.328571424
2020-02-08,0.04663,0.0471,0.043,0.04483,36961901.1,8304.0,17787282.4,0.046119999999999994,0.042998571428571435,0.040036,0.04503960588186458,0.04345053498329925,0.041228001623419414,65.59343434343435,0.045823577986304945,0.03424842201369506,0.001089053162097335,9.5560675365432e-05,0.0009934924867319032,0.004100000000000006,0.0026249999999999993,-304184958.3200006,0.007850000000000003,12.38405615442466,-34.84504913076339,65.1549508692366,79.5354824356851,-3.8601758524554928,0.04697,0.04944,0.04558,0.04669,52065289.9,9505.0,25397896.7,-0.5961251862891113,75.97054886211515,0.04508953154895514,0.03427046845104486,0.0009028482902305873,-0.0001528124463175438,0.001055660736548131,0.0038599999999999954,0.002537142857142856,-267223057.2200006,0.00902,19.93321346005652,-20.78609221466361,79.21390778533639,82.08751878188427,0.044826666666666674,0.04524921176372915,0.04211142857142857,0.04299071331106566,0.03968,0.04084884389956882,31082.0,28868153.33333334,59823.0,20992252.299999993
2020-02-09,0.04483,0.05,0.04451,0.04946,50772634.0,9724.0,25238855.6,0.04699333333333333,0.04443571428571429,0.040642,0.047249802940932284,0.04495290123747443,0.04201200146880804,77.14432460195172,0.047650339693775565,0.03363366030622443,0.001591874037068751,0.0003948233477060958,0.0011970506893626551,0.005490000000000002,0.002872142857142857,-253412324.3200006,0.011159999999999996,27.17922345075854,-3.91588107324152,96.08411892675848,80.15099252711049,10.327905420477348,0.04663,0.0471,0.043,0.04483,36961901.1,8304.0,17787282.4,-3.8601758524554928,65.59343434343435,0.045823577986304945,0.03424842201369506,0.001089053162097335,9.5560675365432e-05,0.0009934924867319032,0.004100000000000006,0.0026249999999999993,-304184958.3200006,0.007850000000000003,12.38405615442466,-34.84504913076339,65.1549508692366,79.5354824356851,0.046119999999999994,0.04503960588186458,0.042998571428571435,0.04345053498329925,0.040036,0.041228001623419414,31135.0,26345504.233333334,62458.0,21874331.28571428
2020-02-10,0.04945,0.04951,0.04474,0.04853,50727997.3,9370.0,23668769.5,0.047606666666666665,0.045495714285714285,0.0411675,0.04788990147046614,0.045847175928105825,0.042632763233683466,73.58861070201276,0.04888797960060445,0.03344702039939555,0.001893492967179472,0.0006945572716007711,0.001198935695578701,0.0047699999999999965,0.003155714285714285,-304140321.6200006,0.00963,24.691675231243558,-10.6598984771574,89.3401015228426,83.52639043961257,-1.860465116279078,0.04483,0.05,0.04451,0.04946,50772634.0,9724.0,25238855.6,10.327905420477348,77.14432460195172,0.047650339693775565,0.03363366030622443,0.001591874037068751,0.0003948233477060958,0.0011970506893626551,0.005490000000000002,0.002872142857142857,-253412324.3200006,0.011159999999999996,27.17922345075854,-3.91588107324152,96.08411892675848,80.15099252711049,0.04699333333333333,0.047249802940932284,0.04443571428571429,0.04495290123747443,0.040642,0.04201200146880804,27533.0,22808011.566666674,64566.0,23417332.042857137
2020-02-11,0.04853,0.05198,0.04676,0.05124,54829189.4,10667.0,27982615.1,0.049743333333333334,0.04693428571428571,0.0417535,0.049564950735233065,0.04719538194607937,0.04345250006857076,81.0810810810811,0.050638740926164036,0.03286825907383596,0.0023244081635091854,0.0010205274499824539,0.0013038807135267315,0.0052199999999999955,0.0033528571428571414,-249311132.2200006,0.01262,36.0233607645341,-4.6924540266328325,95.30754597336717,93.57725547432274,5.58417473727592,0.04945,0.04951,0.04474,0.04853,50727997.3,9370.0,23668769.5,-1.860465116279078,73.58861070201276,0.04888797960060445,0.03344702039939555,0.001893492967179472,0.0006945572716007711,0.001198935695578701,0.0047699999999999965,0.003155714285714285,-304140321.6200006,0.00963,24.691675231243558,-10.6598984771574,89.3401015228426,83.52639043961257,0.047606666666666665,0.04788990147046614,0.045495714285714285,0.045847175928105825,0.0411675,0.042632763233683466,27398.0,22231635.83333334,66140.0,24784989.71428571
2020-02-12,0.05122,0.05518,0.05019,0.05301,55931590.8,11246.0,29729311.6,0.05092666666666667,0.04865714285714286,0.0425165,0.051287475367616533,0.04864903645955953,0.04436273815727831,84.98472282845921,0.05250636913144249,0.032526630868557505,0.002776727383841479,0.001371767436754259,0.0014049599470872202,0.004990000000000001,0.0036342857142857136,-193379541.4200006,0.013610000000000004,43.34775554353705,-11.439114391143903,88.5608856088561,91.06951103502196,3.4947286216321745,0.04853,0.05198,0.04676,0.05124,54829189.4,10667.0,27982615.1,5.58417473727592,81.0810810810811,0.050638740926164036,0.03286825907383596,0.0023244081635091854,0.0010205274499824539,0.0013038807135267315,0.0052199999999999955,0.0033528571428571414,-249311132.2200006,0.01262,36.0233607645341,-4.6924540266328325,95.30754597336717,93.57725547432274,0.049743333333333334,0.049564950735233065,0.04693428571428571,0.04719538194607937,0.0417535,0.04345250006857076,29761.0,25630080.066666674,69147.0,25897426.085714284
2020-02-13,0.05301,0.0558,0.04925,0.05431,51524013.2,9545.0,23601554.8,0.052853333333333335,0.04972428571428572,0.043285500000000005,0.052798737683808265,0.050064277344669644,0.0453100964280137,84.97160332022719,0.054415681773716834,0.032155318226283175,0.0032031686261662987,0.001738047674636667,0.0014651209515296317,0.00655,0.0038957142857142845,-141855528.22000062,0.013199999999999996,41.80156657963445,-8.146528157463123,91.85347184253688,91.90730114158673,2.4523674778343625,0.05122,0.05518,0.05019,0.05301,55931590.8,11246.0,29729311.6,3.4947286216321745,84.98472282845921,0.05250636913144249,0.032526630868557505,0.002776727383841479,0.001371767436754259,0.0014049599470872202,0.004990000000000001,0.0036342857142857136,-193379541.4200006,0.013610000000000004,43.34775554353705,-11.439114391143903,88.5608856088561,91.06951103502196,0.05092666666666667,0.051287475367616533,0.04865714285714286,0.04864903645955953,0.0425165,0.04436273815727831,31283.0,27126898.733333338,72142.0,26522294.928571425
2020-02-14,0.0544,0.05506,0.0505,0.05425,47269405.1,8259.0,22765234.0,0.053856666666666664,0.05080428571428571,0.044003499999999994,0.05352436884190413,0.05111070800850223,0.046161515815821924,84.34004474272933,0.05602816635931406,0.031978833640685926,0.003495985341649667,0.002089635208039267,0.0014063501336103999,0.004559999999999995,0.00411642857142857,-189124933.32000062,0.013080000000000001,39.46015424164526,-8.635097493036227,91.36490250696377,90.59308665278559,-0.2757352941176422,0.05301,0.0558,0.04925,0.05431,51524013.2,9545.0,23601554.8,2.4523674778343625,84.97160332022719,0.054415681773716834,0.032155318226283175,0.0032031686261662987,0.001738047674636667,0.0014651209515296317,0.00655,0.0038957142857142845,-141855528.22000062,0.013199999999999996,41.80156657963445,-8.146528157463123,91.85347184253688,91.90730114158673,0.052853333333333335,0.052798737683808265,0.04972428571428572,0.050064277344669644,0.043285500000000005,0.0453100964280137,31458.0,27104493.83333334,68361.0,24772326.528571427
2020-02-15,0.05426,0.057,0.04832,0.04983,56619732.1,9274.0,28600767.1,0.05279666666666666,0.05151857142857143,0.0445505,0.051677184420952066,0.05079053100637668,0.04651089526193412,71.15892789731976,0.05659105336200729,0.03250994663799271,0.003332967265841487,0.002338301619599711,0.0009946656462417758,0.00868,0.004625714285714284,-245744665.4200006,0.008879999999999999,29.026411185914025,-37.44125326370759,62.55874673629241,81.9257070285977,-8.164393660154817,0.0544,0.05506,0.0505,0.05425,47269405.1,8259.0,22765234.0,-0.2757352941176422,84.34004474272933,0.05602816635931406,0.031978833640685926,0.003495985341649667,0.002089635208039267,0.0014063501336103999,0.004559999999999995,0.00411642857142857,-189124933.32000062,0.013080000000000001,39.46015424164526,-8.635097493036227,91.36490250696377,90.59308665278559,0.053856666666666664,0.05352436884190413,0.05080428571428571,0.05111070800850223,0.044003499999999994,0.046161515815821924,29050.0,25365366.80000001,67115.0,24396231.85714286
2020-02-16,0.04983,0.0524,0.04268,0.0465,58351107.5,9992.0,27162728.9,0.05019333333333333,0.051095714285714286,0.0449295,0.04908859221047603,0.04971789825478251,0.04650985761794039,62.2245179063361,0.05669793320073605,0.03316106679926394,0.0029016229925918693,0.002450965894198143,0.00045065709839372647,0.00972,0.005145714285714286,-304095772.9200006,-0.00034,18.020304568527923,-58.43071786310519,41.569282136894806,65.16431046005033,-6.682721252257676,0.05426,0.057,0.04832,0.04983,56619732.1,9274.0,28600767.1,-8.164393660154817,71.15892789731976,0.05659105336200729,0.03250994663799271,0.003332967265841487,0.002338301619599711,0.0009946656462417758,0.00868,0.004625714285714284,-245744665.4200006,0.008879999999999999,29.026411185914025,-37.44125326370759,62.55874673629241,81.9257070285977,0.05279666666666666,0.051677184420952066,0.05151857142857143,0.05079053100637668,0.0445505,0.04651089526193412,27078.0,24989185.3,68085.0,25941015.385714285
2020-02-17,0.04631,0.04666,0.04157,0.0458,50693844.4,8510.0,24181233.8,0.04737666666666667,0.05070571428571429,0.045336,0.04744429610523802,0.048738423691086885,0.046442252130517496,58.3660363895826,0.05659943576637893,0.034072564233621074,0.0024747678156288727,0.002455726278484289,1.904153714458361e-05,0.005089999999999997,0.005359999999999999,-354789617.3200006,-0.0008900000000000019,11.408416443687663,-63.70875995449373,36.29124004550627,46.80642297289783,-1.1012740228892175,0.04983,0.0524,0.04268,0.0465,58351107.5,9992.0,27162728.9,-6.682721252257676,62.2245179063361,0.05669793320073605,0.03316106679926394,0.0029016229925918693,0.002450965894198143,0.00045065709839372647,0.00972,0.005145714285714286,-304095772.9200006,-0.00034,18.020304568527923,-58.43071786310519,41.569282136894806,65.16431046005033,0.05019333333333333,0.04908859221047603,0.051095714285714286,0.04971789825478251,0.0449295,0.04650985761794039,27525.0,26176243.33333334,68353.0,26215854.42857143
2020-02-18,0.04586,0.04823,0.04445,0.04787,45970733.7,8331.0,23068313.7,0.04672333333333334,0.050224285714285714,0.045880500000000005,0.04765714805261901,0.04852131776831516,0.04657822811808726,61.15179760319575,0.056476204144415086,0.03528479585558492,0.00227726284432591,0.0024200335916526134,-0.00014277074732670352,0.0037799999999999986,0.0053942857142857134,-308818883.6200006,0.003040000000000001,16.273985912071897,-53.832547169811306,46.167452830188694,41.342658337529926,4.382904491931978,0.04631,0.04666,0.04157,0.0458,50693844.4,8510.0,24181233.8,-1.1012740228892175,58.3660363895826,0.05659943576637893,0.034072564233621074,0.0024747678156288727,0.002455726278484289,1.904153714458361e-05,0.005089999999999997,0.005359999999999999,-354789617.3200006,-0.0008900000000000019,11.408416443687663,-63.70875995449373,36.29124004550627,46.80642297289783,0.04737666666666667,0.04744429610523802,0.05070571428571429,0.048738423691086885,0.045336,0.046442252130517496,27776.0,26648243.26666667,67493.0,26289063.61428571
2020-02-19,0.04772,0.04795,0.04104,0.04213,46749739.9,7669.0,23091991.0,0.04526666666666667,0.04867,0.046072,0.0448935740263095,0.04692348832623637,0.0461545873449361,51.659167604049486,0.05621981615086538,0.03592418384913462,0.0016386790309765656,0.002263762679517404,-0.0006250836485408385,0.0069099999999999995,0.005763571428571428,-355568623.5200006,-0.007329999999999996,2.8815628815628935,-90.23058252427184,9.769417475728156,30.74270345047438,-11.714165968147523,0.04586,0.04823,0.04445,0.04787,45970733.7,8331.0,23068313.7,4.382904491931978,61.15179760319575,0.056476204144415086,0.03528479585558492,0.00227726284432591,0.0024200335916526134,-0.00014277074732670352,0.0037799999999999986,0.0053942857142857134,-308818883.6200006,0.003040000000000001,16.273985912071897,-53.832547169811306,46.167452830188694,41.342658337529926,0.04672333333333334,0.04765714805261901,0.050224285714285714,0.04852131776831516,0.045880500000000005,0.04657822811808726,26833.0,24804092.133333337,65157.0,25587020.557142854
2020-02-20,0.04209,0.04265,0.04,0.04101,39410051.5,6812.0,19177707.1,0.043669999999999994,0.04676999999999999,0.046177499999999996,0.042951787013154746,0.04544511624467727,0.04566462664541837,40.53264046768432,0.05605154865504977,0.03630345134495022,0.0010303449432415915,0.0020170791322622417,-0.0009867341890206502,0.0026499999999999996,0.005454999999999999,-394978675.0200006,-0.007519999999999999,-12.4466268146883,-94.05882352941178,5.941176470588217,20.62601559216836,-2.5659301496792692,0.04772,0.04795,0.04104,0.04213,46749739.9,7669.0,23091991.0,-11.714165968147523,51.659167604049486,0.05621981615086538,0.03592418384913462,0.0016386790309765656,0.002263762679517404,-0.0006250836485408385,0.0069099999999999995,0.005763571428571428,-355568623.5200006,-0.007329999999999996,2.8815628815628935,-90.23058252427184,9.769417475728156,30.74270345047438,0.04526666666666667,0.0448935740263095,0.04867,0.04692348832623637,0.046072,0.0461545873449361,24510.0,23447179.500000004,61580.0,24638831.899999995
2020-02-21,0.0411,0.04355,0.04072,0.04205,47709691.5,7082.0,24602418.2,0.041729999999999996,0.04502714285714286,0.046349,0.042500893506577375,0.04459633718350795,0.045320376488711865,42.67676767676767,0.055779545890332044,0.03691845410966796,0.0006249510574863684,0.0017386535173070671,-0.0011137024598206987,0.002829999999999999,0.005381428571428571,-347268983.5200006,-0.009190000000000004,-9.937888198757772,-87.94117647058826,12.058823529411741,9.256472491909376,2.311435523114354,0.04209,0.04265,0.04,0.04101,39410051.5,6812.0,19177707.1,-2.5659301496792692,40.53264046768432,0.05605154865504977,0.03630345134495022,0.0010303449432415915,0.0020170791322622417,-0.0009867341890206502,0.0026499999999999996,0.005454999999999999,-394978675.0200006,-0.007519999999999999,-12.4466268146883,-94.05882352941178,5.941176470588217,20.62601559216836,0.043669999999999994,0.042951787013154746,0.04676999999999999,0.04544511624467727,0.046177499999999996,0.04566462664541837,22812.0,21779337.266666673,58847.0,24006853.65714285
2020-02-22,0.04232,0.04245,0.04078,0.04199,51335063.1,7573.0,26613515.9,0.04168333333333333,0.04390714285714286,0.0464785,0.04224544675328869,0.043944752887630965,0.04500319777550121,45.24765729585006,0.05557238522146818,0.03738461477853182,0.00029542649106861774,0.0014500081120593774,-0.0011545816209907597,0.0016700000000000048,0.005207857142857142,-398604046.6200006,-0.011020000000000002,-6.335043497657821,-88.29411764705884,11.705882352941169,9.901960784313713,-0.7797731568998202,0.0411,0.04355,0.04072,0.04205,47709691.5,7082.0,24602418.2,2.311435523114354,42.67676767676767,0.055779545890332044,0.03691845410966796,0.0006249510574863684,0.0017386535173070671,-0.0011137024598206987,0.002829999999999999,0.005381428571428571,-347268983.5200006,-0.009190000000000004,-9.937888198757772,-87.94117647058826,12.058823529411741,9.256472491909376,0.041729999999999996,0.042500893506577375,0.04502714285714286,0.04459633718350795,0.046349,0.045320376488711865,21563.0,22290705.433333337,57670.0,24269308.542857137
2020-02-23,0.04199,0.0436,0.04196,0.04342,49496539.6,7622.0,25760308.8,0.04248666666666667,0.04346714285714286,0.046594000000000003,0.042832723376644344,0.043813564665723226,0.044852417034977284,38.68065967016492,0.05545652761855546,0.037731472381444545,0.00014795936363511814,0.0011895983623745256,-0.0010416389987394075,0.0016400000000000026,0.004932857142857142,-349107507.0200006,-0.010889999999999997,-12.21188839466235,-79.88235294117646,20.117647058823522,14.62745098039215,3.4055727554179587,0.04232,0.04245,0.04078,0.04199,51335063.1,7573.0,26613515.9,-0.7797731568998202,45.24765729585006,0.05557238522146818,0.03738461477853182,0.00029542649106861774,0.0014500081120593774,-0.0011545816209907597,0.0016700000000000048,0.005207857142857142,-398604046.6200006,-0.011020000000000002,-6.335043497657821,-88.29411764705884,11.705882352941169,9.901960784313713,0.04168333333333333,0.04224544675328869,0.04390714285714286,0.043944752887630965,0.0464785,0.04500319777550121,21467.0,23464547.066666674,55969.0,23985415.51428571
2020-02-24,0.04338,0.04394,0.03975,0.04061,45735723.7,8150.0,23660316.7,0.042006666666666664,0.04272571428571428,0.046565999999999996,0.041721361688322176,0.04301267349929242,0.0444483773173604,36.13445378151261,0.0555038989642377,0.03762810103576229,-0.00019342325032144225,0.0009129940398353322,-0.0011064172901567744,0.004189999999999999,0.00489142857142857,-394843230.72000057,-0.01364,-16.31980218421595,-95.01449275362319,4.98550724637681,12.269678886047172,-6.385431074227759,0.04199,0.0436,0.04196,0.04342,49496539.6,7622.0,25760308.8,3.4055727554179587,38.68065967016492,0.05545652761855546,0.037731472381444545,0.00014795936363511814,0.0011895983623745256,-0.0010416389987394075,0.0016400000000000026,0.004932857142857142,-349107507.0200006,-0.010889999999999997,-12.21188839466235,-79.88235294117646,20.117647058823522,14.62745098039215,0.04248666666666667,0.042832723376644344,0.04346714285714286,0.043813564665723226,0.046594000000000003,0.044852417034977284,22277.0,25658747.633333337,53599.0,23785069.785714287
2020-02-25,0.0406,0.04078,0.03703,0.03761,42624382.7,8218.0,20771810.7,0.04054666666666667,0.041260000000000005,0.046399,0.03966568084416108,0.04166200512446932,0.0437971032871356,26.377816291161167,0.055886624959314415,0.03691137504068559,-0.0006980002470073909,0.0005907951824667876,-0.0012887954294741786,0.0037499999999999964,0.004786428571428571,-437467613.42000055,-0.012220000000000002,-26.600312256049964,-97.09564346519781,2.904356534802189,9.335836946667511,-7.364532019704432,0.04338,0.04394,0.03975,0.04061,45735723.7,8150.0,23660316.7,-6.385431074227759,36.13445378151261,0.0555038989642377,0.03762810103576229,-0.00019342325032144225,0.0009129940398353322,-0.0011064172901567744,0.004189999999999999,0.00489142857142857,-394843230.72000057,-0.01364,-16.31980218421595,-95.01449275362319,4.98550724637681,12.269678886047172,0.042006666666666664,0.041721361688322176,0.04272571428571428,0.04301267349929242,0.046565999999999996,0.0444483773173604,23345.0,25344713.8,53239.0,23710653.057142854
2020-02-26,0.03755,0.03809,0.03064,0.03268,52582920.7,8839.0,25533949.7,0.03696666666666667,0.03991,0.045691,0.03617284042208054,0.03941650384335199,0.04273833154550363,18.244298656669784,0.056982007880058985,0.03439999211994102,-0.0014786460393168138,0.00017690693811006733,-0.0016555529774268812,0.007449999999999998,0.004962142857142857,-490050534.12000054,-0.013819999999999999,-38.351254480286734,-92.26100151745068,7.7389984825493165,5.20962075457611,-12.969374167776296,0.0406,0.04078,0.03703,0.03761,42624382.7,8218.0,20771810.7,-7.364532019704432,26.377816291161167,0.055886624959314415,0.03691137504068559,-0.0006980002470073909,0.0005907951824667876,-0.0012887954294741786,0.0037499999999999964,0.004786428571428571,-437467613.42000055,-0.012220000000000002,-26.600312256049964,-97.09564346519781,2.904356534802189,9.335836946667511,0.04054666666666667,0.03966568084416108,0.041260000000000005,0.04166200512446932,0.046399,0.0437971032871356,23990.0,23397478.733333338,53126.0,23382581.199999996
2020-02-27,0.03254,0.03498,0.03067,0.03278,40552460.4,7529.0,19116670.5,0.03435666666666667,0.038734285714285714,0.0449955,0.03447642021104027,0.037757377882513994,0.041789919017360434,15.060045439792276,0.0576577862739869,0.0323332137260131,-0.0020654352379715774,-0.00027156149710626167,-0.0017938737408653158,0.004309999999999998,0.004802142857142856,-449498073.72000057,-0.013020000000000004,-39.642791382802436,-91.8816388467375,8.118361153262503,6.253905390204674,0.7375537799631137,0.03755,0.03809,0.03064,0.03268,52582920.7,8839.0,25533949.7,-12.969374167776296,18.244298656669784,0.056982007880058985,0.03439999211994102,-0.0014786460393168138,0.00017690693811006733,-0.0016555529774268812,0.007449999999999998,0.004962142857142857,-490050534.12000054,-0.013819999999999999,-38.351254480286734,-92.26100151745068,7.7389984825493165,5.20962075457611,0.03696666666666667,0.03617284042208054,0.03991,0.03941650384335199,0.045691,0.04273833154550363,25207.0,23322025.700000003,54296.0,23731432.442857143
2020-02-28,0.03275,0.03383,0.0307,0.03242,33576867.4,5940.0,13521627.2,0.032626666666666665,0.03735857142857143,0.044375,0.03344821010552013,0.0364230334118855,0.04089754577761182,14.91481838637094,0.05823140266220022,0.030518597337799776,-0.0025303505903310486,-0.000723319315751219,-0.0018070312745798295,0.0031299999999999974,0.0047,-483074941.12000054,-0.015450000000000005,-40.23963133640554,-93.24734446130502,6.752655538694981,7.536671724835604,-1.0076335877862714,0.03254,0.03498,0.03067,0.03278,40552460.4,7529.0,19116670.5,0.7375537799631137,15.060045439792276,0.0576577862739869,0.0323332137260131,-0.0020654352379715774,-0.00027156149710626167,-0.0017938737408653158,0.004309999999999998,0.004802142857142856,-449498073.72000057,-0.013020000000000004,-39.642791382802436,-91.8816388467375,8.118361153262503,6.253905390204674,0.03435666666666667,0.03447642021104027,0.038734285714285714,0.037757377882513994,0.0449955,0.041789919017360434,24586.0,21807476.96666667,55013.0,23722712.928571425
2020-02-29,0.03242,0.03473,0.03186,0.03215,39906722.9,7310.0,12680708.8,0.03245,0.035952857142857134,0.04350949999999999,0.03279910505276007,0.03535477505891413,0.04006444617974403,17.210682492581597,0.058167790953736684,0.0288512090462633,-0.002887303067645952,-0.0011561160661301656,-0.0017311870015157865,0.0028699999999999976,0.004284999999999999,-522981664.0200005,-0.009980000000000003,-35.480634156130854,-93.0606617647059,6.939338235294105,7.270118309083867,-0.8328192473781599,0.03275,0.03383,0.0307,0.03242,33576867.4,5940.0,13521627.2,-1.0076335877862714,14.91481838637094,0.05823140266220022,0.030518597337799776,-0.0025303505903310486,-0.000723319315751219,-0.0018070312745798295,0.0031299999999999974,0.0047,-483074941.12000054,-0.015450000000000005,-40.23963133640554,-93.24734446130502,6.752655538694981,7.536671724835604,0.032626666666666665,0.03344821010552013,0.03735857142857143,0.0364230334118855,0.044375,0.04089754577761182,22308.0,19390749.133333337,53871.0,22139742.78571428
2020-03-01,0.03217,0.03344,0.03171,0.03232,38583440.7,7923.0,12317309.3,0.03229666666666666,0.03436714285714286,0.042699,0.032559552526380035,0.03459608129418559,0.03932687987691127,20.210084033613455,0.05796831825590748,0.02742968174409252,-0.0031205016972499847,-0.0015489931923541294,-0.0015715085048958553,0.0017299999999999954,0.003714285714285713,-484398223.3200005,-0.008689999999999996,-30.494623655913976,-90.44911881750994,9.550881182490055,7.747624985493052,0.4662729250854968,0.03242,0.03473,0.03186,0.03215,39906722.9,7310.0,12680708.8,-0.8328192473781599,17.210682492581597,0.058167790953736684,0.0288512090462633,-0.002887303067645952,-0.0011561160661301656,-0.0017311870015157865,0.0028699999999999976,0.004284999999999999,-522981664.0200005,-0.009980000000000003,-35.480634156130854,-93.0606617647059,6.939338235294105,7.270118309083867,0.03245,0.03279910505276007,0.035952857142857134,0.03535477505891413,0.04350949999999999,0.04006444617974403,20779.0,15106335.500000006,53608.0,20149341.771428566
2020-03-02,0.03234,0.03535,0.03209,0.03483,37538705.1,7793.0,13348703.6,0.0331,0.03354142857142857,0.0418785,0.03369477626319002,0.034654560970639195,0.038898605602919724,28.582584927762596,0.05697803261738086,0.02677896738261914,-0.0030674179831534226,-0.0018526781505139884,-0.0012147398326394342,0.003259999999999999,0.0035835714285714277,-446859518.2200005,-0.007219999999999997,-23.95196506550219,-76.179647527004,23.820352472996014,13.43685729692673,7.699443413729125,0.03217,0.03344,0.03171,0.03232,38583440.7,7923.0,12317309.3,0.4662729250854968,20.210084033613455,0.05796831825590748,0.02742968174409252,-0.0031205016972499847,-0.0015489931923541294,-0.0015715085048958553,0.0017299999999999954,0.003714285714285713,-484398223.3200005,-0.008689999999999996,-30.494623655913976,-90.44911881750994,9.550881182490055,7.747624985493052,0.03229666666666666,0.032559552526380035,0.03436714285714286,0.03459608129418559,0.042699,0.03932687987691127,21173.0,12839881.766666671,53909.0,18228913.271428566
2020-03-03,0.03482,0.03491,0.03337,0.03397,24350175.9,6846.0,8962142.9,0.03370666666666667,0.03302142857142858,0.0409265,0.03383238813159501,0.0344834207279794,0.03842921459311785,21.51639344262294,0.055461310881762885,0.02639168911823711,-0.003059475836973455,-0.0020940376878058817,-0.0009654381491675731,0.0015399999999999997,0.0034235714285714277,-471209694.1200005,-0.00802,-29.03697514100689,-80.76256499133449,19.23743500866551,17.53622288805053,-2.4411257897759815,0.03234,0.03535,0.03209,0.03483,37538705.1,7793.0,13348703.6,7.699443413729125,28.582584927762596,0.05697803261738086,0.02677896738261914,-0.0030674179831534226,-0.0018526781505139884,-0.0012147398326394342,0.003259999999999999,0.0035835714285714277,-446859518.2200005,-0.007219999999999997,-23.95196506550219,-76.179647527004,23.820352472996014,13.43685729692673,0.0331,0.03369477626319002,0.03354142857142857,0.034654560970639195,0.0418785,0.038898605602919724,23026.0,12782240.566666672,53552.0,16755825.68571428
2020-03-04,0.03394,0.03739,0.03381,0.03653,33220903.6,7622.0,14680991.6,0.03511,0.03357142857142857,0.0400375,0.035181194065797505,0.03499506554598455,0.03824833701282091,36.80490103675777,0.053239518785026516,0.026835481214973478,-0.0028141710120521274,-0.002238064352655131,-0.0005761066593969965,0.00358,0.0031857142857142848,-437988790.52000046,-0.00689,-13.292190837882744,-55.714285714285715,44.285714285714285,29.11450058912527,7.631113730111968,0.03482,0.03491,0.03337,0.03397,24350175.9,6846.0,8962142.9,-2.4411257897759815,21.51639344262294,0.055461310881762885,0.02639168911823711,-0.003059475836973455,-0.0020940376878058817,-0.0009654381491675731,0.0015399999999999997,0.0034235714285714277,-471209694.1200005,-0.00802,-29.03697514100689,-80.76256499133449,19.23743500866551,17.53622288805053,0.03370666666666667,0.03383238813159501,0.03302142857142858,0.0344834207279794,0.0409265,0.03842921459311785,22562.0,11542718.600000003,52180.0,15068730.285714282
2020-03-05,0.03652,0.0378,0.03628,0.03638,19574336.4,3760.0,9386245.0,0.03562666666666667,0.03408571428571428,0.039144,0.03578059703289875,0.03534129915948841,0.03807040015445702,38.56790123456791,0.05059925372459864,0.027688746275401355,-0.002601876109198646,-0.002310826703963834,-0.0002910494052348121,0.0015200000000000005,0.0031049999999999993,-457563126.92000043,-0.004229999999999998,-11.2899292855401,-56.84210526315788,43.157894736842124,35.56034801040731,-0.3833515881708497,0.03394,0.03739,0.03381,0.03653,33220903.6,7622.0,14680991.6,7.631113730111968,36.80490103675777,0.053239518785026516,0.026835481214973478,-0.0028141710120521274,-0.002238064352655131,-0.0005761066593969965,0.00358,0.0031857142857142848,-437988790.52000046,-0.00689,-13.292190837882744,-55.714285714285715,44.285714285714285,29.11450058912527,0.03511,0.035181194065797505,0.03357142857142857,0.03499506554598455,0.0400375,0.03824833701282091,22261.0,12330612.700000005,50963.0,13518307.699999997
2020-03-06,0.03652,0.03782,0.036,0.03714,39134472.7,5469.0,18634222.3,0.03668333333333334,0.03476,0.0385095,0.03646029851644937,0.035790974369616306,0.0379817906159373,37.706559839759635,0.04882129289123739,0.028197707108762612,-0.0023452704034393826,-0.002317715443858944,-2.7554959580438493e-05,0.0018200000000000022,0.0030328571428571423,-418428654.22000045,-0.0004699999999999982,-11.676575505350772,-51.12781954887219,48.87218045112781,45.438596491228076,1.6976998904709817,0.03652,0.0378,0.03628,0.03638,19574336.4,3760.0,9386245.0,-0.3833515881708497,38.56790123456791,0.05059925372459864,0.027688746275401355,-0.002601876109198646,-0.002310826703963834,-0.0002910494052348121,0.0015200000000000005,0.0031049999999999993,-457563126.92000043,-0.004229999999999998,-11.2899292855401,-56.84210526315788,43.157894736842124,35.56034801040731,0.03562666666666667,0.03578059703289875,0.03408571428571428,0.03534129915948841,0.039144,0.03807040015445702,18228.0,11009793.166666672,47194.0,12128246.91428571
2020-03-07,0.03714,0.03871,0.03481,0.03539,48979065.7,6173.0,22986815.4,0.03630333333333333,0.035222857142857146,0.037954,0.03592514925822468,0.03569073077721223,0.03773495341441946,34.76454293628808,0.04763081635337976,0.028277183646620244,-0.0022571004584321028,-0.002305592446773576,4.849198834147323e-05,0.0039000000000000007,0.003192142857142856,-467407719.92000043,0.002709999999999997,-15.718028101929038,-64.2857142857143,35.7142857142857,42.581453634085214,-4.711900915455039,0.03652,0.03782,0.036,0.03714,39134472.7,5469.0,18634222.3,1.6976998904709817,37.706559839759635,0.04882129289123739,0.028197707108762612,-0.0023452704034393826,-0.002317715443858944,-2.7554959580438493e-05,0.0018200000000000022,0.0030328571428571423,-418428654.22000045,-0.0004699999999999982,-11.676575505350772,-51.12781954887219,48.87218045112781,45.438596491228076,0.03668333333333334,0.03646029851644937,0.03476,0.035790974369616306,0.0385095,0.0379817906159373,16851.0,14233819.633333338,46723.0,12858617.642857138
2020-03-08,0.03531,0.03531,0.02995,0.02999,52677301.63,8084.0,23616093.1,0.03417333333333333,0.03489,0.0371635,0.03295757462911234,0.03426554808290917,0.03699733880352237,23.800234100663275,0.04672396084554213,0.027603039154457873,-0.00259306872991151,-0.002363087703401163,-0.00022998102651034706,0.00536,0.0034578571428571414,-520085021.5500004,-0.0027899999999999973,-30.930446798710275,-99.71408148677628,0.28591851322371964,28.29079489287908,-15.0665533843104,0.03714,0.03871,0.03481,0.03539,48979065.7,6173.0,22986815.4,-4.711900915455039,34.76454293628808,0.04763081635337976,0.028277183646620244,-0.0022571004584321028,-0.002305592446773576,4.849198834147323e-05,0.0039000000000000007,0.003192142857142856,-467407719.92000043,0.002709999999999997,-15.718028101929038,-64.2857142857143,35.7142857142857,42.581453634085214,0.03630333333333333,0.03592514925822468,0.035222857142857146,0.03569073077721223,0.037954,0.03773495341441946,15402.0,17002427.56666667,45586.0,14330918.58571428
2020-03-09,0.03015,0.03101,0.02666,0.02859,44862919.39,6631.0,23491290.79,0.031323333333333335,0.03399857142857143,0.0361995,0.03077378731455617,0.03284666106218188,0.036196639869853574,25.185796862097433,0.0450782302909338,0.027320769709066203,-0.002938422005516042,-0.002478154563824139,-0.000460267441691903,0.00435,0.0034692857142857134,-564947940.9400004,-0.0038299999999999966,-29.59862102930313,-86.33144475920679,13.668555240793212,16.556253156100883,-5.174129353233827,0.03531,0.03531,0.02995,0.02999,52677301.63,8084.0,23616093.1,-15.0665533843104,23.800234100663275,0.04672396084554213,0.027603039154457873,-0.00259306872991151,-0.002363087703401163,-0.00022998102651034706,0.00536,0.0034578571428571414,-520085021.5500004,-0.0027899999999999973,-30.930446798710275,-99.71408148677628,0.28591851322371964,28.29079489287908,0.03417333333333333,0.03295757462911234,0.03489,0.03426554808290917,0.0371635,0.03699733880352237,19726.0,21745710.26666667,45747.0,15945030.557142852
2020-03-10,0.02862,0.03,0.02751,0.02883,29725489.9,5777.0,14794885.3,0.02913666666666667,0.03326428571428571,0.0355345,0.029801893657278086,0.03184249579663641,0.03549505512034371,29.543336439888165,0.04453444730979833,0.026534552690201663,-0.0031563663438897785,-0.002613796919837267,-0.0005425694240525115,0.002489999999999999,0.0033792857142857136,-535222451.04000044,-0.0033199999999999966,-23.34485509173091,-81.99170124481327,18.008298755186733,10.654257503067894,0.7337526205450798,0.03015,0.03101,0.02666,0.02859,44862919.39,6631.0,23491290.79,-5.174129353233827,25.185796862097433,0.0450782302909338,0.027320769709066203,-0.002938422005516042,-0.002478154563824139,-0.000460267441691903,0.00435,0.0034692857142857134,-564947940.9400004,-0.0038299999999999966,-29.59862102930313,-86.33144475920679,13.668555240793212,16.556253156100883,0.031323333333333335,0.03077378731455617,0.03399857142857143,0.03284666106218188,0.0361995,0.036196639869853574,20888.0,23364733.096666675,44585.0,17393971.58428571
2020-03-11,0.02882,0.03039,0.02625,0.0283,30469911.4,5928.0,11995880.2,0.02857333333333333,0.03208857142857143,0.034899,0.02905094682863904,0.030956871847477307,0.03480981177554907,37.16295427901523,0.04406444058149041,0.025733559418509588,-0.0033334296706055005,-0.002757723469990914,-0.0005757062006145866,0.004140000000000001,0.003142857142857142,-565692362.4400004,-0.004020000000000003,-13.40269277845778,-83.54735152487962,16.45264847512038,16.04316749036678,-1.804302567661345,0.02862,0.03,0.02751,0.02883,29725489.9,5777.0,14794885.3,0.7337526205450798,29.543336439888165,0.04453444730979833,0.026534552690201663,-0.0031563663438897785,-0.002613796919837267,-0.0005425694240525115,0.002489999999999999,0.0033792857142857136,-535222451.04000044,-0.0033199999999999966,-23.34485509173091,-81.99170124481327,18.008298755186733,10.654257503067894,0.02913666666666667,0.029801893657278086,0.03326428571428571,0.03184249579663641,0.0355345,0.03549505512034371,20492.0,20634089.730000004,43516.0,18227220.498571422
2020-03-12,0.02842,0.0285,0.00958,0.01071,158404968.85,19131.0,72184561.2,0.022613333333333333,0.028421428571428573,0.033331999999999994,0.01988047341431952,0.02589515388560798,0.032514591606449164,18.060781476121562,0.04697316309287875,0.019690836907121236,-0.004837357579905787,-0.0031736502919738887,-0.0016637072879318983,0.01892,0.004186428571428571,-724097331.2900004,-0.02412,-67.32763880414888,-96.12083762444215,3.8791623755578466,12.780036535288325,-62.315270935960584,0.02882,0.03039,0.02625,0.0283,30469911.4,5928.0,11995880.2,-1.804302567661345,37.16295427901523,0.04406444058149041,0.025733559418509588,-0.0033334296706055005,-0.002757723469990914,-0.0005757062006145866,0.004140000000000001,0.003142857142857142,-565692362.4400004,-0.004020000000000003,-13.40269277845778,-83.54735152487962,16.45264847512038,16.04316749036678,0.02857333333333333,0.02905094682863904,0.03208857142857143,0.030956871847477307,0.034899,0.03480981177554907,18336.0,16760685.430000005,41822.0,17843633.15571428
2020-03-13,0.01076,0.01403,0.00735,0.01262,87168729.5,8297.0,43212007.6,0.01721,0.02491857142857143,0.0318635,0.01625023670715976,0.022576365414205983,0.030619868596311148,22.57617728531855,0.04772329660718436,0.016003703392815653,-0.005808157422464065,-0.003700551718071924,-0.002107605704392141,0.006680000000000001,0.0044399999999999995,-636928601.7900004,-0.02135,-61.07341147439852,-83.1951530612245,16.80484693877551,12.378885929817917,17.286245353159842,0.02842,0.0285,0.00958,0.01071,158404968.85,19131.0,72184561.2,-62.315270935960584,18.060781476121562,0.04697316309287875,0.019690836907121236,-0.004837357579905787,-0.0031736502919738887,-0.0016637072879318983,0.01892,0.004186428571428571,-724097331.2900004,-0.02412,-67.32763880414888,-96.12083762444215,3.8791623755578466,12.780036535288325,0.022613333333333333,0.01988047341431952,0.028421428571428573,0.02589515388560798,0.033331999999999994,0.032514591606449164,30836.0,32991775.566666674,57193.0,26814821.184285708
2020-03-14,0.01246,0.01308,0.0107,0.01116,31329199.8,2851.0,14668713.0,0.011496666666666667,0.02145714285714286,0.030250499999999996,0.01370511835357988,0.019722274060654486,0.028766547777614847,21.855725395548404,0.04764880176226208,0.012852198237737911,-0.006619032998001588,-0.004284247974057857,-0.0023347850239437314,0.00238,0.004405,-668257801.5900004,-0.02537,-65.28771384136857,-87.85076530612245,12.14923469387755,10.94441466940364,-10.433386837881226,0.01076,0.01403,0.00735,0.01262,87168729.5,8297.0,43212007.6,17.286245353159842,22.57617728531855,0.04772329660718436,0.016003703392815653,-0.005808157422464065,-0.003700551718071924,-0.002107605704392141,0.006680000000000001,0.0044399999999999995,-636928601.7900004,-0.02135,-61.07341147439852,-83.1951530612245,16.80484693877551,12.378885929817917,0.01721,0.01625023670715976,0.02491857142857143,0.022576365414205983,0.0318635,0.030619868596311148,33356.0,42464149.66666668,60021.0,30325933.369999994
2020-03-15,0.0112,0.013,0.01085,0.01147,38636324.1,2837.0,20473680.6,0.011749999999999998,0.01881142857142857,0.0287935,0.012587559176789938,0.017659205545490865,0.0271192575130801,22.148009617953505,0.04737906460210867,0.010207935397891329,-0.00715417445464208,-0.004858233270174701,-0.002295941184467379,0.002149999999999999,0.004435,-629621477.4900004,-0.02491,-64.51113861386139,-86.86224489795919,13.137755102040815,14.030612244897961,2.4107142857142803,0.01246,0.01308,0.0107,0.01116,31329199.8,2851.0,14668713.0,-10.433386837881226,21.855725395548404,0.04764880176226208,0.012852198237737911,-0.006619032998001588,-0.004284247974057857,-0.0023347850239437314,0.00238,0.004405,-668257801.5900004,-0.02537,-65.28771384136857,-87.85076530612245,12.14923469387755,10.94441466940364,0.011496666666666667,0.01370511835357988,0.02145714285714286,0.019722274060654486,0.030250499999999996,0.028766547777614847,30279.0,43355093.93333334,56699.0,29137633.027142853
2020-03-16,0.01147,0.01186,0.00892,0.00987,43222422.0,3555.0,17509098.2,0.010833333333333334,0.016137142857142857,0.0274065,0.01122877958839497,0.015711904159118148,0.02547647108326295,15.826944140197128,0.047314990941785526,0.007498009058214471,-0.007619551100675033,-0.005410496836274768,-0.002209054264400265,0.00294,0.0044121428571428575,-672843899.4900004,-0.02727,-71.66236003445306,-91.96428571428572,8.035714285714288,11.107568027210888,-13.949433304272004,0.0112,0.013,0.01085,0.01147,38636324.1,2837.0,20473680.6,2.4107142857142803,22.148009617953505,0.04737906460210867,0.010207935397891329,-0.00715417445464208,-0.004858233270174701,-0.002295941184467379,0.002149999999999999,0.004435,-629621477.4900004,-0.02491,-64.51113861386139,-86.86224489795919,13.137755102040815,14.030612244897961,0.011749999999999998,0.012587559176789938,0.01881142857142857,0.017659205545490865,0.0287935,0.0271192575130801,13985.0,26118133.733333338,51452.0,28688716.955714285
2020-03-17,0.0099,0.01195,0.00964,0.01088,99596788.5,8865.0,44239671.6,0.01074,0.013572857142857142,0.0263165,0.011054389794197485,0.014503928119338611,0.02408633098009505,18.51649850013635,0.04736384740131852,0.005269152598681482,-0.00781676014129145,-0.005891749497278105,-0.0019250106440133448,0.0023100000000000013,0.004467142857142857,-573247110.9900004,-0.024509999999999997,-67.97173977038562,-88.7436224489796,11.256377551020412,10.809948979591843,9.898989898989898,0.01147,0.01186,0.00892,0.00987,43222422.0,3555.0,17509098.2,-13.949433304272004,15.826944140197128,0.047314990941785526,0.007498009058214471,-0.007619551100675033,-0.005410496836274768,-0.002209054264400265,0.00294,0.0044121428571428575,-672843899.4900004,-0.02727,-71.66236003445306,-91.96428571428572,8.035714285714288,11.107568027210888,0.010833333333333334,0.01122877958839497,0.016137142857142857,0.015711904159118148,0.0274065,0.02547647108326295,9243.0,17550497.26666667,48376.0,27834118.01428571
2020-03-18,0.01088,0.01109,0.00987,0.01092,77820189.3,6726.0,37369281.4,0.010556666666666666,0.01109,0.0252235,0.010987194897098741,0.013607946089503959,0.022832394696276473,12.503660322108331,0.04711119832337216,0.0033358016766278364,-0.007878997878055974,-0.006289199173433679,-0.0015897987046222944,0.0012199999999999989,0.0042985714285714285,-495426921.69000036,-0.01907,-70.10676156583631,-88.61607142857144,11.38392857142857,10.225340136054427,0.3676470588235144,0.0099,0.01195,0.00964,0.01088,99596788.5,8865.0,44239671.6,9.898989898989898,18.51649850013635,0.04736384740131852,0.005269152598681482,-0.00781676014129145,-0.005891749497278105,-0.0019250106440133448,0.0023100000000000013,0.004467142857142857,-573247110.9900004,-0.024509999999999997,-67.97173977038562,-88.7436224489796,11.256377551020412,10.809948979591843,0.01074,0.011054389794197485,0.013572857142857142,0.014503928119338611,0.0263165,0.02408633098009505,15257.0,27407483.466666672,51464.0,32040516.057142854
2020-03-19,0.011,0.01335,0.01096,0.01264,97470532.5,8135.0,48866330.1,0.011479999999999999,0.011365714285714285,0.0242345,0.01181359744854937,0.01336595956712797,0.021861690439488237,16.769316909294503,0.0465366419551954,0.001932358044804603,-0.00770076251081387,-0.006571511840909718,-0.0011292506699041522,0.0023900000000000015,0.004360714285714286,-397956389.19000036,-0.01595,-65.25563496426608,-83.13137755102042,16.868622448979593,13.169642857142861,14.909090909090917,0.01088,0.01109,0.00987,0.01092,77820189.3,6726.0,37369281.4,0.3676470588235144,12.503660322108331,0.04711119832337216,0.0033358016766278364,-0.007878997878055974,-0.006289199173433679,-0.0015897987046222944,0.0012199999999999989,0.0042985714285714285,-495426921.69000036,-0.01907,-70.10676156583631,-88.61607142857144,11.38392857142857,10.225340136054427,0.010556666666666666,0.010987194897098741,0.01109,0.013607946089503959,0.0252235,0.022832394696276473,19146.0,33039350.400000006,52262.0,35665287.657142855
2020-03-20,0.01272,0.01547,0.0115,0.01311,91528380.5,7937.0,41462278.8,0.012223333333333334,0.011435714285714287,0.0232825,0.012461798724274685,0.013301969675345977,0.02102819611191793,16.08806096528366,0.04578655612562938,0.0007784438743706212,-0.007435868561996677,-0.00674438318512711,-0.0006914853768695663,0.00397,0.004514285714285715,-306428008.69000036,-0.01572,-64.70113085621972,-81.63265306122449,18.367346938775512,15.539965986394563,3.0660377358490543,0.011,0.01335,0.01096,0.01264,97470532.5,8135.0,48866330.1,14.909090909090917,16.769316909294503,0.0465366419551954,0.001932358044804603,-0.00770076251081387,-0.006571511840909718,-0.0011292506699041522,0.0023900000000000015,0.004360714285714286,-397956389.19000036,-0.01595,-65.25563496426608,-83.13137755102042,16.868622448979593,13.169642857142861,0.011479999999999999,0.01181359744854937,0.011365714285714285,0.01336595956712797,0.0242345,0.021861690439488237,23726.0,43491761.03333334,41266.0,32334111.78571428
2020-03-21,0.01315,0.01394,0.01216,0.01353,64081286.1,4089.0,43955936.5,0.013093333333333334,0.011774285714285713,0.022343000000000002,0.012995899362137343,0.013358977256509483,0.020314082196497173,17.947214076246325,0.044827316030705416,-0.0001413160307054094,-0.007110087051533102,-0.006817523958408309,-0.0002925630931247926,0.0017799999999999986,0.004362857142857143,-242346722.59000036,-0.014769999999999998,-61.768861260243,-77.8969957081545,22.103004291845494,19.112991226533538,2.8897338403041832,0.01272,0.01547,0.0115,0.01311,91528380.5,7937.0,41462278.8,3.0660377358490543,16.08806096528366,0.04578655612562938,0.0007784438743706212,-0.007435868561996677,-0.00674438318512711,-0.0006914853768695663,0.00397,0.004514285714285715,-306428008.69000036,-0.01572,-64.70113085621972,-81.63265306122449,18.367346938775512,15.539965986394563,0.012223333333333334,0.012461798724274685,0.011435714285714287,0.013301969675345977,0.0232825,0.02102819611191793,22798.0,42565963.43333334,40906.0,32084150.528571427
2020-03-22,0.01344,0.0139,0.0116,0.01187,73169229.5,3836.0,55211185.4,0.012836666666666668,0.011831428571428573,0.021195,0.012432949681068672,0.012986732942382112,0.01950988389206887,20.15810276679842,0.043336823725586684,-0.0009468237255866874,-0.006906240146736478,-0.006835267196073943,-7.097295066253555e-05,0.0023,0.004144285714285714,-315515952.0900004,0.0011599999999999996,-60.42014004668223,-80.89602704987318,19.1039729501268,19.858108060249272,-11.68154761904762,0.01315,0.01394,0.01216,0.01353,64081286.1,4089.0,43955936.5,2.8897338403041832,17.947214076246325,0.044827316030705416,-0.0001413160307054094,-0.007110087051533102,-0.006817523958408309,-0.0002925630931247926,0.0017799999999999986,0.004362857142857143,-242346722.59000036,-0.014769999999999998,-61.768861260243,-77.8969957081545,22.103004291845494,19.112991226533538,0.013093333333333334,0.012995899362137343,0.011774285714285713,0.013358977256509483,0.022343000000000002,0.020314082196497173,20161.0,44761515.13333333,42144.0,36268039.6
2020-03-23,0.01183,0.01354,0.0115,0.01348,69875083.1,2895.0,51213012.9,0.01296,0.012347142857142859,0.0201705,0.012956474840534336,0.013110049706786584,0.01893560923568136,25.28622832842656,0.041711478304524784,-0.0013704783045247818,-0.006539394393442982,-0.006776092635547751,0.000236698242104769,0.00204,0.003979285714285714,-245640868.9900004,0.0008600000000000014,-52.85064707939839,-73.39409722222221,26.60590277777778,22.604293339916694,13.947590870667797,0.01344,0.0139,0.0116,0.01187,73169229.5,3836.0,55211185.4,-11.68154761904762,20.15810276679842,0.043336823725586684,-0.0009468237255866874,-0.006906240146736478,-0.006835267196073943,-7.097295066253555e-05,0.0023,0.004144285714285714,-315515952.0900004,0.0011599999999999996,-60.42014004668223,-80.89602704987318,19.1039729501268,19.858108060249272,0.012836666666666668,0.012432949681068672,0.011831428571428573,0.012986732942382112,0.021195,0.01950988389206887,15862.0,46876466.900000006,43143.0,41230540.285714276
2020-03-24,0.01348,0.0144,0.01298,0.01374,64383859.6,3851.0,42452910.7,0.01303,0.012755714285714287,0.019031,0.013348237420267167,0.013267537280089938,0.01844078930847361,25.335076822491004,0.03930187192059759,-0.0012398719205975947,-0.006156715875695164,-0.006652217283577234,0.0004955014078820699,0.0014199999999999994,0.003902857142857143,-181257009.3900004,0.0025800000000000007,-52.34131113423517,-72.26562499999999,27.734375,24.48141690930153,1.9287833827893162,0.01183,0.01354,0.0115,0.01348,69875083.1,2895.0,51213012.9,13.947590870667797,25.28622832842656,0.041711478304524784,-0.0013704783045247818,-0.006539394393442982,-0.006776092635547751,0.000236698242104769,0.00204,0.003979285714285714,-245640868.9900004,0.0008600000000000014,-52.85064707939839,-73.39409722222221,26.60590277777778,22.604293339916694,0.01296,0.012956474840534336,0.012347142857142859,0.013110049706786584,0.0201705,0.01893560923568136,10820.0,50126711.6,42483.0,46045385.242857136
2020-03-25,0.01368,0.01447,0.01313,0.0143,48952537.8,2868.0,33587250.2,0.01384,0.01323857142857143,0.017927000000000002,0.013824118710133584,0.013525652960067453,0.018046428421952313,27.139124755062042,0.03655822687149354,-0.0007042268714935358,-0.005742062155229551,-0.006470186257907698,0.0007281241026781474,0.001340000000000001,0.0037028571428571427,-132304471.5900004,0.002830000000000001,-49.46996466431095,-67.13947990543736,32.860520094562645,29.066932624113477,4.532163742690065,0.01348,0.0144,0.01298,0.01374,64383859.6,3851.0,42452910.7,1.9287833827893162,25.335076822491004,0.03930187192059759,-0.0012398719205975947,-0.006156715875695164,-0.006652217283577234,0.0004955014078820699,0.0014199999999999994,0.003902857142857143,-181257009.3900004,0.0025800000000000007,-52.34131113423517,-72.26562499999999,27.734375,24.48141690930153,0.01303,0.013348237420267167,0.012755714285714287,0.013267537280089938,0.019031,0.01844078930847361,10582.0,49625703.00000001,37469.0,45790133.68571428
2020-03-26,0.01436,0.0145,0.01362,0.01429,44779379.9,2500.0,28745498.5,0.01411,0.013474285714285715,0.0167845,0.014057059355066792,0.01371673972005059,0.01768867333414733,63.72699386503068,0.033115385785117045,0.00045361421488295667,-0.005352552121756723,-0.006246659430677504,0.0008941073089207812,0.0008800000000000006,0.0024142857142857147,-177083851.4900004,0.00442,33.426704014939304,-14.532019704433486,85.46798029556652,48.68762513004307,-0.487465181058488,0.01368,0.01447,0.01313,0.0143,48952537.8,2868.0,33587250.2,4.532163742690065,27.139124755062042,0.03655822687149354,-0.0007042268714935358,-0.005742062155229551,-0.006470186257907698,0.0007281241026781474,0.001340000000000001,0.0037028571428571427,-132304471.5900004,0.002830000000000001,-49.46996466431095,-67.13947990543736,32.860520094562645,29.066932624113477,0.01384,0.013824118710133584,0.01323857142857143,0.013525652960067453,0.017927000000000002,0.018046428421952313,9614.0,42417724.6,33611.0,45249843.514285706
2020-03-27,0.01433,0.01571,0.01379,0.01405,68150639.2,5294.0,37093902.9,0.014213333333333333,0.01360857142857143,0.015717500000000002,0.014053529677533396,0.013800054790037942,0.01734213301660949,56.28847845206685,0.029523355165194543,0.0019116448348054614,-0.005005527997277938,-0.005998433143997592,0.0009929051467196534,0.001919999999999998,0.002074285714285714,-245234490.6900004,0.003169999999999999,11.331220285261502,-24.44771723122237,75.55228276877763,64.6269277196356,-1.953942777390096,0.01436,0.0145,0.01362,0.01429,44779379.9,2500.0,28745498.5,-0.487465181058488,63.72699386503068,0.033115385785117045,0.00045361421488295667,-0.005352552121756723,-0.006246659430677504,0.0008941073089207812,0.0008800000000000006,0.0024142857142857147,-177083851.4900004,0.00442,33.426704014939304,-14.532019704433486,85.46798029556652,48.68762513004307,0.01411,0.014057059355066792,0.013474285714285715,0.01371673972005059,0.0167845,0.01768867333414733,9219.0,34928553.13333335,27976.0,42375439.0
2020-03-28,0.014,0.014,0.01282,0.01354,55656203.2,3343.0,36115799.0,0.01396,0.013609999999999999,0.014895,0.013796764838766698,0.013735041092528457,0.01698002511026573,61.420345489443385,0.02697251194315562,0.00281748805684438,-0.0047172837060506494,-0.005742203256408204,0.0010249195503575547,0.0011800000000000005,0.0019885714285714285,-300890693.8900004,0.002620000000000001,21.326164874551967,-31.958762886597924,68.04123711340208,76.35383339258208,-3.2857142857142883,0.01433,0.01571,0.01379,0.01405,68150639.2,5294.0,37093902.9,-1.953942777390096,56.28847845206685,0.029523355165194543,0.0019116448348054614,-0.005005527997277938,-0.005998433143997592,0.0009929051467196534,0.001919999999999998,0.002074285714285714,-245234490.6900004,0.003169999999999999,11.331220285261502,-24.44771723122237,75.55228276877763,64.6269277196356,0.014213333333333333,0.014053529677533396,0.01360857142857143,0.013800054790037942,0.015717500000000002,0.01734213301660949,10662.0,33142217.200000007,25333.0,41751385.3
2020-03-29,0.01357,0.01374,0.0125,0.0125,54464918.3,2648.0,37921720.0,0.013363333333333333,0.0137,0.0140905,0.01314838241938335,0.013426280819396341,0.016553356052145186,54.6188340807175,0.02433080730419923,0.0038501926958007717,-0.0045206560282395215,-0.005497893810774469,0.0009772377825349472,0.0012399999999999998,0.0019235714285714286,-355355612.1900004,-0.0001399999999999995,8.979947689625112,-47.27540500736375,52.72459499263624,65.43937162493866,-7.885040530582164,0.014,0.014,0.01282,0.01354,55656203.2,3343.0,36115799.0,-3.2857142857142883,61.420345489443385,0.02697251194315562,0.00281748805684438,-0.0047172837060506494,-0.005742203256408204,0.0010249195503575547,0.0011800000000000005,0.0019885714285714285,-300890693.8900004,0.002620000000000001,21.326164874551967,-31.958762886597924,68.04123711340208,76.35383339258208,0.01396,0.013796764838766698,0.013609999999999999,0.013735041092528457,0.014895,0.01698002511026573,11137.0,33985066.800000004,24587.0,40631365.657142855
2020-03-30,0.0125,0.0143,0.01239,0.01381,46390496.9,2694.0,33015226.5,0.013283333333333334,0.013747142857142857,0.013339499999999999,0.013479191209691675,0.013522210614547257,0.016292084047178978,68.13996316758748,0.020873972286219216,0.005805027713780783,-0.004210584132196733,-0.005240431875058921,0.0010298477428621888,0.0019100000000000002,0.0018499999999999999,-308965115.29000044,0.0006999999999999992,39.918946301925004,-31.301482701812176,68.69851729818782,63.15478313474205,10.47999999999999,0.01357,0.01374,0.0125,0.0125,54464918.3,2648.0,37921720.0,-7.885040530582164,54.6188340807175,0.02433080730419923,0.0038501926958007717,-0.0045206560282395215,-0.005497893810774469,0.0009772377825349472,0.0012399999999999998,0.0019235714285714286,-355355612.1900004,-0.0001399999999999995,8.979947689625112,-47.27540500736375,52.72459499263624,65.43937162493866,0.013363333333333333,0.01314838241938335,0.0137,0.013426280819396341,0.0140905,0.016553356052145186,11285.0,37043807.300000004,23399.0,38161442.02857143
2020-03-31,0.01378,0.0142,0.0137,0.01404,43466171.3,1809.0,34457278.6,0.013449999999999998,0.013789999999999998,0.012626499999999999,0.013759595604845838,0.013651657960910443,0.01607759985220955,65.67460317460316,0.015385449266090073,0.009867550733909925,-0.003901318867408826,-0.004972609273528903,0.0010712904061200767,0.0005000000000000004,0.0017207142857142855,-265498943.99000043,0.00051,29.04411764705881,-28.59589041095888,71.40410958904113,64.27574062662173,1.8867924528301872,0.0125,0.0143,0.01239,0.01381,46390496.9,2694.0,33015226.5,10.47999999999999,68.13996316758748,0.020873972286219216,0.005805027713780783,-0.004210584132196733,-0.005240431875058921,0.0010298477428621888,0.0019100000000000002,0.0018499999999999999,-308965115.29000044,0.0006999999999999992,39.918946301925004,-31.301482701812176,68.69851729818782,63.15478313474205,0.013283333333333334,0.013479191209691675,0.013747142857142857,0.013522210614547257,0.013339499999999999,0.016292084047178978,8685.0,35684248.50000001,23198.0,35561758.25714286
2020-04-01,0.01403,0.01433,0.01341,0.01411,30264308.8,2085.0,23852648.4,0.013986666666666666,0.013762857142857144,0.012796499999999999,0.013934797802422919,0.01376624347068283,0.015890209390094355,65.77645895153313,0.015476085788928423,0.010116914211071575,-0.003608973501920765,-0.004699882119207276,0.0010909086172865108,0.0009200000000000007,0.0016992857142857142,-235234635.1900004,0.002239999999999999,29.21245421245422,-33.68421052631578,66.31578947368423,68.80613878697106,0.5702066999287133,0.01378,0.0142,0.0137,0.01404,43466171.3,1809.0,34457278.6,1.8867924528301872,65.67460317460316,0.015385449266090073,0.009867550733909925,-0.003901318867408826,-0.004972609273528903,0.0010712904061200767,0.0005000000000000004,0.0017207142857142855,-265498943.99000043,0.00051,29.04411764705881,-28.59589041095888,71.40410958904113,64.27574062662173,0.013449999999999998,0.013759595604845838,0.013789999999999998,0.013651657960910443,0.012626499999999999,0.01607759985220955,7151.0,35131408.366666675,21156.0,34419525.099999994
2020-04-02,0.01414,0.01516,0.01393,0.01446,40369521.5,2717.0,25484663.4,0.014203333333333332,0.013787142857142859,0.0128885,0.01419739890121146,0.013939682603012123,0.015753998971990132,60.411899313501145,0.015667089380890144,0.010109910619109857,-0.003310879856573471,-0.004422081666680515,0.001111201810107044,0.0012300000000000002,0.0016164285714285714,-194865113.6900004,0.00098,14.3987341772152,-29.691211401425132,70.30878859857486,69.34289588710008,2.2630834512022693,0.01403,0.01433,0.01341,0.01411,30264308.8,2085.0,23852648.4,0.5702066999287133,65.77645895153313,0.015476085788928423,0.010116914211071575,-0.003608973501920765,-0.004699882119207276,0.0010909086172865108,0.0009200000000000007,0.0016992857142857142,-235234635.1900004,0.002239999999999999,29.21245421245422,-33.68421052631578,66.31578947368423,68.80613878697106,0.013986666666666666,0.013934797802422919,0.013762857142857144,0.01376624347068283,0.012796499999999999,0.015890209390094355,6588.0,30441717.833333343,20373.0,33028867.699999996
2020-04-03,0.01446,0.0149,0.01422,0.01447,40123082.5,2457.0,28805176.8,0.014346666666666667,0.013847142857142858,0.013054,0.01433369945060573,0.014072261952259094,0.01563171335561012,58.21256038647343,0.015793123178993694,0.010314876821006303,-0.003038802158861792,-0.004145425765116771,0.0011066236062549787,0.00068,0.0013814285714285714,-154742031.1900004,0.0007299999999999997,10.373760488176975,-29.453681710213743,70.54631828978626,69.05696545401513,0.06915629322268044,0.01414,0.01516,0.01393,0.01446,40369521.5,2717.0,25484663.4,2.2630834512022693,60.411899313501145,0.015667089380890144,0.010109910619109857,-0.003310879856573471,-0.004422081666680515,0.001111201810107044,0.0012300000000000002,0.0016164285714285714,-194865113.6900004,0.00098,14.3987341772152,-29.691211401425132,70.30878859857486,69.34289588710008,0.014203333333333332,0.01419739890121146,0.013787142857142859,0.013939682603012123,0.0128885,0.015753998971990132,6611.0,27931530.13333334,20590.0,32563034.114285707
2020-04-04,0.01448,0.01501,0.01434,0.01478,32930655.4,1958.0,25134371.8,0.01457,0.014024285714285715,0.0132195,0.014556849725302865,0.01424919646419432,0.015550597797932966,57.649938800489586,0.015955632306783908,0.01048336769321609,-0.002766276302718893,-0.0038695958726371956,0.0011033195699183024,0.0006700000000000005,0.0013021428571428574,-121811375.79000041,0.0004799999999999995,9.238728750923864,-22.090261282660308,77.90973871733969,72.92161520190028,2.071823204419889,0.01446,0.0149,0.01422,0.01447,40123082.5,2457.0,28805176.8,0.06915629322268044,58.21256038647343,0.015793123178993694,0.010314876821006303,-0.003038802158861792,-0.004145425765116771,0.0011066236062549787,0.00068,0.0013814285714285714,-154742031.1900004,0.0007299999999999997,10.373760488176975,-29.453681710213743,70.54631828978626,69.05696545401513,0.014346666666666667,0.01433369945060573,0.013847142857142858,0.014072261952259094,0.013054,0.01563171335561012,7259.0,26047496.200000007,17753.0,31378930.38571428
2020-04-05,0.01483,0.015,0.0143,0.01437,25997143.9,1304.0,14169627.4,0.014539999999999999,0.014291428571428571,0.013444500000000002,0.014463424862651432,0.01427939734814574,0.01543815991241554,68.0635838150289,0.015722656919001585,0.01116634308099842,-0.0025539409304961777,-0.0036064648842089922,0.0010525239537128145,0.0006999999999999992,0.001187857142857143,-147808519.6900004,8.000000000000021e-05,21.061499578770015,-31.828978622327742,68.17102137767226,72.20902612826607,-3.101820633850294,0.01448,0.01501,0.01434,0.01478,32930655.4,1958.0,25134371.8,2.071823204419889,57.649938800489586,0.015955632306783908,0.01048336769321609,-0.002766276302718893,-0.0038695958726371956,0.0011033195699183024,0.0006700000000000005,0.0013021428571428574,-121811375.79000041,0.0004799999999999995,9.238728750923864,-22.090261282660308,77.90973871733969,72.92161520190028,0.01457,0.014556849725302865,0.014024285714285715,0.01424919646419432,0.0132195,0.015550597797932966,7132.0,26474737.333333343,16368.0,29810155.071428567
2020-04-06,0.01431,0.01582,0.01431,0.01573,36436554.1,2434.0,20686466.9,0.014960000000000001,0.014565714285714284,0.013687,0.015096712431325716,0.014642048011109306,0.015465954206471203,66.86656671664169,0.01584512881919177,0.01152887118080823,-0.00224998653994566,-0.0033351692153563263,0.0010851826754106663,0.001510000000000001,0.0011500000000000002,-111371965.59000042,0.001680000000000001,16.691394658753712,-2.623906705539352,97.37609329446066,81.15228446315753,9.923130677847666,0.01483,0.015,0.0143,0.01437,25997143.9,1304.0,14169627.4,-3.101820633850294,68.0635838150289,0.015722656919001585,0.01116634308099842,-0.0025539409304961777,-0.0036064648842089922,0.0010525239537128145,0.0006999999999999992,0.001187857142857143,-147808519.6900004,8.000000000000021e-05,21.061499578770015,-31.828978622327742,68.17102137767226,72.20902612826607,0.014539999999999999,0.014463424862651432,0.014291428571428571,0.01427939734814574,0.013444500000000002,0.01543815991241554,5719.0,22703058.666666675,15024.0,26416998.985714283
2020-04-07,0.01566,0.01643,0.01507,0.01564,36604601.8,2792.0,20821021.7,0.015246666666666667,0.014794285714285716,0.013923000000000001,0.015368356215662859,0.01489153600833198,0.015482529996331089,64.61538461538463,0.015824092206909793,0.012021907793090212,-0.0019933842505975834,-0.0030668122224045778,0.0010734279718069943,0.00136,0.001145714285714286,-147976567.3900004,0.002100000000000001,13.82823871906842,-19.55445544554453,80.44554455445547,81.99755307552947,-0.1277139208173639,0.01431,0.01582,0.01431,0.01573,36436554.1,2434.0,20686466.9,9.923130677847666,66.86656671664169,0.01584512881919177,0.01152887118080823,-0.00224998653994566,-0.0033351692153563263,0.0010851826754106663,0.001510000000000001,0.0011500000000000002,-111371965.59000042,0.001680000000000001,16.691394658753712,-2.623906705539352,97.37609329446066,81.15228446315753,0.014960000000000001,0.015096712431325716,0.014565714285714284,0.014642048011109306,0.013687,0.015465954206471203,5696.0,19996822.033333343,14764.0,24655747.614285707
2020-04-08,0.01564,0.01617,0.01531,0.01609,37064870.4,1951.0,27565367.5,0.01582,0.015077142857142857,0.0140955,0.015729178107831428,0.015191152006248985,0.015540384282394794,64.00625978090767,0.016127967776714665,0.012063032223285336,-0.0017337285053750442,-0.0028001954789986716,0.0010664669736236273,0.0008599999999999997,0.0011114285714285716,-110911696.9900004,0.0035899999999999994,12.517482517482525,-8.415841584158416,91.58415841584159,89.80193208825257,2.8772378516623975,0.01566,0.01643,0.01507,0.01564,36604601.8,2792.0,20821021.7,-0.1277139208173639,64.61538461538463,0.015824092206909793,0.012021907793090212,-0.0019933842505975834,-0.0030668122224045778,0.0010734279718069943,0.00136,0.001145714285714286,-147976567.3900004,0.002100000000000001,13.82823871906842,-19.55445544554453,80.44554455445547,81.99755307552947,0.015246666666666667,0.015368356215662859,0.014794285714285716,0.01489153600833198,0.013923000000000001,0.015482529996331089,6530.0,18559038.66666667,15747.0,22707710.914285712
2020-04-09,0.01606,0.01749,0.01566,0.0167,54838321.6,4256.0,34655889.6,0.016143333333333332,0.015397142857142856,0.014275000000000001,0.016214589053915714,0.015568364004686738,0.01565082387454767,67.23891273247497,0.016559487734865663,0.011990512265134338,-0.0014618759584870133,-0.0025325315748963404,0.001070655616409327,0.0018299999999999983,0.0011792857142857143,-56073375.390000395,0.00289,16.86494051784464,-15.490196078431358,84.50980392156863,85.51316896395524,3.985056039850549,0.01564,0.01617,0.01531,0.01609,37064870.4,1951.0,27565367.5,2.8772378516623975,64.00625978090767,0.016127967776714665,0.012063032223285336,-0.0017337285053750442,-0.0028001954789986716,0.0010664669736236273,0.0008599999999999997,0.0011114285714285716,-110911696.9900004,0.0035899999999999994,12.517482517482525,-8.415841584158416,91.58415841584159,89.80193208825257,0.01582,0.015729178107831428,0.015077142857142857,0.015191152006248985,0.0140955,0.015540384282394794,7177.0,23024285.366666675,15613.0,23238099.357142854
2020-04-10,0.01676,0.01676,0.01429,0.01487,43210748.6,3046.0,21653115.9,0.015886666666666664,0.015454285714285714,0.014341999999999999,0.015542294526957857,0.015393773003515054,0.015576459696019321,54.778554778554785,0.016613049838432942,0.012070950161567055,-0.0013782094222244603,-0.0023016671443619645,0.0009234577221375042,0.00247,0.0012185714285714287,-99284123.9900004,0.0008299999999999991,5.836298932384332,-51.37254901960784,48.62745098039216,74.90713777260079,-11.27684964200478,0.01606,0.01749,0.01566,0.0167,54838321.6,4256.0,34655889.6,3.985056039850549,67.23891273247497,0.016559487734865663,0.011990512265134338,-0.0014618759584870133,-0.0025325315748963404,0.001070655616409327,0.0018299999999999983,0.0011792857142857143,-56073375.390000395,0.00289,16.86494051784464,-15.490196078431358,84.50980392156863,85.51316896395524,0.016143333333333332,0.016214589053915714,0.015397142857142856,0.015568364004686738,0.014275000000000001,0.01565082387454767,8999.0,27680759.600000005,17152.0,24548274.528571423
2020-04-11,0.01487,0.01548,0.01446,0.01492,35032408.9,1410.0,16352130.2,0.015496666666666666,0.015474285714285715,0.014494499999999999,0.015231147263478928,0.01527532975263629,0.015513939724969861,58.49753694581281,0.016455009869292547,0.012533990130707452,-0.0012929640229050864,-0.0020999265200705892,0.0008069624971655028,0.00102,0.0012071428571428574,-64251715.0900004,0.00081,10.192023633677994,-50.3921568627451,49.6078431372549,60.91503267973857,0.33624747814391187,0.01676,0.01676,0.01429,0.01487,43210748.6,3046.0,21653115.9,-11.27684964200478,54.778554778554785,0.016613049838432942,0.012070950161567055,-0.0013782094222244603,-0.0023016671443619645,0.0009234577221375042,0.00247,0.0012185714285714287,-99284123.9900004,0.0008299999999999991,5.836298932384332,-51.37254901960784,48.62745098039216,74.90713777260079,0.015886666666666664,0.015542294526957857,0.015454285714285714,0.015393773003515054,0.014341999999999999,0.015576459696019321,9253.0,27958124.33333334,17741.0,23526551.54285714
2020-04-12,0.01492,0.01559,0.01475,0.01505,30070160.5,1517.0,17384109.6,0.014946666666666664,0.015571428571428571,0.014573,0.015140573631739464,0.015218997314477218,0.015469754989258446,67.68377253814147,0.01648766473641119,0.012658335263588807,-0.001201071313775606,-0.0019201554788115926,0.0007190841650359867,0.0008400000000000005,0.0011785714285714286,-34181554.5900004,0.0005899999999999985,20.399999999999995,-47.84313725490196,52.15686274509803,50.13071895424837,0.8713136729222514,0.01487,0.01548,0.01446,0.01492,35032408.9,1410.0,16352130.2,0.33624747814391187,58.49753694581281,0.016455009869292547,0.012533990130707452,-0.0012929640229050864,-0.0020999265200705892,0.0008069624971655028,0.00102,0.0012071428571428574,-64251715.0900004,0.00081,10.192023633677994,-50.3921568627451,49.6078431372549,60.91503267973857,0.015496666666666666,0.015231147263478928,0.015474285714285715,0.01527532975263629,0.014494499999999999,0.015513939724969861,8712.0,24220378.566666674,17193.0,22271945.599999994
2020-04-13,0.01504,0.01516,0.0143,0.01491,26898494.5,1573.0,15197074.9,0.014959999999999996,0.015454285714285714,0.0146315,0.015025286815869732,0.015141747985857913,0.01541644499028145,59.105960264900666,0.016510158816175336,0.012752841183824666,-0.0011265562702835567,-0.0017614356371059856,0.0006348793668224289,0.0008599999999999997,0.0011035714285714288,-61080049.0900004,0.0004399999999999994,7.9652425778421465,-63.23529411764706,36.76470588235294,46.176470588235304,-0.864361702127659,0.01492,0.01559,0.01475,0.01505,30070160.5,1517.0,17384109.6,0.8713136729222514,67.68377253814147,0.01648766473641119,0.012658335263588807,-0.001201071313775606,-0.0019201554788115926,0.0007190841650359867,0.0008400000000000005,0.0011785714285714286,-34181554.5900004,0.0005899999999999985,20.399999999999995,-47.84313725490196,52.15686274509803,50.13071895424837,0.014946666666666664,0.015140573631739464,0.015571428571428571,0.015218997314477218,0.014573,0.015469754989258446,5973.0,18463118.566666674,17406.0,22731157.342857134
2020-04-14,0.01493,0.01534,0.0147,0.015,33895856.9,1413.0,26331366.4,0.014986666666666667,0.015362857142857142,0.014666499999999999,0.015012643407934866,0.015106310989393435,0.015376783562635598,58.13559322033898,0.01654523725795689,0.01278776274204311,-0.0010481578029290037,-0.0016187800702705893,0.0005706222673415855,0.0006399999999999999,0.0011135714285714286,-27184192.1900004,0.0002199999999999997,6.8376068376068355,-61.029411764705884,38.970588235294116,42.630718954248366,0.4688546550569248,0.01504,0.01516,0.0143,0.01491,26898494.5,1573.0,15197074.9,-0.864361702127659,59.105960264900666,0.016510158816175336,0.012752841183824666,-0.0011265562702835567,-0.0017614356371059856,0.0006348793668224289,0.0008599999999999997,0.0011035714285714288,-61080049.0900004,0.0004399999999999994,7.9652425778421465,-63.23529411764706,36.76470588235294,46.176470588235304,0.014959999999999996,0.015025286815869732,0.015454285714285714,0.015141747985857913,0.0146315,0.01541644499028145,4500.0,16311104.900000008,16545.0,21946958.485714283
2020-04-15,0.01507,0.01518,0.01407,0.01411,26652872.8,1461.0,16582337.2,0.014673333333333332,0.01508,0.0146575,0.014561321703967432,0.014857233242045076,0.015256137509051254,50.0,0.01654553295026265,0.01276946704973735,-0.0010457868350252468,-0.0015041814232215208,0.000458394588196274,0.0011100000000000016,0.0011271428571428574,-53837064.9900004,-0.00026000000000000155,0.0,-94.9438202247191,5.056179775280889,26.930491297642657,-6.370272063702726,0.01493,0.01534,0.0147,0.015,33895856.9,1413.0,26331366.4,0.4688546550569248,58.13559322033898,0.01654523725795689,0.01278776274204311,-0.0010481578029290037,-0.0016187800702705893,0.0005706222673415855,0.0006399999999999999,0.0011135714285714286,-27184192.1900004,0.0002199999999999997,6.8376068376068355,-61.029411764705884,38.970588235294116,42.630718954248366,0.014986666666666667,0.015012643407934866,0.015362857142857142,0.015106310989393435,0.014666499999999999,0.015376783562635598,4503.0,19637516.966666672,15166.0,22734150.58571428
2020-04-16,0.01407,0.0152,0.01352,0.01491,30590456.0,1853.0,20118329.8,0.014673333333333332,0.014824285714285712,0.0147005,0.014735660851983716,0.014870424931533807,0.015223172031998753,53.138075313807526,0.016569352448404906,0.012831647551595094,-0.0009681937765818431,-0.0013969838938935853,0.0004287901173117422,0.0016799999999999992,0.001159285714285714,-23246608.990000397,-0.0008200000000000013,3.112033195020736,-64.98740554156173,35.01259445843828,26.346454156337767,5.970149253731346,0.01507,0.01518,0.01407,0.01411,26652872.8,1461.0,16582337.2,-6.370272063702726,50.0,0.01654553295026265,0.01276946704973735,-0.0010457868350252468,-0.0015041814232215208,0.000458394588196274,0.0011100000000000016,0.0011271428571428574,-53837064.9900004,-0.00026000000000000155,0.0,-94.9438202247191,5.056179775280889,26.930491297642657,0.014673333333333332,0.014561321703967432,0.01508,0.014857233242045076,0.0146575,0.015256137509051254,4447.0,19370259.500000007,14676.0,21165146.257142853
2020-04-17,0.01491,0.01523,0.01469,0.01502,35452698.5,1229.0,20773198.5,0.014679999999999999,0.014845714285714285,0.014774500000000001,0.014877830425991858,0.014907818698650354,0.015203822314665539,53.78266850068776,0.016565453583169264,0.01298354641683074,-0.0008875930182392147,-0.0012951057187627112,0.0004075127005234965,0.0005400000000000005,0.0011492857142857142,12206089.509999603,-0.0006200000000000008,3.8009675190048275,-62.216624685138534,37.78337531486147,25.950716516193552,0.7377598926894751,0.01407,0.0152,0.01352,0.01491,30590456.0,1853.0,20118329.8,5.970149253731346,53.138075313807526,0.016569352448404906,0.012831647551595094,-0.0009681937765818431,-0.0013969838938935853,0.0004287901173117422,0.0016799999999999992,0.001159285714285714,-23246608.990000397,-0.0008200000000000013,3.112033195020736,-64.98740554156173,35.01259445843828,26.346454156337767,0.014673333333333332,0.014735660851983716,0.014824285714285712,0.014870424931533807,0.0147005,0.015223172031998753,4727.0,21010677.80000001,12273.0,19088351.999999996
2020-04-18,0.01501,0.01558,0.01501,0.01544,33356911.3,1308.0,20438109.9,0.015123333333333334,0.01492,0.0149215,0.015158915212995928,0.015040864023987766,0.015226315427554536,54.47154471544716,0.01637774282251253,0.013465257177487469,-0.0007808249822928316,-0.0011922495714687354,0.0004114245891759039,0.0005699999999999993,0.001142142857142857,45563000.8099996,-0.0006499999999999995,4.465493910690133,-51.6372795969773,48.36272040302269,40.38623005877415,2.8647568287808114,0.01491,0.01523,0.01469,0.01502,35452698.5,1229.0,20773198.5,0.7377598926894751,53.78266850068776,0.016565453583169264,0.01298354641683074,-0.0008875930182392147,-0.0012951057187627112,0.0004075127005234965,0.0005400000000000005,0.0011492857142857142,12206089.509999603,-0.0006200000000000008,3.8009675190048275,-62.216624685138534,37.78337531486147,25.950716516193552,0.014679999999999999,0.014877830425991858,0.014845714285714285,0.014907818698650354,0.014774500000000001,0.015203822314665539,4543.0,19157955.166666675,10456.0,18962649.51428571
2020-04-19,0.01544,0.01599,0.01499,0.01555,35701374.3,1897.0,22619188.1,0.015336666666666665,0.014991428571428572,0.0150085,0.015354457606497965,0.015168148017990825,0.0152571425296922,58.33333333333332,0.016391194166516642,0.013625805833483356,-0.0006795015925081423,-0.001089699975676617,0.00041019838316847467,0.0010000000000000009,0.0011635714285714285,81264375.1099996,-0.00115,8.211551844119679,-48.86649874055416,51.13350125944584,45.759865659110005,0.7124352331606152,0.01501,0.01558,0.01501,0.01544,33356911.3,1308.0,20438109.9,2.8647568287808114,54.47154471544716,0.01637774282251253,0.013465257177487469,-0.0007808249822928316,-0.0011922495714687354,0.0004114245891759039,0.0005699999999999993,0.001142142857142857,45563000.8099996,-0.0006499999999999995,4.465493910690133,-51.6372795969773,48.36272040302269,40.38623005877415,0.015123333333333334,0.015158915212995928,0.01492,0.015040864023987766,0.0149215,0.015226315427554536,4390.0,20443212.733333338,10354.0,19546360.9
2020-04-20,0.01554,0.0157,0.01419,0.01438,35474005.9,2043.0,20743034.4,0.01512333333333333,0.014915714285714284,0.0150255,0.014867228803248983,0.014971111013493119,0.01517360514591199,40.203193033381694,0.01636576666640132,0.013685233333598681,-0.0006857068957536634,-0.0010089013596920264,0.00032319446393836294,0.0015099999999999992,0.0011635714285714285,45790369.2099996,-0.0004899999999999991,-8.582326764144954,-78.33753148614609,21.66246851385391,40.38623005877415,-7.464607464607462,0.01544,0.01599,0.01499,0.01555,35701374.3,1897.0,22619188.1,0.7124352331606152,58.33333333333332,0.016391194166516642,0.013625805833483356,-0.0006795015925081423,-0.001089699975676617,0.00041019838316847467,0.0010000000000000009,0.0011635714285714285,81264375.1099996,-0.00115,8.211551844119679,-48.86649874055416,51.13350125944584,45.759865659110005,0.015336666666666665,0.015354457606497965,0.014991428571428572,0.015168148017990825,0.0150085,0.0152571425296922,4434.0,21276832.166666675,10734.0,20294229.25714285
2020-04-21,0.01438,0.01468,0.01413,0.01441,31829699.2,1208.0,15921343.4,0.014779999999999996,0.01483142857142857,0.015040500000000002,0.014638614401624492,0.014830833260119839,0.015100880846301325,40.995607613469964,0.016343831359172844,0.01373716864082716,-0.000680361114584159,-0.000943193310670453,0.00026283219608629396,0.0005500000000000001,0.0011057142857142856,77620068.4099996,-0.00051,-7.864450127877253,-77.58186397984889,22.418136020151106,31.738035264483624,0.2086230876216883,0.01554,0.0157,0.01419,0.01438,35474005.9,2043.0,20743034.4,-7.464607464607462,40.203193033381694,0.01636576666640132,0.013685233333598681,-0.0006857068957536634,-0.0010089013596920264,0.00032319446393836294,0.0015099999999999992,0.0011635714285714285,45790369.2099996,-0.0004899999999999991,-8.582326764144954,-78.33753148614609,21.66246851385391,40.38623005877415,0.01512333333333333,0.014867228803248983,0.014915714285714284,0.014971111013493119,0.0150255,0.01517360514591199,5248.0,21266777.466666672,11204.0,21086509.185714282
2020-04-22,0.01443,0.01505,0.01432,0.01489,32606996.5,1261.0,23083526.8,0.014559999999999998,0.014942857142857143,0.015061999999999997,0.014764307200812246,0.01484562494508988,0.015080796956177388,41.25364431486881,0.01633893053028413,0.013785069469715864,-0.0006301288231882907,-0.0008805804131740206,0.0002504515899857298,0.0007299999999999997,0.0010964285714285713,110227064.9099996,-0.00015999999999999868,-7.458048477315105,-65.49118387909319,34.50881612090681,26.19647355163728,3.1878031878031896,0.01438,0.01468,0.01413,0.01441,31829699.2,1208.0,15921343.4,0.2086230876216883,40.995607613469964,0.016343831359172844,0.01373716864082716,-0.000680361114584159,-0.000943193310670453,0.00026283219608629396,0.0005500000000000001,0.0011057142857142856,77620068.4099996,-0.00051,-7.864450127877253,-77.58186397984889,22.418136020151106,31.738035264483624,0.014779999999999996,0.014638614401624492,0.01483142857142857,0.014830833260119839,0.015040500000000002,0.015100880846301325,5148.0,19761188.633333344,10999.0,19599363.04285714
2020-04-23,0.01486,0.01594,0.01468,0.01536,42658981.4,2174.0,29732475.2,0.014886666666666666,0.015007142857142858,0.0151065,0.015062153600406122,0.014974218708817408,0.01510738772225573,40.02976190476191,0.016358349579081027,0.013854650420918971,-0.0005460992065882391,-0.0008136841718568643,0.0002675849652686252,0.001259999999999999,0.0010557142857142855,152886046.3099996,0.00045000000000000075,-8.023952095808372,-43.20987654320989,56.79012345679012,37.90569186594935,3.3647375504710664,0.01443,0.01505,0.01432,0.01489,32606996.5,1261.0,23083526.8,3.1878031878031896,41.25364431486881,0.01633893053028413,0.013785069469715864,-0.0006301288231882907,-0.0008805804131740206,0.0002504515899857298,0.0007299999999999997,0.0010964285714285713,110227064.9099996,-0.00015999999999999868,-7.458048477315105,-65.49118387909319,34.50881612090681,26.19647355163728,0.014559999999999998,0.014764307200812246,0.014942857142857143,0.01484562494508988,0.015061999999999997,0.015080796956177388,4512.0,19915968.200000007,10799.0,20528104.414285712
2020-04-24,0.01536,0.01712,0.01532,0.01693,50153251.7,3941.0,25577801.5,0.015726666666666667,0.01528,0.015214,0.01599607680020306,0.015463164031613057,0.01528096984394566,65.94427244582045,0.016695910573412777,0.013732089426587223,-0.00034879851886354847,-0.0007207070412582012,0.0003719085223946527,0.0017999999999999995,0.0010078571428571426,203039298.00999957,0.0019300000000000012,13.85339609952927,-5.277777777777757,94.72222222222224,62.007053933306395,10.221354166666668,0.01486,0.01594,0.01468,0.01536,42658981.4,2174.0,29732475.2,3.3647375504710664,40.02976190476191,0.016358349579081027,0.013854650420918971,-0.0005460992065882391,-0.0008136841718568643,0.0002675849652686252,0.001259999999999999,0.0010557142857142855,152886046.3099996,0.00045000000000000075,-8.023952095808372,-43.20987654320989,56.79012345679012,37.90569186594935,0.014886666666666666,0.015062153600406122,0.015007142857142858,0.014974218708817408,0.0151065,0.01510738772225573,4643.0,22912448.466666672,11120.0,21901553.757142853
2020-04-25,0.01689,0.02075,0.01628,0.02032,130042785.1,11248.0,60753707.5,0.01753666666666667,0.01597714285714286,0.015511500000000001,0.01815803840010153,0.016677373023709793,0.0157608774778556,77.55102040816328,0.018187713153380924,0.01283528684661908,8.018405435510079e-05,-0.0005605288221355408,0.0006407128764906416,0.004470000000000002,0.0012542857142857143,333082083.10999954,0.006210000000000002,36.193029490616645,-5.947441217150758,94.05255878284923,81.85496815395386,20.307874481941994,0.01536,0.01712,0.01532,0.01693,50153251.7,3941.0,25577801.5,10.221354166666668,65.94427244582045,0.016695910573412777,0.013732089426587223,-0.00034879851886354847,-0.0007207070412582012,0.0003719085223946527,0.0017999999999999995,0.0010078571428571426,203039298.00999957,0.0019300000000000012,13.85339609952927,-5.277777777777757,94.72222222222224,62.007053933306395,0.015726666666666667,0.01599607680020306,0.01528,0.015463164031613057,0.015214,0.01528096984394566,7376.0,26131267.833333343,13832.0,22587925.61428571
2020-04-26,0.02022,0.021,0.0184,0.01874,80798728.6,7501.0,39067107.6,0.018663333333333334,0.016432857142857145,0.015662000000000002,0.018449019200050765,0.017193029767782343,0.016044603432345542,66.4,0.018703555003995304,0.012620444996004699,0.00028932784756794186,-0.0003905574881948443,0.0006798853357627861,0.0026000000000000016,0.00138,252283354.50999954,0.00383,24.518272425249176,-30.21390374331553,69.78609625668447,86.18695908725199,-7.3194856577645835,0.01689,0.02075,0.01628,0.02032,130042785.1,11248.0,60753707.5,20.307874481941994,77.55102040816328,0.018187713153380924,0.01283528684661908,8.018405435510079e-05,-0.0005605288221355408,0.0006407128764906416,0.004470000000000002,0.0012542857142857143,333082083.10999954,0.006210000000000002,36.193029490616645,-5.947441217150758,94.05255878284923,81.85496815395386,0.01753666666666667,0.01815803840010153,0.01597714285714286,0.016677373023709793,0.015511500000000001,0.0157608774778556,17363.0,38687994.73333334,23772.0,28347296.699999996
2020-04-27,0.0188,0.02042,0.01794,0.02023,53495075.6,4919.0,29592865.3,0.019763333333333334,0.017268571428571432,0.0158915,0.01933950960002538,0.01795227232583676,0.016443212629265014,71.11111111111111,0.019555126474900483,0.012227873525099516,0.0005687501602268004,-0.00019869595851051535,0.0007674461187373157,0.0024799999999999996,0.0014957142857142858,305778430.10999954,0.005210000000000001,35.68075117370893,-10.29411764705882,89.70588235294117,84.51484579749165,7.606382978723408,0.02022,0.021,0.0184,0.01874,80798728.6,7501.0,39067107.6,-7.3194856577645835,66.4,0.018703555003995304,0.012620444996004699,0.00028932784756794186,-0.0003905574881948443,0.0006798853357627861,0.0026000000000000016,0.00138,252283354.50999954,0.00383,24.518272425249176,-30.21390374331553,69.78609625668447,86.18695908725199,0.018663333333333334,0.018449019200050765,0.016432857142857145,0.017193029767782343,0.015662000000000002,0.016044603432345542,22690.0,41799538.866666675,29376.0,30696999.485714283
2020-04-28,0.02031,0.0215,0.01886,0.02055,57252685.8,5925.0,26924422.9,0.01984,0.018145714285714286,0.016114499999999997,0.01994475480001269,0.01860170424437757,0.01683433523600168,71.62899454403741,0.020330332189835668,0.011898667810164326,0.000806716357777449,2.3865047470775225e-06,0.0008043298530303715,0.00264,0.0016385714285714287,363031115.90999955,0.005109999999999998,36.999999999999986,-11.904761904761902,88.09523809523809,82.52907223495458,1.1816838995568544,0.0188,0.02042,0.01794,0.02023,53495075.6,4919.0,29592865.3,7.606382978723408,71.11111111111111,0.019555126474900483,0.012227873525099516,0.0005687501602268004,-0.00019869595851051535,0.0007674461187373157,0.0024799999999999996,0.0014957142857142858,305778430.10999954,0.005210000000000001,35.68075117370893,-10.29411764705882,89.70588235294117,84.51484579749165,0.019763333333333334,0.01933950960002538,0.017268571428571432,0.01795227232583676,0.0158915,0.016443212629265014,23668.0,43137893.466666676,32252.0,31961261.042857137
2020-04-29,0.02055,0.02103,0.01969,0.02094,57017190.4,5989.0,29269997.1,0.020573333333333332,0.01901,0.0163265,0.020442377400006345,0.019186278183283178,0.017225350927811044,77.69667477696674,0.021060846061685998,0.011592153938314004,0.0010150748731487282,0.00020492417842740766,0.0008101506947213206,0.001340000000000001,0.001655,420048306.3099995,0.005390000000000001,48.405386250885904,-7.0175438596491,92.9824561403509,90.26119219617674,1.8978102189781094,0.02031,0.0215,0.01886,0.02055,57252685.8,5925.0,26924422.9,1.1816838995568544,71.62899454403741,0.020330332189835668,0.011898667810164326,0.000806716357777449,2.3865047470775225e-06,0.0008043298530303715,0.00264,0.0016385714285714287,363031115.90999955,0.005109999999999998,36.999999999999986,-11.904761904761902,88.09523809523809,82.52907223495458,0.01984,0.01994475480001269,0.018145714285714286,0.01860170424437757,0.016114499999999997,0.01683433523600168,18345.0,31861465.266666677,36969.0,33533129.542857137
2020-04-30,0.02095,0.0224,0.01944,0.01997,55273239.7,5442.0,28574884.2,0.020486666666666667,0.019668571428571428,0.0165815,0.020206188700003173,0.019382208637462383,0.017486746077543327,70.24000000000001,0.021530074595430305,0.01163292540456969,0.001089372002021971,0.00038181374314632036,0.0007075582588756507,0.002960000000000001,0.0017464285714285717,364775066.60999954,0.005590000000000001,33.93695506371564,-29.383313180169267,70.61668681983073,83.89812701847326,-4.677804295942713,0.02055,0.02103,0.01969,0.02094,57017190.4,5989.0,29269997.1,1.8978102189781094,77.69667477696674,0.021060846061685998,0.011592153938314004,0.0010150748731487282,0.00020492417842740766,0.0008101506947213206,0.001340000000000001,0.001655,420048306.3099995,0.005390000000000001,48.405386250885904,-7.0175438596491,92.9824561403509,90.26119219617674,0.020573333333333332,0.020442377400006345,0.01901,0.019186278183283178,0.0163265,0.017225350927811044,16833.0,28595761.766666677,41697.0,34416911.014285706
2020-05-01,0.02004,0.02169,0.02004,0.02053,26392432.8,3068.0,14475871.2,0.02048,0.020182857142857145,0.016862,0.020368094350001587,0.019669156478096785,0.017776579784443962,71.27413127413126,0.022044487108696074,0.01167951289130392,0.001179839872198763,0.000541418968956809,0.0006384209032419541,0.0016500000000000022,0.001825714285714286,391167499.40999955,0.0061200000000000004,36.68442077230358,-22.611850060459496,77.38814993954051,80.32909763324072,2.445109780439126,0.02095,0.0224,0.01944,0.01997,55273239.7,5442.0,28574884.2,-4.677804295942713,70.24000000000001,0.021530074595430305,0.01163292540456969,0.001089372002021971,0.00038181374314632036,0.0007075582588756507,0.002960000000000001,0.0017464285714285717,364775066.60999954,0.005590000000000001,33.93695506371564,-29.383313180169267,70.61668681983073,83.89812701847326,0.020486666666666667,0.020206188700003173,0.019668571428571428,0.019382208637462383,0.0165815,0.017486746077543327,17356.0,28256434.733333338,44965.0,34251540.871428564
2020-05-02,0.02045,0.02134,0.0195,0.02029,31114254.0,2670.0,15091655.4,0.02026333333333333,0.020178571428571428,0.017124,0.020329047175000795,0.019824367358572587,0.018015953138306444,68.98981989036804,0.022448645379860934,0.011799354620139067,0.0012181284898905645,0.0006767608731435602,0.0005413676167470043,0.0018400000000000014,0.001916428571428572,360053245.40999955,0.0053999999999999986,31.411917098445574,-25.513905683192274,74.48609431680772,74.16364369205967,-0.782396088019562,0.02004,0.02169,0.02004,0.02053,26392432.8,3068.0,14475871.2,2.445109780439126,71.27413127413126,0.022044487108696074,0.01167951289130392,0.001179839872198763,0.000541418968956809,0.0006384209032419541,0.0016500000000000022,0.001825714285714286,391167499.40999955,0.0061200000000000004,36.68442077230358,-22.611850060459496,77.38814993954051,80.32909763324072,0.02048,0.020368094350001587,0.020182857142857145,0.019669156478096785,0.016862,0.017776579784443962,14499.0,24106917.500000004,44092.0,32665550.82857142
2020-05-03,0.02029,0.02042,0.01901,0.02005,30353143.8,2861.0,18876414.2,0.02029,0.020365714285714286,0.017381,0.020189523587500396,0.01988077551892944,0.018209671887039165,67.44186046511628,0.022751680247046074,0.012010319752953927,0.0012150995893369515,0.0007844286163822384,0.0004306709729547131,0.0014100000000000015,0.0019457142857142863,329700101.60999954,0.004689999999999998,28.938906752411576,-28.415961305925048,71.58403869407495,74.48609431680774,-1.1828486939379035,0.02045,0.02134,0.0195,0.02029,31114254.0,2670.0,15091655.4,-0.782396088019562,68.98981989036804,0.022448645379860934,0.011799354620139067,0.0012181284898905645,0.0006767608731435602,0.0005413676167470043,0.0018400000000000014,0.001916428571428572,360053245.40999955,0.0053999999999999986,31.411917098445574,-25.513905683192274,74.48609431680772,74.16364369205967,0.02026333333333333,0.020329047175000795,0.020178571428571428,0.019824367358572587,0.017124,0.018015953138306444,11180.0,19380803.60000001,35514.0,26142400.528571423
2020-05-04,0.02005,0.02015,0.01803,0.0189,27738925.8,2474.0,15997040.7,0.019746666666666666,0.020175714285714286,0.017576,0.0195447617937502,0.01963558163919708,0.018275417421606863,67.54658385093168,0.0228652677833923,0.012286732216607702,0.0011071413385973818,0.0008489711608252671,0.0002581701777721147,0.0021200000000000004,0.0019892857142857147,301961175.8099995,0.0019699999999999995,31.432545201668983,-42.32164449818621,57.67835550181378,67.9161628375655,-5.735660847880291,0.02029,0.02042,0.01901,0.02005,30353143.8,2861.0,18876414.2,-1.1828486939379035,67.44186046511628,0.022751680247046074,0.012010319752953927,0.0012150995893369515,0.0007844286163822384,0.0004306709729547131,0.0014100000000000015,0.0019457142857142863,329700101.60999954,0.004689999999999998,28.938906752411576,-28.415961305925048,71.58403869407495,74.48609431680774,0.02029,0.020189523587500396,0.020365714285714286,0.01988077551892944,0.017381,0.018209671887039165,8599.0,16147980.266666673,30874.0,23258015.75714285
2020-05-05,0.01895,0.02018,0.01824,0.01959,31153949.2,2833.0,17446537.7,0.01951333333333333,0.02003857142857143,0.017849999999999998,0.019567380896875097,0.019624186229397808,0.01840061576240621,69.12850812407682,0.02294755772277891,0.012752442277221086,0.0010649844032476034,0.0008921738093097344,0.00017281059393786907,0.0019400000000000008,0.0020885714285714292,333115125.0099995,-0.0007300000000000015,35.947258848022216,-34.777227722772274,65.22277227722772,64.82838882437215,3.377308707124001,0.02005,0.02015,0.01803,0.0189,27738925.8,2474.0,15997040.7,-5.735660847880291,67.54658385093168,0.0228652677833923,0.012286732216607702,0.0011071413385973818,0.0008489711608252671,0.0002581701777721147,0.0021200000000000004,0.0019892857142857147,301961175.8099995,0.0019699999999999995,31.432545201668983,-42.32164449818621,57.67835550181378,67.9161628375655,0.019746666666666666,0.0195447617937502,0.020175714285714286,0.01963558163919708,0.017576,0.018275417421606863,8005.0,16655036.766666675,28429.0,21315755.099999994
2020-05-06,0.01959,0.01988,0.0184,0.01852,23310354.6,2290.0,11482940.9,0.01900333333333333,0.019692857142857144,0.0180305,0.019043690448437546,0.019348139672048355,0.018411985689796097,62.845010615711246,0.0229419880369459,0.013119011963054102,0.0009344627655433861,0.0009006316005564648,3.383116498692127e-05,0.0014799999999999987,0.0021421428571428577,309804770.4099995,-0.00022000000000000144,24.378777703156462,-50.259067357512976,49.740932642487024,57.547353473842854,-5.46197039305769,0.01895,0.02018,0.01824,0.01959,31153949.2,2833.0,17446537.7,3.377308707124001,69.12850812407682,0.02294755772277891,0.012752442277221086,0.0010649844032476034,0.0008921738093097344,0.00017281059393786907,0.0019400000000000008,0.0020885714285714292,333115125.0099995,-0.0007300000000000015,35.947258848022216,-34.777227722772274,65.22277227722772,64.82838882437215,0.01951333333333333,0.019567380896875097,0.02003857142857143,0.019624186229397808,0.017849999999999998,0.01840061576240621,8168.0,17439997.53333334,25337.0,19961771.499999996
2020-05-07,0.01844,0.0192,0.01734,0.01806,33091300.4,3457.0,15815049.4,0.01872333333333333,0.019419999999999996,0.018182499999999997,0.018551845224218773,0.019026104754036266,0.01837846324314885,59.56090651558073,0.02288543469410989,0.013479565305890106,0.0007848579181620949,0.0008774768640775909,-9.261894591549604e-05,0.001859999999999997,0.0021850000000000003,276713470.0099995,-0.002170000000000002,17.578125,-61.299435028248595,38.700564971751405,51.22142329715539,-2.0607375271149775,0.01959,0.01988,0.0184,0.01852,23310354.6,2290.0,11482940.9,-5.46197039305769,62.845010615711246,0.0229419880369459,0.013119011963054102,0.0009344627655433861,0.0009006316005564648,3.383116498692127e-05,0.0014799999999999987,0.0021421428571428577,309804770.4099995,-0.00022000000000000144,24.378777703156462,-50.259067357512976,49.740932642487024,57.547353473842854,0.01900333333333333,0.019043690448437546,0.019692857142857144,0.019348139672048355,0.0180305,0.018411985689796097,7597.0,14975506.43333334,21638.0,17420763.471428566
2020-05-08,0.018,0.01943,0.018,0.01889,25190079.6,2457.0,15329779.6,0.01849,0.019185714285714285,0.018355,0.018720922612109385,0.0189920785655272,0.018427181029515627,57.32436472346786,0.02288426623547337,0.01382573376452663,0.0007249127195794632,0.0008469640351779654,-0.00012205131559850228,0.0014300000000000007,0.002158571428571429,301903549.60999954,-0.0016599999999999983,11.577082102776126,-57.35294117647057,42.64705882352943,43.696185479255966,4.944444444444455,0.01844,0.0192,0.01734,0.01806,33091300.4,3457.0,15815049.4,-2.0607375271149775,59.56090651558073,0.02288543469410989,0.013479565305890106,0.0007848579181620949,0.0008774768640775909,-9.261894591549604e-05,0.001859999999999997,0.0021850000000000003,276713470.0099995,-0.002170000000000002,17.578125,-61.299435028248595,38.700564971751405,51.22142329715539,0.01872333333333333,0.018551845224218773,0.019419999999999996,0.019026104754036266,0.018182499999999997,0.01837846324314885,8580.0,14914842.666666673,19653.0,15597929.928571422
2020-05-09,0.01881,0.01977,0.01872,0.01879,28150374.1,2234.0,15920056.3,0.01858,0.018971428571428573,0.018517,0.018755461306054693,0.0189415589241454,0.018461735217180805,42.41823587710604,0.022851416005124928,0.014182583994875072,0.0006617087865636792,0.0008099129854551082,-0.00014820419889142902,0.0010499999999999989,0.0019142857142857145,273753175.5099995,-0.002149999999999999,-7.529527559055116,-71.34387351778656,28.656126482213445,36.66791675916477,-0.10632642211589147,0.018,0.01943,0.018,0.01889,25190079.6,2457.0,15329779.6,4.944444444444455,57.32436472346786,0.02288426623547337,0.01382573376452663,0.0007249127195794632,0.0008469640351779654,-0.00012205131559850228,0.0014300000000000007,0.002158571428571429,301903549.60999954,-0.0016599999999999983,11.577082102776126,-57.35294117647057,42.64705882352943,43.696185479255966,0.01849,0.018720922612109385,0.019185714285714285,0.0189920785655272,0.018355,0.018427181029515627,8204.0,14209256.63333334,19042.0,15719916.84285714
2020-05-10,0.01873,0.01874,0.01547,0.01768,40638622.4,4037.0,20741373.2,0.018453333333333335,0.018632857142857142,0.018682,0.01821773065302735,0.01862616919310905,0.018387284244115967,44.4906444906445,0.02258288572940864,0.01478111427059136,0.0005161021862058572,0.0007511508256052581,-0.0002350486393994009,0.0032700000000000003,0.0019621428571428576,233114553.1099995,-0.0022900000000000004,-5.6563500533617805,-68.10966810966809,31.890331890331915,34.397839065358276,-5.605979711692466,0.01881,0.01977,0.01872,0.01879,28150374.1,2234.0,15920056.3,-0.10632642211589147,42.41823587710604,0.022851416005124928,0.014182583994875072,0.0006617087865636792,0.0008099129854551082,-0.00014820419889142902,0.0010499999999999989,0.0019142857142857145,273753175.5099995,-0.002149999999999999,-7.529527559055116,-71.34387351778656,28.656126482213445,36.66791675916477,0.01858,0.018755461306054693,0.018971428571428573,0.0189415589241454,0.018517,0.018461735217180805,8148.0,15688295.100000009,18606.0,15838259.828571424
2020-05-11,0.0177,0.0181,0.01624,0.01697,27820946.5,2781.0,16993095.1,0.017813333333333334,0.018357142857142857,0.01881,0.017593865326513674,0.018212126894831787,0.0182523047922954,31.561085972850663,0.022262949921170935,0.015357050078829067,0.00033950325787757835,0.0006688213120597221,-0.0003293180541821438,0.0018600000000000005,0.0019178571428571432,205293606.6099995,-0.0035600000000000007,-16.114681166584287,-78.35497835497837,21.64502164502164,27.397160005855678,-4.124293785310742,0.01873,0.01874,0.01547,0.01768,40638622.4,4037.0,20741373.2,-5.605979711692466,44.4906444906445,0.02258288572940864,0.01478111427059136,0.0005161021862058572,0.0007511508256052581,-0.0002350486393994009,0.0032700000000000003,0.0019621428571428576,233114553.1099995,-0.0022900000000000004,-5.6563500533617805,-68.10966810966809,31.890331890331915,34.397839065358276,0.018453333333333335,0.01821773065302735,0.018632857142857142,0.01862616919310905,0.018682,0.018387284244115967,8728.0,17330403.033333343,19782.0,16104682.542857137
2020-05-12,0.01699,0.01831,0.01667,0.01785,26831272.2,2382.0,15019974.7,0.0175,0.01810857142857143,0.018958000000000003,0.017721932663256838,0.01812159517112384,0.01821399005017203,35.638297872340445,0.02192273021763825,0.015993269782361756,0.000267472721348274,0.0005885515939174326,-0.00032107887256915856,0.001639999999999999,0.0018464285714285718,232124878.8099995,-0.0024399999999999977,-13.138686131386844,-65.65656565656563,34.34343434343437,29.29292929292932,5.061801059446731,0.0177,0.0181,0.01624,0.01697,27820946.5,2781.0,16993095.1,-4.124293785310742,31.561085972850663,0.022262949921170935,0.015357050078829067,0.00033950325787757835,0.0006688213120597221,-0.0003293180541821438,0.0018600000000000005,0.0019178571428571432,205293606.6099995,-0.0035600000000000007,-16.114681166584287,-78.35497835497837,21.64502164502164,27.397160005855678,0.017813333333333334,0.017593865326513674,0.018357142857142857,0.018212126894831787,0.01881,0.0182523047922954,9052.0,17884841.533333343,20089.0,16246976.028571425
2020-05-13,0.01785,0.01908,0.01773,0.01853,51789723.6,3114.0,41033969.1,0.017783333333333335,0.018109999999999998,0.0191165,0.01812596633162842,0.018223696378342882,0.01824408623586993,37.56449948400414,0.021565381807168816,0.016667618192831187,0.0002622354323712009,0.0005232883616081862,-0.0002610529292369853,0.0013500000000000005,0.0018471428571428575,283914602.4099995,-0.001519999999999997,-11.509073543457493,-55.84415584415582,44.15584415584418,33.3814333814334,3.8095238095238098,0.01699,0.01831,0.01667,0.01785,26831272.2,2382.0,15019974.7,5.061801059446731,35.638297872340445,0.02192273021763825,0.015993269782361756,0.000267472721348274,0.0005885515939174326,-0.00032107887256915856,0.001639999999999999,0.0018464285714285718,232124878.8099995,-0.0024399999999999977,-13.138686131386844,-65.65656565656563,34.34343434343437,29.29292929292932,0.0175,0.017721932663256838,0.01810857142857143,0.01812159517112384,0.018958000000000003,0.01821399005017203,9200.0,17584814.33333334,19638.0,15900324.171428567
2020-05-14,0.01853,0.01948,0.0183,0.01944,59658597.9,3460.0,46209141.8,0.018606666666666667,0.018307142857142855,0.019242,0.01878298316581421,0.01852777228375716,0.0183579827848347,47.24818276220143,0.021466018174908726,0.01701798182509127,0.000327736297903454,0.0004841779488672398,-0.0001564416509637858,0.0011800000000000005,0.0017200000000000004,343573200.30999947,0.0005399999999999988,-2.653980971457204,-36.17363344051449,63.82636655948551,47.441881686254696,4.910955207771169,0.01785,0.01908,0.01773,0.01853,51789723.6,3114.0,41033969.1,3.8095238095238098,37.56449948400414,0.021565381807168816,0.016667618192831187,0.0002622354323712009,0.0005232883616081862,-0.0002610529292369853,0.0013500000000000005,0.0018471428571428575,283914602.4099995,-0.001519999999999997,-11.509073543457493,-55.84415584415582,44.15584415584418,33.3814333814334,0.017783333333333335,0.01812596633162842,0.018109999999999998,0.018223696378342882,0.0191165,0.01824408623586993,8277.0,24349012.966666672,20462.0,20121899.628571425
2020-05-15,0.01948,0.02081,0.01901,0.0195,70563592.3,6241.0,46796278.9,0.01915666666666667,0.018394285714285717,0.019201,0.019141491582907105,0.01877082921281787,0.018466746329136155,44.3592552026287,0.021370917776809495,0.017031082223190504,0.0003801060780452073,0.00046336357470283334,-8.325749665762604e-05,0.0017999999999999995,0.0017307142857142857,414136792.6099995,-8.99999999999998e-05,-5.017048222113973,-31.34582623509371,68.65417376490629,58.87879482674534,0.10266940451744962,0.01853,0.01948,0.0183,0.01944,59658597.9,3460.0,46209141.8,4.910955207771169,47.24818276220143,0.021466018174908726,0.01701798182509127,0.000327736297903454,0.0004841779488672398,-0.0001564416509637858,0.0011800000000000005,0.0017200000000000004,343573200.30999947,0.0005399999999999988,-2.653980971457204,-36.17363344051449,63.82636655948551,47.441881686254696,0.018606666666666667,0.01878298316581421,0.018307142857142855,0.01852777228375716,0.019242,0.0183579827848347,8956.0,34087695.20000001,20465.0,24463912.82857142
2020-05-16,0.01951,0.02234,0.0194,0.02156,88229435.5,8316.0,55552400.5,0.020166666666666666,0.01879,0.019342,0.020350745791453552,0.019468121909613403,0.018761341916837475,55.79908675799087,0.02174025901770606,0.016943740982293943,0.0005811353237056109,0.0004869179245033889,9.421739920222202e-05,0.002939999999999998,0.0018092857142857142,502366228.1099995,0.003040000000000001,6.25924100542139,-11.353711790393007,88.646288209607,73.70894284466627,10.507432086109686,0.01948,0.02081,0.01901,0.0195,70563592.3,6241.0,46796278.9,0.10266940451744962,44.3592552026287,0.021370917776809495,0.017031082223190504,0.0003801060780452073,0.00046336357470283334,-8.325749665762604e-05,0.0017999999999999995,0.0017307142857142857,414136792.6099995,-8.99999999999998e-05,-5.017048222113973,-31.34582623509371,68.65417376490629,58.87879482674534,0.01915666666666667,0.019141491582907105,0.018394285714285717,0.01877082921281787,0.019201,0.018466746329136155,12815.0,44679796.6,24249.0,28959127.01428571
2020-05-17,0.02146,0.02244,0.0204,0.02058,64259019.4,5720.0,35014648.7,0.020546666666666668,0.019204285714285712,0.019359499999999998,0.020465372895726777,0.019746091432210053,0.01893454744856724,52.266894781864856,0.021789934009370165,0.01692906599062983,0.0006538376065027308,0.0005203018609032574,0.0001335357455994735,0.00204,0.0018542857142857141,438107208.7099995,0.0025200000000000014,2.643391521197014,-26.6857962697274,73.3142037302726,76.87155523492864,-4.10065237651444,0.01951,0.02234,0.0194,0.02156,88229435.5,8316.0,55552400.5,10.507432086109686,55.79908675799087,0.02174025901770606,0.016943740982293943,0.0005811353237056109,0.0004869179245033889,9.421739920222202e-05,0.002939999999999998,0.0018092857142857142,502366228.1099995,0.003040000000000001,6.25924100542139,-11.353711790393007,88.646288209607,73.70894284466627,0.020166666666666666,0.020350745791453552,0.01879,0.019468121909613403,0.019342,0.018761341916837475,18017.0,49519273.73333334,30331.0,34620890.471428566
2020-05-18,0.02058,0.02097,0.0201,0.02023,40802421.1,2559.0,28570249.4,0.02079,0.01967,0.019343500000000003,0.02034768644786339,0.01986706857415754,0.019057923882037024,56.10651974288339,0.021744975642886445,0.01694202435711356,0.0006754267157426073,0.0005513268318711274,0.00012409988387147993,0.0008699999999999992,0.0017649999999999996,397304787.6099995,0.001340000000000001,7.037037037037042,-31.707317073170728,68.29268292682927,76.75105828890297,-1.7006802721088417,0.02146,0.02244,0.0204,0.02058,64259019.4,5720.0,35014648.7,-4.10065237651444,52.266894781864856,0.021789934009370165,0.01692906599062983,0.0006538376065027308,0.0005203018609032574,0.0001335357455994735,0.00204,0.0018542857142857141,438107208.7099995,0.0025200000000000014,2.643391521197014,-26.6857962697274,73.3142037302726,76.87155523492864,0.020546666666666668,0.020465372895726777,0.019204285714285712,0.019746091432210053,0.019359499999999998,0.01893454744856724,20277.0,45787776.03333334,32014.0,36659929.828571424
2020-05-19,0.02023,0.02056,0.01965,0.0205,51242229.8,2783.0,39002412.9,0.02043666666666667,0.020048571428571433,0.0193215,0.020423843223931697,0.020025301430618155,0.019195264464700164,54.34574976122254,0.021668845869657456,0.01697415413034254,0.0007061825510075517,0.0005822979756984123,0.0001238845753091394,0.0009099999999999976,0.001691428571428571,448547017.4099995,0.0017099999999999997,4.645227156712606,-27.8335724533716,72.16642754662841,71.25777140124343,1.3346515076618855,0.02058,0.02097,0.0201,0.02023,40802421.1,2559.0,28570249.4,-1.7006802721088417,56.10651974288339,0.021744975642886445,0.01694202435711356,0.0006754267157426073,0.0005513268318711274,0.00012409988387147993,0.0008699999999999992,0.0017649999999999996,397304787.6099995,0.001340000000000001,7.037037037037042,-31.707317073170728,68.29268292682927,76.75105828890297,0.02079,0.02034768644786339,0.01967,0.01986706857415754,0.019343500000000003,0.019057923882037024,16595.0,39712432.866666675,31792.0,38313809.014285706
2020-05-20,0.02043,0.0208,0.01885,0.01967,57205814.7,3777.0,34225974.6,0.020133333333333333,0.02021142857142857,0.0193065,0.02004692161196585,0.019936476072963616,0.019240477372823958,55.620723362658865,0.021640191676791144,0.016972808323208858,0.0006560205125284296,0.0005970424830644158,5.8978029464013806e-05,0.0019500000000000003,0.0017249999999999995,391341202.7099995,0.0019899999999999987,6.209503239740832,-39.741750358680065,60.25824964131993,66.90578670492589,-3.7200195790504176,0.02023,0.02056,0.01965,0.0205,51242229.8,2783.0,39002412.9,1.3346515076618855,54.34574976122254,0.021668845869657456,0.01697415413034254,0.0007061825510075517,0.0005822979756984123,0.0001238845753091394,0.0009099999999999976,0.001691428571428571,448547017.4099995,0.0017099999999999997,4.645227156712606,-27.8335724533716,72.16642754662841,71.25777140124343,0.02043666666666667,0.020423843223931697,0.020048571428571433,0.020025301430618155,0.0193215,0.019195264464700164,11062.0,34195770.33333334,32193.0,41739871.61428571
2020-05-21,0.01962,0.01989,0.01831,0.01915,71012050.1,3661.0,52912960.4,0.019773333333333334,0.02017,0.0192375,0.019598460805982924,0.019739857054722712,0.019231860480174057,55.29640427599611,0.021499375095487706,0.016975624904512297,0.0005677622714119861,0.0005911864407339299,-2.3424169321943807e-05,0.0015800000000000015,0.001705,320329152.60999954,0.0021800000000000014,6.035437430786272,-47.20229555236729,52.79770444763271,61.74079387852702,-2.3955147808358728,0.02043,0.0208,0.01885,0.01967,57205814.7,3777.0,34225974.6,-3.7200195790504176,55.620723362658865,0.021640191676791144,0.016972808323208858,0.0006560205125284296,0.0005970424830644158,5.8978029464013806e-05,0.0019500000000000003,0.0017249999999999995,391341202.7099995,0.0019899999999999987,6.209503239740832,-39.741750358680065,60.25824964131993,66.90578670492589,0.020133333333333333,0.02004692161196585,0.02021142857142857,0.019936476072963616,0.0193065,0.019240477372823958,9119.0,33932878.966666676,32856.0,40767300.971428566
2020-05-22,0.0191,0.02093,0.01896,0.02034,68779500.5,3885.0,49806814.3,0.01972,0.02029,0.01924,0.019969230402991464,0.019889892791042033,0.019337397577300335,56.8075117370892,0.021506878215150595,0.016973121784849405,0.0005870726264186263,0.0005903636778708692,-3.291051452242958e-06,0.0019699999999999995,0.0017435714285714283,389108653.10999954,0.002489999999999999,7.676019057702477,-30.12912482065998,69.87087517934002,60.97560975609756,6.492146596858647,0.01962,0.01989,0.01831,0.01915,71012050.1,3661.0,52912960.4,-2.3955147808358728,55.29640427599611,0.021499375095487706,0.016975624904512297,0.0005677622714119861,0.0005911864407339299,-2.3424169321943807e-05,0.0015800000000000015,0.001705,320329152.60999954,0.0021800000000000014,6.035437430786272,-47.20229555236729,52.79770444763271,61.74079387852702,0.019773333333333334,0.019598460805982924,0.02017,0.019739857054722712,0.0192375,0.019231860480174057,10221.0,42047115.966666676,33057.0,41724989.34285714
2020-05-23,0.02041,0.02091,0.01962,0.02003,73797629.1,3178.0,58204909.5,0.01984,0.020071428571428573,0.019239,0.01999961520149573,0.019924919593281527,0.01940335971279554,55.709023941068125,0.02150439086907597,0.01697360913092403,0.0005707821908663528,0.000586447380469966,-1.5665189603613185e-05,0.001290000000000003,0.0017607142857142858,315311024.0099995,0.0014999999999999979,6.599254922831288,-34.57675753228123,65.42324246771877,62.697274031563836,-1.8618324350808517,0.0191,0.02093,0.01896,0.02034,68779500.5,3885.0,49806814.3,6.492146596858647,56.8075117370892,0.021506878215150595,0.016973121784849405,0.0005870726264186263,0.0005903636778708692,-3.291051452242958e-06,0.0019699999999999995,0.0017435714285714283,389108653.10999954,0.002489999999999999,7.676019057702477,-30.12912482065998,69.87087517934002,60.97560975609756,0.01972,0.019969230402991464,0.02029,0.019889892791042033,0.01924,0.019337397577300335,11323.0,45648583.1,30701.0,42155065.828571424
2020-05-24,0.01996,0.021,0.01889,0.01999,75714480.8,5667.0,45399284.4,0.02012,0.01998714285714286,0.019293499999999998,0.019994807600747865,0.019941189694961146,0.01945923021633882,61.79775280898876,0.021576925635267755,0.01701007436473224,0.000548323505566238,0.0005788226054892204,-3.0499099922982344e-05,0.0021100000000000008,0.0016778571428571428,239596543.2099995,0.0005500000000000019,13.065610859728505,-39.51612903225807,60.48387096774193,65.25932953826693,0.1503006012024161,0.02041,0.02091,0.01962,0.02003,73797629.1,3178.0,58204909.5,-1.8618324350808517,55.709023941068125,0.02150439086907597,0.01697360913092403,0.0005707821908663528,0.000586447380469966,-1.5665189603613185e-05,0.001290000000000003,0.0017607142857142858,315311024.0099995,0.0014999999999999979,6.599254922831288,-34.57675753228123,65.42324246771877,62.697274031563836,0.01984,0.01999961520149573,0.020071428571428573,0.019924919593281527,0.019239,0.01940335971279554,10724.0,53641561.400000006,25563.0,42533995.68571428
2020-05-25,0.01999,0.02299,0.01967,0.02256,85570910.1,9473.0,45082449.1,0.02086,0.02032,0.019442,0.021277403800373934,0.02059589227122086,0.01975454162430655,73.99141630901289,0.022152902743447164,0.01673109725655284,0.0007294932136010061,0.0006089567271115776,0.00012053648648942857,0.00332,0.0017821428571428571,325167453.30999947,0.0030600000000000002,32.94048320565706,-6.803797468354428,93.19620253164557,73.03443865570209,12.85642821410705,0.01996,0.021,0.01889,0.01999,75714480.8,5667.0,45399284.4,0.1503006012024161,61.79775280898876,0.021576925635267755,0.01701007436473224,0.000548323505566238,0.0005788226054892204,-3.0499099922982344e-05,0.0021100000000000008,0.0016778571428571428,239596543.2099995,0.0005500000000000019,13.065610859728505,-39.51612903225807,60.48387096774193,65.25932953826693,0.02012,0.019994807600747865,0.01998714285714286,0.019941189694961146,0.019293499999999998,0.01945923021633882,12730.0,51137002.73333334,25510.0,44017515.07142856
2020-05-26,0.02273,0.02592,0.02205,0.02386,97604803.3,10901.0,52334836.4,0.022136666666666666,0.020800000000000003,0.019708999999999997,0.022568701900186967,0.021411919203415647,0.02014553766008688,74.89643744821873,0.02302246789239049,0.016395532107609505,0.0009668256832738135,0.0006805305183440248,0.0002862951649297888,0.0038699999999999984,0.0019414285714285714,422772256.6099995,0.0023,33.66946778711484,-25.152625152625145,74.84737484737487,76.17581611558745,4.971403431588206,0.01999,0.02299,0.01967,0.02256,85570910.1,9473.0,45082449.1,12.85642821410705,73.99141630901289,0.022152902743447164,0.01673109725655284,0.0007294932136010061,0.0006089567271115776,0.00012053648648942857,0.00332,0.0017821428571428571,325167453.30999947,0.0030600000000000002,32.94048320565706,-6.803797468354428,93.19620253164557,73.03443865570209,0.02086,0.021277403800373934,0.02032,0.02059589227122086,0.019442,0.01975454162430655,18318.0,49562214.33333334,32424.0,46376400.74285714
2020-05-27,0.0238,0.02389,0.02168,0.02294,44470869.3,4408.0,23523385.5,0.02312,0.021267142857142856,0.019953000000000002,0.022754350950093483,0.021793939402561736,0.020411676930554797,67.91226645004062,0.023467781418704557,0.016438218581295447,0.0010683616560001052,0.0007580967458752409,0.00031026491012486434,0.00221,0.0020028571428571426,378301387.30999947,0.0023599999999999975,23.79924446842956,-39.107611548556434,60.89238845144356,76.31198861015467,-3.6134453781512734,0.02273,0.02592,0.02205,0.02386,97604803.3,10901.0,52334836.4,4.971403431588206,74.89643744821873,0.02302246789239049,0.016395532107609505,0.0009668256832738135,0.0006805305183440248,0.0002862951649297888,0.0038699999999999984,0.0019414285714285714,422772256.6099995,0.0023,33.66946778711484,-25.152625152625145,74.84737484737487,76.17581611558745,0.022136666666666666,0.022568701900186967,0.020800000000000003,0.021411919203415647,0.019708999999999997,0.02014553766008688,26041.0,47605523.30000001,40542.0,48281032.67142856
2020-05-28,0.02287,0.023,0.02102,0.02211,45284088.2,4358.0,25482296.4,0.02297,0.021690000000000004,0.020114,0.022432175475046744,0.021872954551921304,0.020573421984787673,60.91578086672119,0.02371763208593001,0.01651036791406999,0.0010695267439651476,0.0008203827454932223,0.0002491439984719253,0.001979999999999999,0.0020599999999999998,333017299.1099995,0.0018799999999999997,13.734567901234573,-50.065703022339,49.934296977661,61.89135342549315,-3.3231307389593367,0.0238,0.02389,0.02168,0.02294,44470869.3,4408.0,23523385.5,-3.6134453781512734,67.91226645004062,0.023467781418704557,0.016438218581295447,0.0010683616560001052,0.0007580967458752409,0.00031026491012486434,0.00221,0.0020028571428571426,378301387.30999947,0.0023599999999999975,23.79924446842956,-39.107611548556434,60.89238845144356,76.31198861015467,0.02312,0.022754350950093483,0.021267142857142856,0.021793939402561736,0.019953000000000002,0.020411676930554797,24782.0,40313557.00000001,41173.0,46752091.371428564
2020-05-29,0.02211,0.02329,0.02183,0.02271,47400690.3,4158.0,31354637.0,0.022586666666666668,0.02202857142857143,0.02031,0.022571087737523372,0.02208221591394098,0.020776905605284085,62.5685199686766,0.02403480165493933,0.016585198345060673,0.0011061144710720547,0.0008775290906089888,0.0002285853804630659,0.001460000000000003,0.0020357142857142857,380417989.4099995,0.00221,16.46153846153846,-42.18134034165569,57.81865965834431,56.215115029149636,2.713704206241519,0.02287,0.023,0.02102,0.02211,45284088.2,4358.0,25482296.4,-3.3231307389593367,60.91578086672119,0.02371763208593001,0.01651036791406999,0.0010695267439651476,0.0008203827454932223,0.0002491439984719253,0.001979999999999999,0.0020599999999999998,333017299.1099995,0.0018799999999999997,13.734567901234573,-50.065703022339,49.934296977661,61.89135342549315,0.02297,0.022432175475046744,0.021690000000000004,0.021872954551921304,0.020114,0.020573421984787673,19667.0,33780172.76666667,41870.0,42833425.08571428
2020-05-30,0.02271,0.02395,0.022,0.02242,45248117.8,4654.0,27257635.0,0.02241333333333333,0.022369999999999998,0.020547,0.022495543868761687,0.022166661935455734,0.02093339078573322,53.90909090909091,0.02416898026676692,0.016925019733233078,0.0010990408729812072,0.0009218314470834326,0.00017720942589777462,0.0019500000000000003,0.001965,335169871.6099995,0.002749999999999999,3.9888682745825577,-45.99211563731932,54.00788436268068,53.92028033289534,-1.2769704975781684,0.02211,0.02329,0.02183,0.02271,47400690.3,4158.0,31354637.0,2.713704206241519,62.5685199686766,0.02403480165493933,0.016585198345060673,0.0011061144710720547,0.0008775290906089888,0.0002285853804630659,0.001460000000000003,0.0020357142857142857,380417989.4099995,0.00221,16.46153846153846,-42.18134034165569,57.81865965834431,56.215115029149636,0.022586666666666668,0.022571087737523372,0.02202857142857143,0.02208221591394098,0.02031,0.020776905605284085,12924.0,26786772.966666672,42143.0,40197399.75714285
2020-05-31,0.02239,0.02446,0.0215,0.02233,78604478.8,9189.0,42028990.0,0.022486666666666665,0.022704285714285715,0.020815,0.02241277193438084,0.022207496451591802,0.021066401187091962,58.65479723046488,0.02410010834559872,0.017529891654401282,0.0010737947106823215,0.0009522240998032104,0.00012157061087911107,0.002960000000000001,0.002030714285714286,256565392.80999947,0.003179999999999999,8.503401360544217,-47.174770039421816,52.82522996057819,54.883924660534404,-0.2679767753461413,0.02271,0.02395,0.022,0.02242,45248117.8,4654.0,27257635.0,-1.2769704975781684,53.90909090909091,0.02416898026676692,0.016925019733233078,0.0010990408729812072,0.0009218314470834326,0.00017720942589777462,0.0019500000000000003,0.001965,335169871.6099995,0.002749999999999999,3.9888682745825577,-45.99211563731932,54.00788436268068,53.92028033289534,0.02241333333333333,0.022495543868761687,0.022369999999999998,0.022166661935455734,0.020547,0.02093339078573322,13170.0,28031522.80000001,43619.0,35776360.54285713
2020-06-01,0.02214,0.02452,0.02214,0.02372,34282841.6,4865.0,18206813.4,0.022823333333333334,0.022869999999999998,0.0211085,0.02306638596719042,0.022585622338693854,0.021319124883559394,65.65022421524662,0.024326431830131678,0.01789056816986832,0.0011526611680187267,0.0009923115134463137,0.00016034965457241293,0.00238,0.002138571428571429,290848234.4099995,0.003380000000000001,17.251606524962916,-28.90932982917211,71.09067017082789,59.307928164695596,7.136404697380313,0.02239,0.02446,0.0215,0.02233,78604478.8,9189.0,42028990.0,-0.2679767753461413,58.65479723046488,0.02410010834559872,0.017529891654401282,0.0010737947106823215,0.0009522240998032104,0.00012157061087911107,0.002960000000000001,0.002030714285714286,256565392.80999947,0.003179999999999999,8.503401360544217,-47.174770039421816,52.82522996057819,54.883924660534404,0.022486666666666665,0.02241277193438084,0.022704285714285715,0.022207496451591802,0.020815,0.021066401187091962,18001.0,33547087.333333343,47141.0,35294889.91428571
2020-06-02,0.02372,0.0252,0.02066,0.02303,43055629.8,5077.0,27666135.0,0.023026666666666668,0.02275142857142857,0.0213335,0.023048192983595207,0.02269671675402039,0.02148206537083945,60.933448573898005,0.02441886972112029,0.018248130278879705,0.0011462726526211102,0.0010231037412812732,0.00012316891133983703,0.004539999999999999,0.002397857142857143,247792604.60999948,0.002999999999999999,12.341463414634134,-37.97634691195796,62.02365308804204,61.97985107314938,-2.9089376053963028,0.02214,0.02452,0.02214,0.02372,34282841.6,4865.0,18206813.4,7.136404697380313,65.65022421524662,0.024326431830131678,0.01789056816986832,0.0011526611680187267,0.0009923115134463137,0.00016034965457241293,0.00238,0.002138571428571429,290848234.4099995,0.003380000000000001,17.251606524962916,-28.90932982917211,71.09067017082789,59.307928164695596,0.022823333333333334,0.02306638596719042,0.022869999999999998,0.022585622338693854,0.0211085,0.021319124883559394,18708.0,29164479.466666672,42533.0,31455513.38571428
2020-06-03,0.02294,0.02498,0.02294,0.02496,38436432.1,4699.0,24466263.0,0.023903333333333332,0.02304,0.021609499999999997,0.024004096491797605,0.02326253756551529,0.021813297240283316,70.87608524072613,0.024958036050937275,0.01826096394906272,0.001282164583262621,0.0010749159096775428,0.00020724867358507828,0.00204,0.0024042857142857143,286229036.7099995,0.004969999999999999,26.89374682257244,-12.614980289093289,87.3850197109067,73.49978098992555,8.805579773321712,0.02372,0.0252,0.02066,0.02303,43055629.8,5077.0,27666135.0,-2.9089376053963028,60.933448573898005,0.02441886972112029,0.018248130278879705,0.0011462726526211102,0.0010231037412812732,0.00012316891133983703,0.004539999999999999,0.002397857142857143,247792604.60999948,0.002999999999999999,12.341463414634134,-37.97634691195796,62.02365308804204,61.97985107314938,0.023026666666666668,0.023048192983595207,0.02275142857142857,0.02269671675402039,0.0213335,0.02148206537083945,19131.0,29300646.13333334,36709.0,27931413.18571428
2020-06-04,0.02495,0.025,0.02362,0.02452,32623501.1,3240.0,22350865.8,0.024169999999999997,0.023384285714285715,0.021860499999999998,0.024262048245898803,0.02357690317413647,0.022071078455494428,71.32644956314535,0.02529473307920721,0.018426266920792786,0.0013389213427878778,0.0011277169962996098,0.00021120434648826797,0.0013800000000000028,0.0023900000000000006,253605535.6099995,0.00196,28.041775456919062,-19.914651493598846,80.08534850640116,76.4980071017833,-1.7234468937875744,0.02294,0.02498,0.02294,0.02496,38436432.1,4699.0,24466263.0,8.805579773321712,70.87608524072613,0.024958036050937275,0.01826096394906272,0.001282164583262621,0.0010749159096775428,0.00020724867358507828,0.00204,0.0024042857142857143,286229036.7099995,0.004969999999999999,26.89374682257244,-12.614980289093289,87.3850197109067,73.49978098992555,0.023903333333333332,0.024004096491797605,0.02304,0.02326253756551529,0.021609499999999997,0.021813297240283316,14641.0,23446403.80000001,37000.0,28066109.971428566
2020-06-05,0.02449,0.02488,0.02396,0.02481,33313272.4,2033.0,24461452.2,0.02476333333333333,0.023684285714285713,0.022022999999999997,0.0245360241229494,0.023885177380602352,0.02233192812639972,69.11890504704874,0.025696587662763067,0.01834941233723693,0.0013912644296776022,0.0011804264829752085,0.00021083794670239374,0.0009200000000000007,0.0023150000000000007,286918808.0099995,0.0009499999999999995,21.976401179940996,-15.789473684210527,84.21052631578947,83.89363151103244,1.3066557778685068,0.02495,0.025,0.02362,0.02452,32623501.1,3240.0,22350865.8,-1.7234468937875744,71.32644956314535,0.02529473307920721,0.018426266920792786,0.0013389213427878778,0.0011277169962996098,0.00021120434648826797,0.0013800000000000028,0.0023900000000000006,253605535.6099995,0.00196,28.041775456919062,-19.914651493598846,80.08534850640116,76.4980071017833,0.024169999999999997,0.024262048245898803,0.023384285714285715,0.02357690317413647,0.021860499999999998,0.022071078455494428,13016.0,24827754.60000001,35882.0,27618762.74285714
2020-06-06,0.02481,0.02799,0.02424,0.02799,43027911.7,4663.0,24255122.8,0.025773333333333332,0.024480000000000002,0.0223935,0.026263012061474703,0.024911383035451765,0.022870792114361653,77.33516483516483,0.026862807140486607,0.017924192859513393,0.0016700943190678143,0.0012783600501937297,0.0003917342688740846,0.00375,0.002490714285714286,329946719.7099995,0.005050000000000002,39.74038941587619,-0.0,100.0,88.0986249407302,12.817412333736405,0.02449,0.02488,0.02396,0.02481,33313272.4,2033.0,24461452.2,1.3066557778685068,69.11890504704874,0.025696587662763067,0.01834941233723693,0.0013912644296776022,0.0011804264829752085,0.00021083794670239374,0.0009200000000000007,0.0023150000000000007,286918808.0099995,0.0009499999999999995,21.976401179940996,-15.789473684210527,84.21052631578947,83.89363151103244,0.02476333333333333,0.0245360241229494,0.023684285714285713,0.023885177380602352,0.022022999999999997,0.02233192812639972,9972.0,23759527.00000001,33757.0,26634022.057142854
2020-06-07,0.02799,0.02993,0.02636,0.02752,73767296.8,10848.0,34898485.1,0.026773333333333333,0.025221428571428568,0.022757999999999997,0.026891506030737353,0.025563537276588826,0.02331357381775578,75.11674449633088,0.027653173132813035,0.01786282686718696,0.0018320254937288886,0.0013890931389007617,0.000442932354828127,0.003569999999999997,0.002595,256179422.9099995,0.005409999999999998,37.668834417208586,-23.48927875243664,76.51072124756337,86.90708252111762,-1.679171132547344,0.02481,0.02799,0.02424,0.02799,43027911.7,4663.0,24255122.8,12.817412333736405,77.33516483516483,0.026862807140486607,0.017924192859513393,0.0016700943190678143,0.0012783600501937297,0.0003917342688740846,0.00375,0.002490714285714286,329946719.7099995,0.005050000000000002,39.74038941587619,-0.0,100.0,88.0986249407302,0.025773333333333332,0.026263012061474703,0.024480000000000002,0.024911383035451765,0.0223935,0.022870792114361653,9936.0,23689146.93333334,33766.0,26205091.74285714
2020-06-08,0.02744,0.02975,0.02707,0.02709,46151345.6,4820.0,28789138.1,0.027533333333333337,0.025702857142857142,0.0230875,0.026990753015368678,0.025945152957441618,0.02367323345415999,67.62645914396886,0.028223936917819638,0.017951063082180363,0.0019037148699593172,0.0014920174851124728,0.00041169738484684443,0.0026799999999999984,0.0025492857142857144,210028077.3099995,0.0043799999999999985,20.079787234042556,-30.636461704422867,69.36353829557713,81.95808651438017,-1.2755102040816313,0.02799,0.02993,0.02636,0.02752,73767296.8,10848.0,34898485.1,-1.679171132547344,75.11674449633088,0.027653173132813035,0.01786282686718696,0.0018320254937288886,0.0013890931389007617,0.000442932354828127,0.003569999999999997,0.002595,256179422.9099995,0.005409999999999998,37.668834417208586,-23.48927875243664,76.51072124756337,86.90708252111762,0.026773333333333333,0.026891506030737353,0.025221428571428568,0.025563537276588826,0.022757999999999997,0.02331357381775578,17544.0,27871686.700000007,35425.0,25186448.185714282
2020-06-09,0.0271,0.02869,0.02588,0.02752,37160843.1,5028.0,18951960.4,0.02737666666666667,0.026344285714285716,0.02348,0.027255376507684337,0.026338864718081213,0.024039592172811416,65.27545909849749,0.028715622920783612,0.01824437707921639,0.0019724889981175206,0.0015881117877134825,0.00038437721040403814,0.00281,0.0024735714285714287,247188920.4099995,0.0051,15.339480301760267,-25.997842502696866,74.00215749730313,73.29213901348122,1.5498154981549823,0.02744,0.02975,0.02707,0.02709,46151345.6,4820.0,28789138.1,-1.2755102040816313,67.62645914396886,0.028223936917819638,0.017951063082180363,0.0019037148699593172,0.0014920174851124728,0.00041169738484684443,0.0026799999999999984,0.0025492857142857144,210028077.3099995,0.0043799999999999985,20.079787234042556,-30.636461704422867,69.36353829557713,81.95808651438017,0.027533333333333337,0.026990753015368678,0.025702857142857142,0.025945152957441618,0.0230875,0.02367323345415999,20331.0,29314248.666666675,35380.0,26698208.857142854
2020-06-10,0.02743,0.03,0.0269,0.02926,40708284.9,6244.0,25106646.5,0.027956666666666668,0.026958571428571425,0.0239855,0.02825768825384217,0.027069148538560912,0.0245367738706389,74.6875,0.02940970879510041,0.01856129120489959,0.0021426967737615023,0.0016990287849230866,0.0004436679888384157,0.0030999999999999986,0.0025371428571428567,287897205.30999947,0.006930000000000002,27.55013077593724,-7.922912205567428,92.07708779443257,78.48092786243761,6.671527524608099,0.0271,0.02869,0.02588,0.02752,37160843.1,5028.0,18951960.4,1.5498154981549823,65.27545909849749,0.028715622920783612,0.01824437707921639,0.0019724889981175206,0.0015881117877134825,0.00038437721040403814,0.00281,0.0024735714285714287,247188920.4099995,0.0051,15.339480301760267,-25.997842502696866,74.00215749730313,73.29213901348122,0.02737666666666667,0.027255376507684337,0.026344285714285716,0.026338864718081213,0.02348,0.024039592172811416,20696.0,27546527.866666675,35331.0,25453326.771428566
2020-06-11,0.02911,0.0312,0.025,0.02621,61499203.5,9473.0,30725847.1,0.02766333333333333,0.027200000000000002,0.024279000000000002,0.027233844126921085,0.026854361403920685,0.02469612874010186,63.648468708388805,0.02950425406082926,0.019053745939170745,0.0020083274039810126,0.001760888508734672,0.0002474388952463406,0.006199999999999997,0.0028385714285714286,226398001.80999947,0.002489999999999999,18.543645409317055,-47.343453510436426,52.656546489563574,72.91193059376643,-9.96221229817932,0.02743,0.03,0.0269,0.02926,40708284.9,6244.0,25106646.5,6.671527524608099,74.6875,0.02940970879510041,0.01856129120489959,0.0021426967737615023,0.0016990287849230866,0.0004436679888384157,0.0030999999999999986,0.0025371428571428567,287897205.30999947,0.006930000000000002,27.55013077593724,-7.922912205567428,92.07708779443257,78.48092786243761,0.027956666666666668,0.02825768825384217,0.026958571428571425,0.027069148538560912,0.0239855,0.0245367738706389,16092.0,24282581.66666667,36876.0,25544810.128571425
2020-06-12,0.02631,0.02875,0.02598,0.02755,34336356.5,3751.0,21112448.1,0.027673333333333338,0.027591428571428572,0.024655,0.02739192206346054,0.027028271052940516,0.024967926002949302,65.35532994923857,0.02967094300313894,0.01963905699686106,0.0019870599216289912,0.0018061227913135358,0.0001809371303154554,0.0027700000000000016,0.0029321428571428567,260734358.30999947,0.004520000000000003,21.31219726992515,-34.62998102466791,65.37001897533209,70.03455108644275,4.71303686811099,0.02911,0.0312,0.025,0.02621,61499203.5,9473.0,30725847.1,-9.96221229817932,63.648468708388805,0.02950425406082926,0.019053745939170745,0.0020083274039810126,0.001760888508734672,0.0002474388952463406,0.006199999999999997,0.0028385714285714286,226398001.80999947,0.002489999999999999,18.543645409317055,-47.343453510436426,52.656546489563574,72.91193059376643,0.02766333333333333,0.027233844126921085,0.027200000000000002,0.026854361403920685,0.024279000000000002,0.02469612874010186,20745.0,24928151.33333334,43109.0,26741236.028571423
2020-06-13,0.02748,0.02981,0.02659,0.02961,36565943.4,4350.0,22688898.5,0.02779,0.027822857142857142,0.025136000000000002,0.02850096103173027,0.027673703289705386,0.0254100282883827,70.50770108385623,0.03011323406598283,0.020158765934017175,0.0021120832910497336,0.0018673148912607754,0.00024476839978895826,0.0032200000000000006,0.0030228571428571427,297300301.70999944,0.004650000000000001,32.06958073148976,-15.085388994307383,84.91461100569262,67.64705882352943,7.751091703056769,0.02631,0.02875,0.02598,0.02755,34336356.5,3751.0,21112448.1,4.71303686811099,65.35532994923857,0.02967094300313894,0.01963905699686106,0.0019870599216289912,0.0018061227913135358,0.0001809371303154554,0.0027700000000000016,0.0029321428571428567,260734358.30999947,0.004520000000000003,21.31219726992515,-34.62998102466791,65.37001897533209,70.03455108644275,0.027673333333333338,0.02739192206346054,0.027591428571428572,0.027028271052940516,0.024655,0.024967926002949302,19468.0,25648313.900000006,44827.0,26262806.871428568
2020-06-14,0.02962,0.03122,0.028,0.02905,39516383.8,5736.0,23961538.1,0.02873666666666667,0.028041428571428575,0.025460500000000004,0.028775480515865134,0.028017777467279036,0.02575669226091768,68.66666666666666,0.03057495207233494,0.02034604792766507,0.0021412943834329366,0.0019221107896952078,0.00021918359373772887,0.0032200000000000006,0.003041428571428571,257783917.90999943,0.004529999999999999,30.094043887147336,-20.549242424242443,79.45075757575756,76.57846251892744,-1.9243754220121576,0.02748,0.02981,0.02659,0.02961,36565943.4,4350.0,22688898.5,7.751091703056769,70.50770108385623,0.03011323406598283,0.020158765934017175,0.0021120832910497336,0.0018673148912607754,0.00024476839978895826,0.0032200000000000006,0.0030228571428571427,297300301.70999944,0.004650000000000001,32.06958073148976,-15.085388994307383,84.91461100569262,67.64705882352943,0.02779,0.02850096103173027,0.027822857142857142,0.027673703289705386,0.025136000000000002,0.0254100282883827,17574.0,24842397.900000006,44514.0,26039060.542857137
2020-06-15,0.02903,0.02919,0.02606,0.02858,34782020.9,4426.0,19931399.6,0.029079999999999998,0.028254285714285714,0.0256965,0.028677740257932568,0.028158333100459274,0.026025578712258853,64.2271662763466,0.030934106022059704,0.020458893977940297,0.0021022854742353547,0.0019581457266032373,0.0001441397476321174,0.003130000000000001,0.0030949999999999997,223001897.00999942,0.0037700000000000025,20.489038785834744,-25.0,75.0,79.78845619381673,-1.5501205649328247,0.02962,0.03122,0.028,0.02905,39516383.8,5736.0,23961538.1,-1.9243754220121576,68.66666666666666,0.03057495207233494,0.02034604792766507,0.0021412943834329366,0.0019221107896952078,0.00021918359373772887,0.0032200000000000006,0.003041428571428571,257783917.90999943,0.004529999999999999,30.094043887147336,-20.549242424242443,79.45075757575756,76.57846251892744,0.02873666666666667,0.028775480515865134,0.028041428571428575,0.028017777467279036,0.025460500000000004,0.02575669226091768,13837.0,22587628.233333338,39402.0,24476639.54285714
2020-06-16,0.0287,0.03299,0.02861,0.03274,103523707.0,16281.0,52432245.2,0.030123333333333335,0.029,0.0261865,0.03070887012896628,0.029303749825344456,0.02666504740632944,73.62530413625304,0.03212504589681946,0.020247954103180546,0.0023796171211690406,0.002042440005516398,0.00033717711565264255,0.0043799999999999985,0.0030835714285714286,326525604.0099994,0.004749999999999997,42.16239687364307,-2.4875621890547284,97.51243781094527,83.98773179556763,14.076655052264803,0.02903,0.02919,0.02606,0.02858,34782020.9,4426.0,19931399.6,-1.5501205649328247,64.2271662763466,0.030934106022059704,0.020458893977940297,0.0021022854742353547,0.0019581457266032373,0.0001441397476321174,0.003130000000000001,0.0030949999999999997,223001897.00999942,0.0037700000000000025,20.489038785834744,-25.0,75.0,79.78845619381673,0.029079999999999998,0.028677740257932568,0.028254285714285714,0.028158333100459274,0.0256965,0.026025578712258853,14512.0,22193945.400000006,39008.0,23211248.328571428
2020-06-17,0.03272,0.03285,0.02959,0.03102,227887764.4,38750.0,110855321.7,0.030780000000000002,0.02925142857142857,0.026632,0.03086443506448314,0.029732812369008342,0.02707980479620283,64.89675516224187,0.03261954004493358,0.020644459955066415,0.002432573629494072,0.002120466730311933,0.00031210689918213883,0.0032599999999999955,0.003170714285714285,98637839.60999939,0.0034999999999999996,24.278846153846146,-21.02454642475987,78.97545357524012,83.82929712872847,-5.19559902200489,0.0287,0.03299,0.02861,0.03274,103523707.0,16281.0,52432245.2,14.076655052264803,73.62530413625304,0.03212504589681946,0.020247954103180546,0.0023796171211690406,0.002042440005516398,0.00033717711565264255,0.0043799999999999985,0.0030835714285714286,326525604.0099994,0.004749999999999997,42.16239687364307,-2.4875621890547284,97.51243781094527,83.98773179556763,0.030123333333333335,0.03070887012896628,0.029,0.029303749825344456,0.0261865,0.02666504740632944,26443.0,32108394.30000001,50261.0,27994146.15714285
2020-06-18,0.03102,0.03133,0.03008,0.03046,149889454.3,22921.0,74134714.4,0.031406666666666666,0.02985857142857143,0.027019500000000002,0.03066221753224157,0.029914609276756255,0.02740172814894542,64.51612903225806,0.0329410733151355,0.0210979266848645,0.002401669769868456,0.0021767073382232376,0.00022496243164521826,0.0012499999999999976,0.0031614285714285707,-51251614.69000062,0.0033700000000000015,24.22512234910277,-28.01771871539311,71.9822812846069,82.8233908902641,-1.805286911669884,0.03272,0.03285,0.02959,0.03102,227887764.4,38750.0,110855321.7,-5.19559902200489,64.89675516224187,0.03261954004493358,0.020644459955066415,0.002432573629494072,0.002120466730311933,0.00031210689918213883,0.0032599999999999955,0.003170714285714285,98637839.60999939,0.0034999999999999996,24.278846153846146,-21.02454642475987,78.97545357524012,83.82929712872847,0.030780000000000002,0.03086443506448314,0.02925142857142857,0.029732812369008342,0.026632,0.02707980479620283,59457.0,61072988.833333336,82767.0,40243956.89999999
2020-06-19,0.03044,0.03188,0.02923,0.0312,267590326.6,40219.0,134270738.8,0.03089333333333333,0.03038,0.027458500000000004,0.030931108766120784,0.030235956957567194,0.02776346832523633,65.27977044476327,0.033244611411247314,0.02167238858875269,0.0024091192272003084,0.002223189716018652,0.0001859295111816565,0.0026499999999999996,0.0032849999999999993,216338711.90999937,0.0036799999999999992,25.755743651753328,-20.457142857142863,79.54285714285714,76.83353066756807,2.4967148488830495,0.03102,0.03133,0.03008,0.03046,149889454.3,22921.0,74134714.4,-1.805286911669884,64.51612903225806,0.0329410733151355,0.0210979266848645,0.002401669769868456,0.0021767073382232376,0.00022496243164521826,0.0012499999999999976,0.0031614285714285707,-51251614.69000062,0.0033700000000000015,24.22512234910277,-28.01771871539311,71.9822812846069,82.8233908902641,0.031406666666666666,0.03066221753224157,0.02985857142857143,0.029914609276756255,0.027019500000000002,0.02740172814894542,77952.0,79140760.43333334,96215.0,46445223.65714286
2020-06-20,0.0312,0.03159,0.02991,0.03097,108132465.2,20148.0,52242956.4,0.030876666666666667,0.030574285714285717,0.027890499999999995,0.030950554383060394,0.030419467718175393,0.02806885229426144,58.29621380846326,0.03334504508694089,0.0224359549130591,0.002369153768104749,0.0022523825264358713,0.00011677124166887751,0.001680000000000001,0.003137142857142856,108206246.70999937,0.0017099999999999997,10.646659521257584,-25.281602002503107,74.7183979974969,75.41451214165365,-0.7371794871794795,0.03044,0.03188,0.02923,0.0312,267590326.6,40219.0,134270738.8,2.4967148488830495,65.27977044476327,0.033244611411247314,0.02167238858875269,0.0024091192272003084,0.002223189716018652,0.0001859295111816565,0.0026499999999999996,0.0032849999999999993,216338711.90999937,0.0036799999999999992,25.755743651753328,-20.457142857142863,79.54285714285714,76.83353066756807,0.03089333333333333,0.030931108766120784,0.03038,0.030235956957567194,0.027458500000000004,0.02776346832523633,101890.0,106420258.30000001,132683.0,62610693.75714285
2020-06-21,0.03099,0.03171,0.03065,0.03117,127210460.4,18226.0,67558677.7,0.031113333333333337,0.030877142857142856,0.028263,0.0310602771915302,0.030607100788631547,0.028364199694807968,60.316563029960435,0.0335327592075417,0.0229932407924583,0.002326797311342079,0.002267265483417113,5.953182792496625e-05,0.001060000000000002,0.002957857142857142,235416707.10999936,0.004959999999999999,13.263081395348841,-22.778473091364198,77.22152690863581,77.16092734966328,0.5808325266214895,0.0312,0.03159,0.02991,0.03097,108132465.2,20148.0,52242956.4,-0.7371794871794795,58.29621380846326,0.03334504508694089,0.0224359549130591,0.002369153768104749,0.0022523825264358713,0.00011677124166887751,0.001680000000000001,0.003137142857142856,108206246.70999937,0.0017099999999999997,10.646659521257584,-25.281602002503107,74.7183979974969,75.41451214165365,0.030876666666666667,0.030950554383060394,0.030574285714285717,0.030419467718175393,0.027890499999999995,0.02806885229426144,83288.0,86882803.2,148481.0,66832702.02857143
2020-06-22,0.03118,0.03235,0.03092,0.03128,184216780.2,27964.0,91079288.8,0.03114,0.03126285714285714,0.0286755,0.0311701385957651,0.03077532559147366,0.028641894961969117,62.061024755325285,0.03349266437666246,0.023858335623337543,0.0022758707732933522,0.002268986541392361,6.884231900991435e-06,0.0014299999999999972,0.0028685714285714282,419633487.30999935,0.0037300000000000007,15.4669619785899,-21.401752190237758,78.59824780976224,76.84605757196499,0.32071840923669936,0.03099,0.03171,0.03065,0.03117,127210460.4,18226.0,67558677.7,0.5808325266214895,60.316563029960435,0.0335327592075417,0.0229932407924583,0.002326797311342079,0.002267265483417113,5.953182792496625e-05,0.001060000000000002,0.002957857142857142,235416707.10999936,0.004959999999999999,13.263081395348841,-22.778473091364198,77.22152690863581,77.16092734966328,0.031113333333333337,0.0310602771915302,0.030877142857142856,0.030607100788631547,0.028263,0.028364199694807968,78593.0,84690790.96666667,160971.0,73060864.82857142
2020-06-23,0.03126,0.03155,0.02979,0.03004,355429505.9,48022.0,169293325.8,0.03083,0.030877142857142856,0.028929500000000004,0.03060506929788255,0.030591494193605243,0.028775047822733962,56.93069306930693,0.033448249128289496,0.02441075087171051,0.0021111178358102396,0.0022374128002759365,-0.00012629496446569686,0.0017600000000000011,0.002793571428571428,64203981.40999937,0.0004299999999999998,9.156976744186052,-36.92115143929911,63.0788485607009,72.96620775969966,-3.9027511196417217,0.03118,0.03235,0.03092,0.03128,184216780.2,27964.0,91079288.8,0.32071840923669936,62.061024755325285,0.03349266437666246,0.023858335623337543,0.0022758707732933522,0.002268986541392361,6.884231900991435e-06,0.0014299999999999972,0.0028685714285714282,419633487.30999935,0.0037300000000000007,15.4669619785899,-21.401752190237758,78.59824780976224,76.84605757196499,0.03114,0.0311701385957651,0.03126285714285714,0.03077532559147366,0.0286755,0.028641894961969117,66338.0,70293640.96666665,184509.0,83224849.0
2020-06-24,0.03005,0.0305,0.0285,0.02888,46671013.9,7784.0,21774448.2,0.03006666666666667,0.030571428571428576,0.029147500000000003,0.029742534648941277,0.030163620645203934,0.02878504326818787,48.92045454545455,0.03316323156475956,0.025131768435240447,0.0018654439635848938,0.002163019032937728,-0.00029757506935283425,0.0019999999999999983,0.0027149999999999995,17532967.509999372,-0.00017,-1.2987012987013102,-51.43929912390489,48.56070087609511,63.41259908218609,-3.8935108153078235,0.03126,0.03155,0.02979,0.03004,355429505.9,48022.0,169293325.8,-3.9027511196417217,56.93069306930693,0.033448249128289496,0.02441075087171051,0.0021111178358102396,0.0022374128002759365,-0.00012629496446569686,0.0017600000000000011,0.002793571428571428,64203981.40999937,0.0004299999999999998,9.156976744186052,-36.92115143929911,63.0788485607009,72.96620775969966,0.03083,0.03060506929788255,0.030877142857142856,0.030591494193605243,0.028929500000000004,0.028775047822733962,94212.0,109310430.76666665,216250.0,99919289.0857143
2020-06-25,0.02882,0.02889,0.02675,0.02803,23898792.3,4624.0,10312257.6,0.028983333333333333,0.03022428571428571,0.029308500000000005,0.028886267324470638,0.02963021548390295,0.02871313438550331,55.90909090909091,0.03281834944949222,0.025798650550507795,0.0015838995455897086,0.002047195135468124,-0.0004632955898784155,0.0021399999999999995,0.0024249999999999996,-6365824.790000629,-0.0005500000000000019,6.94391453643648,-70.75606276747504,29.243937232524964,46.96116222310699,-2.741151977793196,0.03005,0.0305,0.0285,0.02888,46671013.9,7784.0,21774448.2,-3.8935108153078235,48.92045454545455,0.03316323156475956,0.025131768435240447,0.0018654439635848938,0.002163019032937728,-0.00029757506935283425,0.0019999999999999983,0.0027149999999999995,17532967.509999372,-0.00017,-1.2987012987013102,-51.43929912390489,48.56070087609511,63.41259908218609,0.03006666666666667,0.029742534648941277,0.030571428571428576,0.030163620645203934,0.029147500000000003,0.02878504326818787,83770.0,94049020.93333334,185284.0,87193450.01428571
2020-06-26,0.02803,0.02845,0.02695,0.02742,15819810.8,2909.0,7635367.5,0.02811,0.02968428571428571,0.029279999999999994,0.02815313366223532,0.029077661612927214,0.02858997872974109,49.55691888207225,0.03284377091829718,0.0257162290817028,0.001296605206185051,0.0018970771496115094,-0.0006004719434264585,0.0014999999999999979,0.0023342857142857132,-22185635.59000063,-0.005319999999999998,-0.47186932849365704,-80.37518037518036,19.62481962481963,32.476485911146575,-2.1762397431323564,0.02882,0.02889,0.02675,0.02803,23898792.3,4624.0,10312257.6,-2.741151977793196,55.90909090909091,0.03281834944949222,0.025798650550507795,0.0015838995455897086,0.002047195135468124,-0.0004632955898784155,0.0021399999999999995,0.0024249999999999996,-6365824.790000629,-0.0005500000000000019,6.94391453643648,-70.75606276747504,29.243937232524964,46.96116222310699,0.028983333333333333,0.028886267324470638,0.03022428571428571,0.02963021548390295,0.029308500000000005,0.02871313438550331,60430.0,67126677.2,166987.0,78075956.18571427
2020-06-27,0.02745,0.02807,0.0251,0.02621,19558868.4,3462.0,9076138.1,0.027219999999999998,0.02900428571428571,0.029214499999999997,0.027181566831117658,0.02836074620969541,0.028363314088813363,37.698986975397965,0.0329580894680733,0.0254709105319267,0.0009602167043018008,0.0017097050605495677,-0.0007494883562477669,0.0029700000000000004,0.0023164285714285704,-41744503.99000063,-0.004809999999999998,-11.482607227288078,-85.93155893536122,14.068441064638787,20.979065973994466,-4.517304189435331,0.02803,0.02845,0.02695,0.02742,15819810.8,2909.0,7635367.5,-2.1762397431323564,49.55691888207225,0.03284377091829718,0.0257162290817028,0.001296605206185051,0.0018970771496115094,-0.0006004719434264585,0.0014999999999999979,0.0023342857142857132,-22185635.59000063,-0.005319999999999998,-0.47186932849365704,-80.37518037518036,19.62481962481963,32.476485911146575,0.02811,0.02815313366223532,0.02968428571428571,0.029077661612927214,0.029279999999999994,0.02858997872974109,15317.0,13240691.099999988,129677.0,59985188.85714286
2020-06-28,0.02621,0.02724,0.0255,0.02662,10866873.6,2285.0,5010986.6,0.02675,0.028354285714285717,0.029191,0.026900783415558828,0.02792555965727156,0.028197284175593043,41.11192392099488,0.03299613724770742,0.02538586275229258,0.0007184283714382622,0.0015114497227273066,-0.0007930213512890444,0.001740000000000002,0.002210714285714285,-30877630.390000626,-0.0038399999999999997,-8.364888123924263,-80.73510773130543,19.26489226869456,17.652717652717666,1.5642884395269003,0.02745,0.02807,0.0251,0.02621,19558868.4,3462.0,9076138.1,-4.517304189435331,37.698986975397965,0.0329580894680733,0.0254709105319267,0.0009602167043018008,0.0017097050605495677,-0.0007494883562477669,0.0029700000000000004,0.0023164285714285704,-41744503.99000063,-0.004809999999999998,-11.482607227288078,-85.93155893536122,14.068441064638787,20.979065973994466,0.027219999999999998,0.027181566831117658,0.02900428571428571,0.02836074620969541,0.029214499999999997,0.028363314088813363,10995.0,9007921.066666657,112991.0,53818500.52857143
2020-06-29,0.02662,0.02732,0.0259,0.02722,20607857.9,2356.0,13486155.7,0.026683333333333337,0.027774285714285717,0.029176,0.027060391707779415,0.027749169742953668,0.02810420949220323,45.07246376811594,0.03301111970583722,0.025340880294162784,0.0005686690978678188,0.001322893597755409,-0.0007542244998875903,0.0014200000000000011,0.002088571428571428,-10269772.490000628,-0.003979999999999997,-4.758572428271524,-73.13054499366285,26.86945500633715,20.067596113223505,2.2539444027047324,0.02621,0.02724,0.0255,0.02662,10866873.6,2285.0,5010986.6,1.5642884395269003,41.11192392099488,0.03299613724770742,0.02538586275229258,0.0007184283714382622,0.0015114497227273066,-0.0007930213512890444,0.001740000000000002,0.002210714285714285,-30877630.390000626,-0.0038399999999999997,-8.364888123924263,-80.73510773130543,19.26489226869456,17.652717652717666,0.02675,0.026900783415558828,0.028354285714285717,0.02792555965727156,0.029191,0.028197284175593043,8656.0,7240830.733333323,97050.0,44883116.08571429
2020-06-30,0.02725,0.02813,0.02634,0.02772,44787715.6,2946.0,35060922.5,0.027186666666666668,0.02744285714285714,0.029098999999999996,0.027390195853889708,0.02774187730721525,0.0280676181119934,25.2465483234714,0.032988472430764866,0.025209527569235127,0.0004847418140406304,0.0011552632410124534,-0.000670521426971823,0.00179,0.001903571428571428,34517943.10999937,-0.0032499999999999994,-15.332926084300535,-66.19354838709674,33.806451612903246,26.646932962644993,1.7247706422018412,0.02662,0.02732,0.0259,0.02722,20607857.9,2356.0,13486155.7,2.2539444027047324,45.07246376811594,0.03301111970583722,0.025340880294162784,0.0005686690978678188,0.001322893597755409,-0.0007542244998875903,0.0014200000000000011,0.002088571428571428,-10269772.490000628,-0.003979999999999997,-4.758572428271524,-73.13054499366285,26.86945500633715,20.067596113223505,0.026683333333333337,0.027060391707779415,0.027774285714285717,0.027749169742953668,0.029176,0.02810420949220323,8103.0,9191093.466666656,71442.0,33798382.78571428
2020-07-01,0.02765,0.02813,0.02732,0.02788,41507929.2,2378.0,34030162.5,0.027606666666666668,0.027299999999999998,0.0291825,0.02763509792694485,0.02777640798041144,0.02804974972037498,31.701631701631698,0.03287767964810713,0.02548732035189287,0.00042622622911573163,0.0010094558386331092,-0.0005832296095173775,0.0008099999999999982,0.0017285714285714283,76025872.30999938,-0.0032900000000000013,-10.12250161186331,-61.65517241379311,38.34482758620689,33.00691140181576,0.8318264014466458,0.02725,0.02813,0.02634,0.02772,44787715.6,2946.0,35060922.5,1.7247706422018412,25.2465483234714,0.032988472430764866,0.025209527569235127,0.0004847418140406304,0.0011552632410124534,-0.000670521426971823,0.00179,0.001903571428571428,34517943.10999937,-0.0032499999999999994,-15.332926084300535,-66.19354838709674,33.806451612903246,26.646932962644993,0.027186666666666668,0.027390195853889708,0.02744285714285714,0.02774187730721525,0.029098999999999996,0.0280676181119934,7587.0,17852688.266666654,26366.0,14622325.17142857
2020-07-02,0.02788,0.02989,0.0271,0.02895,48758278.1,6334.0,34210584.4,0.028183333333333335,0.027431428571428572,0.029252500000000004,0.028292548963472428,0.02806980598530858,0.028135487842244032,41.69416941694168,0.03286968631567568,0.02563531368432433,0.0004608795317629956,0.0008997405772590865,-0.00043886104549609086,0.002790000000000001,0.0018385714285714286,124784150.40999937,-0.002330000000000002,-4.957321076822064,-46.896551724137915,53.103448275862085,41.751575824990745,3.8378766140602636,0.02765,0.02813,0.02732,0.02788,41507929.2,2378.0,34030162.5,0.8318264014466458,31.701631701631698,0.03287767964810713,0.02548732035189287,0.00042622622911573163,0.0010094558386331092,-0.0005832296095173775,0.0008099999999999982,0.0017285714285714283,76025872.30999938,-0.0032900000000000013,-10.12250161186331,-61.65517241379311,38.34482758620689,33.00691140181576,0.027606666666666668,0.02763509792694485,0.027299999999999998,0.02777640798041144,0.0291825,0.02804974972037498,7680.0,27525746.89999999,20960.0,16373141.5
2020-07-03,0.02901,0.03166,0.02877,0.03069,59825760.9,9634.0,36130337.7,0.029173333333333332,0.027898571428571432,0.029306500000000003,0.02949127448173621,0.028724854488981433,0.02837877471441127,47.472745292368685,0.03297799632484685,0.025635003675153152,0.0006215807856118465,0.0008441086189296385,-0.00022252783331779208,0.00289,0.0018557142857142856,184609911.30999938,0.0006499999999999978,-1.63461538461539,-22.89655172413792,77.10344827586209,56.183908045977034,5.79110651499482,0.02788,0.02989,0.0271,0.02895,48758278.1,6334.0,34210584.4,3.8378766140602636,41.69416941694168,0.03286968631567568,0.02563531368432433,0.0004608795317629956,0.0008997405772590865,-0.00043886104549609086,0.002790000000000001,0.0018385714285714286,124784150.40999937,-0.002330000000000002,-4.957321076822064,-46.896551724137915,53.103448275862085,41.751575824990745,0.028183333333333335,0.028292548963472428,0.027431428571428572,0.02806980598530858,0.029252500000000004,0.028135487842244032,11658.0,34433889.79999999,22670.0,19787188.185714286
2020-07-04,0.0307,0.03145,0.0292,0.02968,44612215.8,3745.0,25991804.5,0.029773333333333332,0.028394285714285712,0.029337999999999996,0.029585637240868108,0.028963640866736074,0.028502700932086386,44.066237350505986,0.03301104032966749,0.025664959670332502,0.0006598329840904367,0.0008072534919617982,-0.0001474205078713615,0.0022499999999999985,0.0018964285714285713,139997695.5099994,0.0008000000000000021,-4.165321278656764,-36.827586206896505,63.17241379310349,64.45977011494256,-3.322475570032574,0.02901,0.03166,0.02877,0.03069,59825760.9,9634.0,36130337.7,5.79110651499482,47.472745292368685,0.03297799632484685,0.025635003675153152,0.0006215807856118465,0.0008441086189296385,-0.00022252783331779208,0.00289,0.0018557142857142856,184609911.30999938,0.0006499999999999978,-1.63461538461539,-22.89655172413792,77.10344827586209,56.183908045977034,0.029173333333333332,0.02949127448173621,0.027898571428571432,0.028724854488981433,0.029306500000000003,0.02837877471441127,18346.0,34790361.533333324,29395.0,23857898.214285713
2020-07-05,0.02968,0.03029,0.02782,0.02799,39659260.3,4079.0,26789896.7,0.02945333333333333,0.02859,0.029308499999999998,0.028787818620434055,0.028720230650052057,0.02845387227188768,37.13592233009708,0.03301648441491582,0.02560051558508417,0.0005474683762421509,0.0007552964688178688,-0.0002078280925757179,0.00247,0.0019971428571428566,100338435.2099994,-3.999999999999837e-05,-10.202117420596723,-60.13793103448274,39.86206896551727,60.04597701149428,-5.694070080862535,0.0307,0.03145,0.0292,0.02968,44612215.8,3745.0,25991804.5,-3.322475570032574,44.066237350505986,0.03301104032966749,0.025664959670332502,0.0006598329840904367,0.0008072534919617982,-0.0001474205078713615,0.0022499999999999985,0.0018964285714285713,139997695.5099994,0.0008000000000000021,-4.165321278656764,-36.827586206896505,63.17241379310349,64.45977011494256,0.029773333333333332,0.029585637240868108,0.028394285714285712,0.028963640866736074,0.029337999999999996,0.028502700932086386,19713.0,32110908.866666656,29678.0,26274421.985714287
2020-07-06,0.02794,0.0317,0.02769,0.03112,44336172.7,6043.0,26889995.7,0.02959666666666667,0.02914714285714286,0.0292275,0.029953909310217026,0.029320172987539042,0.028707789198374568,49.47984395318594,0.03268197307280466,0.025773026927195342,0.0007028810809052641,0.0007448133912353479,-4.1932310330083846e-05,0.00401,0.002181428571428571,144674607.9099994,0.0036999999999999984,-0.5115089514066584,-8.7878787878788,91.2121212121212,64.74886799024732,11.381531853972794,0.02968,0.03029,0.02782,0.02799,39659260.3,4079.0,26789896.7,-5.694070080862535,37.13592233009708,0.03301648441491582,0.02560051558508417,0.0005474683762421509,0.0007552964688178688,-0.0002078280925757179,0.00247,0.0019971428571428566,100338435.2099994,-3.999999999999837e-05,-10.202117420596723,-60.13793103448274,39.86206896551727,60.04597701149428,0.02945333333333333,0.028787818620434055,0.02859,0.028720230650052057,0.029308499999999998,0.02845387227188768,17458.0,29637346.299999993,31472.0,29385694.85714286
2020-07-07,0.03112,0.03246,0.03001,0.03214,47896583.3,8401.0,26498054.0,0.030416666666666665,0.029778571428571432,0.0292835,0.031046954655108514,0.030025129740654282,0.029034666417576988,56.92612137203167,0.03289314949460336,0.025673850505396643,0.0008980006520127697,0.0007754508433908323,0.00012254980862193732,0.0024500000000000043,0.002230714285714286,192571191.20999938,0.005930000000000001,6.990679094540608,-4.347826086956532,95.65217391304347,75.57545469689398,3.2776349614396003,0.02794,0.0317,0.02769,0.03112,44336172.7,6043.0,26889995.7,11.381531853972794,49.47984395318594,0.03268197307280466,0.025773026927195342,0.0007028810809052641,0.0007448133912353479,-4.1932310330083846e-05,0.00401,0.002181428571428571,144674607.9099994,0.0036999999999999984,-0.5115089514066584,-8.7878787878788,91.2121212121212,64.74886799024732,0.02959666666666667,0.029953909310217026,0.02914714285714286,0.029320172987539042,0.0292275,0.028707789198374568,13867.0,26557232.299999993,35159.0,31300529.14285714
2020-07-08,0.03208,0.0369,0.03046,0.0365,66564379.3,12799.0,35781324.2,0.033253333333333336,0.03101,0.029585499999999997,0.03377347732755426,0.03164384730549071,0.029745650568283943,70.75163398692811,0.03441436267531473,0.024756637324685263,0.0013884447529999878,0.0008980496253126635,0.0004903951276873244,0.006440000000000001,0.002547857142857143,259135570.5099994,0.009879999999999996,26.385041551246523,-3.3898305084746143,96.61016949152538,94.49148820556336,13.778054862842895,0.03112,0.03246,0.03001,0.03214,47896583.3,8401.0,26498054.0,3.2776349614396003,56.92612137203167,0.03289314949460336,0.025673850505396643,0.0008980006520127697,0.0007754508433908323,0.00012254980862193732,0.0024500000000000043,0.002230714285714286,192571191.20999938,0.005930000000000001,6.990679094540608,-4.347826086956532,95.65217391304347,75.57545469689398,0.030416666666666665,0.031046954655108514,0.029778571428571432,0.030025129740654282,0.0292835,0.029034666417576988,18523.0,26725982.133333325,40614.0,30077262.214285713
2020-07-09,0.0365,0.03652,0.03268,0.03538,52507333.5,10421.0,26186343.5,0.034673333333333334,0.031928571428571424,0.0297945,0.034576738663777126,0.03257788547911803,0.030282255276066424,69.72624798711757,0.03524004081217353,0.024348959187826473,0.0016675283676993759,0.001051945373790006,0.0006155829939093699,0.003839999999999996,0.0026692857142857143,206628237.0099994,0.00816,26.22190510167679,-12.881355932203393,87.11864406779661,93.12699582412183,-3.0684931506849207,0.03208,0.0369,0.03046,0.0365,66564379.3,12799.0,35781324.2,13.778054862842895,70.75163398692811,0.03441436267531473,0.024756637324685263,0.0013884447529999878,0.0008980496253126635,0.0004903951276873244,0.006440000000000001,0.002547857142857143,259135570.5099994,0.009879999999999996,26.385041551246523,-3.3898305084746143,96.61016949152538,94.49148820556336,0.033253333333333336,0.03377347732755426,0.03101,0.03164384730549071,0.029585499999999997,0.029745650568283943,27243.0,29723124.633333325,51035.0,30327428.17142857
2020-07-10,0.03542,0.0355,0.03246,0.03504,40944132.4,9570.0,25338470.5,0.035640000000000005,0.03255,0.029998000000000004,0.034808369331888564,0.03319341410933853,0.030735373821202956,70.75163398692813,0.03591250171413628,0.02408349828586373,0.0018400579419772523,0.0012095678874274552,0.000630490054549797,0.003039999999999994,0.0027792857142857137,165684104.6099994,0.00732,27.78993435448578,-15.76271186440678,84.23728813559322,89.32203389830507,-1.0728402032749813,0.0365,0.03652,0.03268,0.03538,52507333.5,10421.0,26186343.5,-3.0684931506849207,69.72624798711757,0.03524004081217353,0.024348959187826473,0.0016675283676993759,0.001051945373790006,0.0006155829939093699,0.003839999999999996,0.0026692857142857143,206628237.0099994,0.00816,26.22190510167679,-12.881355932203393,87.11864406779661,93.12699582412183,0.034673333333333334,0.034576738663777126,0.031928571428571424,0.03257788547911803,0.0297945,0.030282255276066424,31621.0,29488573.89999999,55122.0,29181108.042857144
2020-07-11,0.03493,0.03909,0.0342,0.0383,54714767.7,13075.0,31119025.3,0.03624,0.03378142857142857,0.0303545,0.03655418466594428,0.0344700605820039,0.03145581440965982,79.61783439490448,0.03733068648653701,0.023378313513462996,0.002214318344138235,0.0014105179787696114,0.0008038003653686237,0.0048899999999999985,0.0029164285714285707,220398872.3099994,0.010420000000000002,46.127432277756576,-5.813097866077991,94.18690213392202,88.5142781124373,9.647867162897217,0.03542,0.0355,0.03246,0.03504,40944132.4,9570.0,25338470.5,-1.0728402032749813,70.75163398692813,0.03591250171413628,0.02408349828586373,0.0018400579419772523,0.0012095678874274552,0.000630490054549797,0.003039999999999994,0.0027792857142857137,165684104.6099994,0.00732,27.78993435448578,-15.76271186440678,84.23728813559322,89.32203389830507,0.035640000000000005,0.034808369331888564,0.03255,0.03319341410933853,0.029998000000000004,0.030735373821202956,32790.0,29102046.06666666,55058.0,27639412.728571426
2020-07-12,0.03838,0.04326,0.03624,0.04318,67281844.3,15155.0,34034564.1,0.038840000000000006,0.03595142857142857,0.0309495,0.03986709233297214,0.03664754543650293,0.03257240351350174,83.27974276527334,0.039984234085749505,0.021914765914250497,0.0028715956581488317,0.0017027335146454555,0.0011688621435033762,0.0070199999999999985,0.003293571428571428,287680716.6099994,0.014230000000000003,62.20886551465063,-0.4608294930875388,99.53917050691247,92.65445359214259,12.50651380927568,0.03493,0.03909,0.0342,0.0383,54714767.7,13075.0,31119025.3,9.647867162897217,79.61783439490448,0.03733068648653701,0.023378313513462996,0.002214318344138235,0.0014105179787696114,0.0008038003653686237,0.0048899999999999985,0.0029164285714285707,220398872.3099994,0.010420000000000002,46.127432277756576,-5.813097866077991,94.18690213392202,88.5142781124373,0.03624,0.03655418466594428,0.03378142857142857,0.0344700605820039,0.0303545,0.03145581440965982,33066.0,27547946.433333322,64388.0,28371872.842857145
2020-07-13,0.04314,0.0495,0.04085,0.04705,124361042.5,28789.0,59070550.1,0.04284333333333334,0.038227142857142855,0.0318,0.043458546166486076,0.0392481590773772,0.03395122222650157,85.22202486678509,0.043331717359672006,0.020268282640327994,0.0036625497285770886,0.0020946967574317823,0.0015678529711453063,0.008650000000000005,0.00381,412041759.1099994,0.016360000000000003,72.85084496693608,-10.578583765112265,89.42141623488774,94.3824962919074,9.06351414000928,0.03838,0.04326,0.03624,0.04318,67281844.3,15155.0,34034564.1,12.50651380927568,83.27974276527334,0.039984234085749505,0.021914765914250497,0.0028715956581488317,0.0017027335146454555,0.0011688621435033762,0.0070199999999999985,0.003293571428571428,287680716.6099994,0.014230000000000003,62.20886551465063,-0.4608294930875388,99.53917050691247,92.65445359214259,0.038840000000000006,0.03986709233297214,0.03595142857142857,0.03664754543650293,0.0309495,0.03257240351350174,37800.0,30164019.966666657,75464.0,29406825.32857143
2020-07-14,0.04715,0.04913,0.0427,0.04591,58761985.3,13354.0,27967983.3,0.045380000000000004,0.04019428571428572,0.03265150000000001,0.044684273083243034,0.0409136193080329,0.035090153443025233,81.59083014935743,0.0456916974072962,0.019611302592703814,0.004149564459213738,0.0025056702977881732,0.0016438941614255647,0.006429999999999998,0.004141428571428571,353279773.8099994,0.016229999999999998,65.6204906204906,-16.026785714285722,83.97321428571428,90.97793367583817,-2.6299045599151603,0.04314,0.0495,0.04085,0.04705,124361042.5,28789.0,59070550.1,9.06351414000928,85.22202486678509,0.043331717359672006,0.020268282640327994,0.0036625497285770886,0.0020946967574317823,0.0015678529711453063,0.008650000000000005,0.00381,412041759.1099994,0.016360000000000003,72.85084496693608,-10.578583765112265,89.42141623488774,94.3824962919074,0.04284333333333334,0.043458546166486076,0.038227142857142855,0.0392481590773772,0.0318,0.03395122222650157,57019.0,41408046.49999999,98210.0,34004047.385714285
2020-07-15,0.0459,0.04892,0.04361,0.04875,50603253.6,12970.0,25091159.4,0.04723666666666667,0.04194428571428572,0.033687499999999995,0.04671713654162152,0.04287271448102468,0.03639109121035616,83.15856371147126,0.0483705340690841,0.01900446593091589,0.004710392929550555,0.0029466148241406496,0.0017637781054099058,0.005309999999999995,0.0044628571428571425,403883027.40999943,0.02076,74.8565279770445,-3.3482142857142883,96.65178571428571,90.0154720782959,6.209150326797381,0.04715,0.04913,0.0427,0.04591,58761985.3,13354.0,27967983.3,-2.6299045599151603,81.59083014935743,0.0456916974072962,0.019611302592703814,0.004149564459213738,0.0025056702977881732,0.0016438941614255647,0.006429999999999998,0.004141428571428571,353279773.8099994,0.016229999999999998,65.6204906204906,-16.026785714285722,83.97321428571428,90.97793367583817,0.045380000000000004,0.044684273083243034,0.04019428571428572,0.0409136193080329,0.03265150000000001,0.035090153443025233,57298.0,40357699.166666664,103163.0,34214037.28571428
2020-07-16,0.04871,0.055,0.04652,0.05205,93178508.3,24227.0,45007447.5,0.04890333333333333,0.04432571428571429,0.034919000000000006,0.04938356827081076,0.045167035860768506,0.037882415856988906,84.27299703264096,0.05140904535438495,0.018428954645615062,0.005359356626486227,0.003429163184609765,0.0019301934418764618,0.008480000000000001,0.004869285714285714,497061535.70999944,0.02093,79.79274611398964,-10.801904064445262,89.19809593555473,89.94103197851825,6.856908232395803,0.0459,0.04892,0.04361,0.04875,50603253.6,12970.0,25091159.4,6.209150326797381,83.15856371147126,0.0483705340690841,0.01900446593091589,0.004710392929550555,0.0029466148241406496,0.0017637781054099058,0.005309999999999995,0.0044628571428571425,403883027.40999943,0.02076,74.8565279770445,-3.3482142857142883,96.65178571428571,90.0154720782959,0.04723666666666667,0.04671713654162152,0.04194428571428572,0.04287271448102468,0.033687499999999995,0.03639109121035616,55113.0,37376564.26666666,103334.0,32686870.88571429
2020-07-17,0.05204,0.05441,0.04929,0.05088,50492554.7,11855.0,24933935.8,0.05056,0.04658857142857143,0.0361525,0.05013178413540538,0.04659527689557638,0.03912028101346615,80.47087232115908,0.053564558586241984,0.018740441413758007,0.00571339534486618,0.0038860096166610483,0.001827385728205132,0.0051199999999999996,0.005028571428571428,446568981.00999945,0.01874,65.78690127077225,-15.086049066276082,84.91395093372391,90.25461086118811,-2.229054573405075,0.04871,0.055,0.04652,0.05205,93178508.3,24227.0,45007447.5,6.856908232395803,84.27299703264096,0.05140904535438495,0.018428954645615062,0.005359356626486227,0.003429163184609765,0.0019301934418764618,0.008480000000000001,0.004869285714285714,497061535.70999944,0.02093,79.79274611398964,-10.801904064445262,89.19809593555473,89.94103197851825,0.04890333333333333,0.04938356827081076,0.04432571428571429,0.045167035860768506,0.034919000000000006,0.037882415856988906,50551.0,32688863.399999987,117140.0,35375600.02857143
2020-07-18,0.05093,0.05596,0.04916,0.05448,40854647.4,11036.0,21595354.2,0.05247000000000001,0.0489,0.037545499999999996,0.05230589206770269,0.04856645767168229,0.04058311139313604,84.71444568868982,0.05616254762054011,0.01892845237945988,0.006212845675849149,0.004351376828498669,0.0018614688473504804,0.0068000000000000005,0.005353571428571429,487423628.40999943,0.017980000000000003,83.55795148247978,-5.2352316943756705,94.76476830562433,89.62560505830099,6.970351462792062,0.05204,0.05441,0.04929,0.05088,50492554.7,11855.0,24933935.8,-2.229054573405075,80.47087232115908,0.053564558586241984,0.018740441413758007,0.00571339534486618,0.0038860096166610483,0.001827385728205132,0.0051199999999999996,0.005028571428571428,446568981.00999945,0.01874,65.78690127077225,-15.086049066276082,84.91395093372391,90.25461086118811,0.05056,0.05013178413540538,0.04658857142857143,0.04659527689557638,0.0361525,0.03912028101346615,49052.0,31677514.233333323,119425.0,35317809.35714286
2020-07-19,0.05446,0.05698,0.0533,0.05423,41456974.3,10081.0,19928229.9,0.05319666666666667,0.05047857142857143,0.038896,0.05326794603385135,0.04998234325376172,0.041882815069980234,88.27304550758461,0.05826283698328241,0.019529163016717584,0.006513408235156622,0.004783783109830259,0.0017296251253263624,0.0036800000000000027,0.00544,445966654.1099994,0.01885,93.74776705966417,-9.388869921474912,90.61113007852508,90.09661643929111,-0.42232831435916457,0.05093,0.05596,0.04916,0.05448,40854647.4,11036.0,21595354.2,6.970351462792062,84.71444568868982,0.05616254762054011,0.01892845237945988,0.006212845675849149,0.004351376828498669,0.0018614688473504804,0.0068000000000000005,0.005353571428571429,487423628.40999943,0.017980000000000003,83.55795148247978,-5.2352316943756705,94.76476830562433,89.62560505830099,0.05247000000000001,0.05230589206770269,0.0489,0.04856645767168229,0.037545499999999996,0.04058311139313604,47118.0,30512245.833333325,117386.0,33957284.91428571
2020-07-20,0.0541,0.05925,0.0519,0.0556,55886109.1,14226.0,28405984.6,0.054770000000000006,0.0517,0.040290000000000006,0.05443397301692567,0.051386757440321285,0.043189213634744025,87.63837638376384,0.06027346263657929,0.020306537363420727,0.006783952596606559,0.00518381700718552,0.0016001355894210388,0.007349999999999995,0.005678571428571429,501852763.20999944,0.020559999999999995,78.66323907455013,-12.482900136798907,87.5170998632011,90.96433274911685,2.7726432532347403,0.05446,0.05698,0.0533,0.05423,41456974.3,10081.0,19928229.9,-0.42232831435916457,88.27304550758461,0.05826283698328241,0.019529163016717584,0.006513408235156622,0.004783783109830259,0.0017296251253263624,0.0036800000000000027,0.00544,445966654.1099994,0.01885,93.74776705966417,-9.388869921474912,90.61113007852508,90.09661643929111,0.05319666666666667,0.05326794603385135,0.05047857142857143,0.04998234325376172,0.038896,0.041882815069980234,32972.0,22152506.63333332,112312.0,31942094.314285714
2020-07-21,0.0556,0.05671,0.04637,0.05648,110911716.3,25753.0,52809808.0,0.05543666666666667,0.05320999999999999,0.04172,0.05545698650846284,0.052660068080240964,0.04445500281238745,87.58492896849909,0.06205441055530671,0.021385589444693293,0.0069888069812569995,0.005544815001999816,0.0014439919792571835,0.010340000000000002,0.006242142857142857,612764479.5099994,0.01818,75.73117610454263,-9.621396318166013,90.378603681834,89.50227787452006,1.5827338129496507,0.0541,0.05925,0.0519,0.0556,55886109.1,14226.0,28405984.6,2.7726432532347403,87.63837638376384,0.06027346263657929,0.020306537363420727,0.006783952596606559,0.00518381700718552,0.0016001355894210388,0.007349999999999995,0.005678571428571429,501852763.20999944,0.020559999999999995,78.66323907455013,-12.482900136798907,87.5170998632011,90.96433274911685,0.054770000000000006,0.05443397301692567,0.0517,0.051386757440321285,0.040290000000000006,0.043189213634744025,35343.0,23309856.23333332,97749.0,27561442.099999998
2020-07-22,0.05629,0.05871,0.05316,0.05486,46757938.0,13020.0,24017938.4,0.05564666666666667,0.05408285714285714,0.0430155,0.05515849325423142,0.05321005106018072,0.04544595492549341,80.97165991902834,0.0632253959345267,0.0228056040654733,0.006940430137535765,0.005823938029107006,0.0011164921084287592,0.005549999999999999,0.006178571428571428,566006541.5099994,0.011679999999999996,50.301369863013704,-16.386711459499807,83.61328854050018,87.16966402851176,-2.5404157043879922,0.0556,0.05671,0.04637,0.05648,110911716.3,25753.0,52809808.0,1.5827338129496507,87.58492896849909,0.06205441055530671,0.021385589444693293,0.0069888069812569995,0.005544815001999816,0.0014439919792571835,0.010340000000000002,0.006242142857142857,612764479.5099994,0.01818,75.73117610454263,-9.621396318166013,90.378603681834,89.50227787452006,0.05543666666666667,0.05545698650846284,0.05320999999999999,0.052660068080240964,0.04172,0.04445500281238745,50060.0,33714674.16666666,110148.0,31110274.199999996
2020-07-23,0.05495,0.05518,0.05034,0.0531,54109165.6,13939.0,26457529.6,0.05481333333333333,0.054232857142857145,0.044135999999999995,0.05412924662711571,0.05318253829513554,0.04617491159925594,79.26023778071334,0.06394964909668338,0.024322350903316605,0.006683035970659737,0.005995757617417552,0.000687278353242185,0.004839999999999997,0.0062499999999999995,511897375.9099994,0.00605,50.084793668739394,-22.956326987681962,77.04367301231804,83.67852174488407,-3.3666969972702407,0.05629,0.05871,0.05316,0.05486,46757938.0,13020.0,24017938.4,-2.5404157043879922,80.97165991902834,0.0632253959345267,0.0228056040654733,0.006940430137535765,0.005823938029107006,0.0011164921084287592,0.005549999999999999,0.006178571428571428,566006541.5099994,0.011679999999999996,50.301369863013704,-16.386711459499807,83.61328854050018,87.16966402851176,0.05564666666666667,0.05515849325423142,0.05408285714285714,0.05321005106018072,0.0430155,0.04544595492549341,52999.0,35077910.33333332,110198.0,30956956.914285712
2020-07-24,0.0531,0.0531,0.0485,0.04941,37199953.9,9422.0,17916626.8,0.05245666666666667,0.05402285714285714,0.0451225,0.05176962331355786,0.05223940372135166,0.04648301525646966,71.36485280999108,0.06383997719730852,0.026405022802691483,0.0061108549456638794,0.0060187770830668185,9.207786259706092e-05,0.0046,0.006361428571428571,474697422.0099994,0.003500000000000003,41.010273972602754,-39.28143712574849,60.71856287425151,73.7918414756899,-6.949152542372879,0.05495,0.05518,0.05034,0.0531,54109165.6,13939.0,26457529.6,-3.3666969972702407,79.26023778071334,0.06394964909668338,0.024322350903316605,0.006683035970659737,0.005995757617417552,0.000687278353242185,0.004839999999999997,0.0062499999999999995,511897375.9099994,0.00605,50.084793668739394,-22.956326987681962,77.04367301231804,83.67852174488407,0.05481333333333333,0.05412924662711571,0.054232857142857145,0.05318253829513554,0.044135999999999995,0.04617491159925594,52712.0,34428425.33333332,99910.0,28306968.64285714
2020-07-25,0.04929,0.05655,0.04912,0.05028,54687687.7,16110.0,27381379.4,0.05093,0.05342285714285714,0.046237,0.051024811656778926,0.051749552791013745,0.0468446328510916,69.1741357234315,0.06323463958845849,0.029239360411541508,0.005662327305616825,0.00594748712757682,-0.00028515982195999497,0.007430000000000006,0.006542857142857143,529385109.7099994,0.0015299999999999966,31.279373368146214,-38.983050847457626,61.01694915254237,66.25972834637064,2.0085209981740673,0.0531,0.0531,0.0485,0.04941,37199953.9,9422.0,17916626.8,-6.949152542372879,71.36485280999108,0.06383997719730852,0.026405022802691483,0.0061108549456638794,0.0060187770830668185,9.207786259706092e-05,0.0046,0.006361428571428571,474697422.0099994,0.003500000000000003,41.010273972602754,-39.28143712574849,60.71856287425151,73.7918414756899,0.05245666666666667,0.05176962331355786,0.05402285714285714,0.05223940372135166,0.0451225,0.04648301525646966,36381.0,22797364.933333322,97477.0,27304495.92857143
2020-07-26,0.05027,0.05381,0.0488,0.05289,34447823.8,9965.0,18655062.3,0.050859999999999995,0.053231428571428575,0.0473255,0.051957405828389466,0.05203466459326031,0.04742038210336859,66.75871591301346,0.06298241974143243,0.03166858025856757,0.005454593943122789,0.005848908490686014,-0.00039431454756322544,0.005009999999999994,0.006399285714285714,563832933.5099994,0.0008400000000000005,22.487262621584048,-34.56521739130434,65.43478260869566,62.390098211829844,5.211855977720305,0.04929,0.05655,0.04912,0.05028,54687687.7,16110.0,27381379.4,2.0085209981740673,69.1741357234315,0.06323463958845849,0.029239360411541508,0.005662327305616825,0.00594748712757682,-0.00028515982195999497,0.007430000000000006,0.006542857142857143,529385109.7099994,0.0015299999999999966,31.279373368146214,-38.983050847457626,61.01694915254237,66.25972834637064,0.05093,0.051024811656778926,0.05342285714285714,0.051749552791013745,0.046237,0.0468446328510916,39471.0,23918511.933333322,102551.0,28131070.95714286
2020-07-27,0.05305,0.0666,0.0505,0.06221,134271597.1,35089.0,69414065.7,0.055126666666666664,0.054175714285714285,0.048829,0.057083702914194734,0.054578498444945237,0.048828917141143006,72.0220801859384,0.06411676311475333,0.03354123688524667,0.005973155052928059,0.005873757803134424,9.939724979363476e-05,0.016100000000000003,0.006931428571428572,698104530.6099994,0.01133,32.221041445270984,-18.3682008368201,81.63179916317989,69.36117697480597,17.266729500471257,0.05027,0.05381,0.0488,0.05289,34447823.8,9965.0,18655062.3,5.211855977720305,66.75871591301346,0.06298241974143243,0.03166858025856757,0.005454593943122789,0.005848908490686014,-0.00039431454756322544,0.005009999999999994,0.006399285714285714,563832933.5099994,0.0008400000000000005,22.487262621584048,-34.56521739130434,65.43478260869566,62.390098211829844,0.050859999999999995,0.051957405828389466,0.053231428571428575,0.05203466459326031,0.0473255,0.04742038210336859,35497.0,21317689.49999999,102435.0,27949189.871428575
2020-07-28,0.06235,0.07561,0.06097,0.07266,98879960.46,29163.0,53030317.66,0.06258666666666667,0.056487142857142854,0.050637,0.06487185145709737,0.05909887383370893,0.05109854408008177,80.58541047335925,0.06817303580000697,0.03310096419999303,0.007144983215277741,0.006128002885563088,0.001016980329714653,0.014639999999999993,0.007517857142857141,796984491.0699995,0.01818,58.26617294707037,-9.218749999999984,90.78125000000001,79.2826105906252,16.535685645549318,0.05305,0.0666,0.0505,0.06221,134271597.1,35089.0,69414065.7,17.266729500471257,72.0220801859384,0.06411676311475333,0.03354123688524667,0.005973155052928059,0.005873757803134424,9.939724979363476e-05,0.016100000000000003,0.006931428571428572,698104530.6099994,0.01133,32.221041445270984,-18.3682008368201,81.63179916317989,69.36117697480597,0.055126666666666664,0.057083702914194734,0.054175714285714285,0.054578498444945237,0.048829,0.048828917141143006,61164.0,38483502.466666654,123298.0,33807487.17142857
2020-07-29,0.07249,0.075,0.06703,0.06878,57957644.7,15687.0,26835994.1,0.06788333333333334,0.05847571428571429,0.052307000000000006,0.06682592572854867,0.0615191553752817,0.05278249226293113,72.36989055170872,0.0700851593979558,0.03452884060204421,0.007672142223212351,0.006436830753092941,0.0012353114701194106,0.007969999999999991,0.007707857142857141,739026846.3699994,0.014549999999999993,41.08717948717946,-23.358413132694952,76.64158686730505,83.01821201016166,-5.117947303076293,0.06235,0.07561,0.06097,0.07266,98879960.46,29163.0,53030317.66,16.535685645549318,80.58541047335925,0.06817303580000697,0.03310096419999303,0.007144983215277741,0.006128002885563088,0.001016980329714653,0.014639999999999993,0.007517857142857141,796984491.0699995,0.01818,58.26617294707037,-9.218749999999984,90.78125000000001,79.2826105906252,0.06258666666666667,0.06487185145709737,0.056487142857142854,0.05909887383370893,0.050637,0.05109854408008177,74217.0,47033148.55333332,126708.0,33838988.55142857
2020-07-30,0.0688,0.07849,0.06727,0.07629,53048372.5,16652.0,27706083.5,0.07257666666666666,0.06178857142857143,0.0543695,0.07155796286427434,0.06521186653146127,0.055021302523604355,74.74479379338504,0.07325004356376776,0.03548895643623225,0.008596815038851013,0.0068688276102445555,0.0017279874286064579,0.011220000000000008,0.007903571428571428,792075218.8699994,0.02069,46.57060518731988,-6.849315068493174,93.15068493150682,86.85784059960396,10.88662790697674,0.07249,0.075,0.06703,0.06878,57957644.7,15687.0,26835994.1,-5.117947303076293,72.36989055170872,0.0700851593979558,0.03452884060204421,0.007672142223212351,0.006436830753092941,0.0012353114701194106,0.007969999999999991,0.007707857142857141,739026846.3699994,0.014549999999999993,41.08717948717946,-23.358413132694952,76.64158686730505,83.01821201016166,0.06788333333333334,0.06682592572854867,0.05847571428571429,0.0615191553752817,0.052307000000000006,0.05278249226293113,79939.0,49760125.819999985,129375.0,34241567.93714286
2020-07-31,0.07631,0.082,0.07133,0.07437,62861237.7,17925.0,31053973.2,0.07314666666666667,0.06535428571428571,0.05617300000000001,0.07296398143213717,0.06750139989859595,0.056864035616594415,73.61753468731149,0.0754766392532917,0.0368693607467083,0.009070142002227728,0.007309090488641191,0.0017610515135865375,0.010669999999999999,0.008299999999999998,729213981.1699994,0.017890000000000003,46.16745283018868,-21.414538310412567,78.58546168958743,82.79257782946644,-2.542261826759268,0.0688,0.07849,0.06727,0.07629,53048372.5,16652.0,27706083.5,10.88662790697674,74.74479379338504,0.07325004356376776,0.03548895643623225,0.008596815038851013,0.0068688276102445555,0.0017279874286064579,0.011220000000000008,0.007903571428571428,792075218.8699994,0.02069,46.57060518731988,-6.849315068493174,93.15068493150682,86.85784059960396,0.07257666666666666,0.07155796286427434,0.06178857142857143,0.06521186653146127,0.0543695,0.055021302523604355,61502.0,35857465.08666665,132088.0,34419932.779999994
2020-08-01,0.07418,0.079,0.07242,0.07495,34662380.5,10179.0,17662488.0,0.07520333333333334,0.06887857142857143,0.05776150000000001,0.0739569907160686,0.06936354992394697,0.05858650841501399,71.91179618925284,0.07777878650310872,0.03774421349689129,0.009383886580346494,0.007724049706982252,0.0016598368733642425,0.0065800000000000025,0.008284285714285713,763876361.6699994,0.020090000000000004,37.57342143906022,-19.78669660398541,80.2133033960146,83.98315000570294,1.0380156376381866,0.07631,0.082,0.07133,0.07437,62861237.7,17925.0,31053973.2,-2.542261826759268,73.61753468731149,0.0754766392532917,0.0368693607467083,0.009070142002227728,0.007309090488641191,0.0017610515135865375,0.010669999999999999,0.008299999999999998,729213981.1699994,0.017890000000000003,46.16745283018868,-21.414538310412567,78.58546168958743,82.79257782946644,0.07314666666666667,0.07296398143213717,0.06535428571428571,0.06750139989859595,0.05617300000000001,0.056864035616594415,50264.0,28532016.933333322,140591.0,36296696.55142857
2020-08-02,0.07495,0.07697,0.06476,0.07163,36539729.2,11088.0,17008913.7,0.07365,0.07155571428571428,0.0589905,0.0727934953580343,0.06993016244296023,0.059828745708822184,67.4768983527521,0.07925546117882085,0.03872553882117916,0.00925791567624755,0.008030822900835313,0.001227092775412237,0.012209999999999999,0.008893571428571428,727336632.4699993,0.018529999999999998,32.085561497326196,-29.104687061465068,70.89531293853493,76.56469267471232,-4.42961974649767,0.07418,0.079,0.07242,0.07495,34662380.5,10179.0,17662488.0,1.0380156376381866,71.91179618925284,0.07777878650310872,0.03774421349689129,0.009383886580346494,0.007724049706982252,0.0016598368733642425,0.0065800000000000025,0.008284285714285713,763876361.6699994,0.020090000000000004,37.57342143906022,-19.78669660398541,80.2133033960146,83.98315000570294,0.07520333333333334,0.0739569907160686,0.06887857142857143,0.06936354992394697,0.05776150000000001,0.05858650841501399,44756.0,25474181.56666666,134660.0,34908283.49428572
2020-08-03,0.07155,0.07669,0.0704,0.07168,24088072.2,7809.0,11919091.6,0.07275333333333334,0.07290857142857143,0.06027899999999999,0.07223674767901714,0.07036762183222017,0.06095743659369626,66.5910028889806,0.08031788525106698,0.04024011474893301,0.009057705814902256,0.008236199483648702,0.0008215063312535537,0.00628999999999999,0.008817857142857141,751424704.6699994,0.02226999999999999,28.920863309352505,-28.964355879876535,71.03564412012346,74.04808681822432,0.18169112508733926,0.07495,0.07697,0.06476,0.07163,36539729.2,11088.0,17008913.7,-4.42961974649767,67.4768983527521,0.07925546117882085,0.03872553882117916,0.00925791567624755,0.008030822900835313,0.001227092775412237,0.012209999999999999,0.008893571428571428,727336632.4699993,0.018529999999999998,32.085561497326196,-29.104687061465068,70.89531293853493,76.56469267471232,0.07365,0.0727934953580343,0.07155571428571428,0.06993016244296023,0.0589905,0.059828745708822184,39192.0,21908458.29999999,135783.0,34673119.40857143
2020-08-04,0.0722,0.07733,0.07104,0.07713,23620134.7,7634.0,12040391.8,0.07347999999999999,0.07354714285714285,0.06169800000000001,0.07468337383950857,0.07205821637416512,0.062497680727629956,69.47011125777861,0.08231052822921452,0.0410854717707855,0.009232382352994672,0.008435436057517898,0.0007969462954767748,0.00628999999999999,0.008528571428571425,775044839.3699994,0.026850000000000006,36.561614730878176,-14.53731343283582,85.46268656716418,75.79788120860752,6.828254847645435,0.07155,0.07669,0.0704,0.07168,24088072.2,7809.0,11919091.6,0.18169112508733926,66.5910028889806,0.08031788525106698,0.04024011474893301,0.009057705814902256,0.008236199483648702,0.0008215063312535537,0.00628999999999999,0.008817857142857141,751424704.6699994,0.02226999999999999,28.920863309352505,-28.964355879876535,71.03564412012346,74.04808681822432,0.07275333333333334,0.07223674767901714,0.07290857142857143,0.07036762183222017,0.06027899999999999,0.06095743659369626,29076.0,15530164.433333324,108503.0,26459551.68
2020-08-05,0.07717,0.088,0.07534,0.08762,50850557.85,17321.0,26201867.09,0.07881,0.07623857142857142,0.0634765,0.08115168691975429,0.07594866228062384,0.06489028256309377,76.46203554119548,0.08657248942172827,0.040380510578271744,0.010100833972833526,0.008768515640581023,0.0013323183322525023,0.01265999999999999,0.009036428571428569,825895397.2199994,0.034730000000000004,59.71563981042656,-0.9620253164556747,99.03797468354433,85.178768456944,13.541531683296618,0.0722,0.07733,0.07104,0.07713,23620134.7,7634.0,12040391.8,6.828254847645435,69.47011125777861,0.08231052822921452,0.0410854717707855,0.009232382352994672,0.008435436057517898,0.0007969462954767748,0.00628999999999999,0.008528571428571425,775044839.3699994,0.026850000000000006,36.561614730878176,-14.53731343283582,85.46268656716418,75.79788120860752,0.07347999999999999,0.07468337383950857,0.07354714285714285,0.07205821637416512,0.06169800000000001,0.062497680727629956,26531.0,13656132.366666658,86974.0,20603847.985714287
2020-08-06,0.08762,0.09816,0.0858,0.097,45937834.91,17133.0,22997608.91,0.08725,0.07919714285714285,0.0657825,0.08907584345987715,0.08121149671046787,0.06794835089041817,81.57364787111622,0.09250748525429461,0.03905751474570537,0.011414397675296048,0.00929769204752403,0.0021167056277720184,0.012359999999999996,0.009573571428571426,871833232.1299994,0.03479,82.67419962335217,-2.3358840112766703,97.66411598872334,94.05492574647728,10.70531842045195,0.07717,0.088,0.07534,0.08762,50850557.85,17321.0,26201867.09,13.541531683296618,76.46203554119548,0.08657248942172827,0.040380510578271744,0.010100833972833526,0.008768515640581023,0.0013323183322525023,0.01265999999999999,0.009036428571428569,825895397.2199994,0.034730000000000004,59.71563981042656,-0.9620253164556747,99.03797468354433,85.178768456944,0.07881,0.08115168691975429,0.07623857142857142,0.07594866228062384,0.0634765,0.06489028256309377,32764.0,16720450.163333321,88608.0,20513258.412857145
2020-08-07,0.097,0.101,0.0887,0.09591,46367163.12,16017.0,22423310.75,0.09351,0.08227428571428572,0.067854,0.09249292172993857,0.08488612253285091,0.07061136509133073,84.74297668858337,0.09718573413503842,0.03852226586496157,0.012226512853290378,0.0098834562086773,0.002343056644613078,0.012300000000000005,0.010123571428571426,825466069.0099994,0.023249999999999993,94.11050394656951,-9.750957854406153,90.24904214559385,95.65037760595385,-1.1237113402061933,0.08762,0.09816,0.0858,0.097,45937834.91,17133.0,22997608.91,10.70531842045195,81.57364787111622,0.09250748525429461,0.03905751474570537,0.011414397675296048,0.00929769204752403,0.0021167056277720184,0.012359999999999996,0.009573571428571426,871833232.1299994,0.03479,82.67419962335217,-2.3358840112766703,97.66411598872334,94.05492574647728,0.08725,0.08907584345987715,0.07919714285714285,0.08121149671046787,0.0657825,0.06794835089041817,42088.0,20413289.266666654,89089.0,19840619.185714286
2020-08-08,0.09584,0.09821,0.091,0.09248,33192274.9,10875.0,14919516.9,0.09512999999999999,0.08477857142857144,0.0697665,0.09248646086496928,0.08678459189963819,0.07269409222548971,80.36845135290731,0.10032046900740423,0.039212530992595765,0.012449833715214242,0.01039673170998469,0.0020531020052295523,0.007210000000000008,0.01010785714285714,792273794.1099994,0.023700000000000013,83.92999204455054,-16.321839080459768,83.67816091954023,90.53043968461914,-3.505843071786298,0.097,0.101,0.0887,0.09591,46367163.12,16017.0,22423310.75,-1.1237113402061933,84.74297668858337,0.09718573413503842,0.03852226586496157,0.012226512853290378,0.0098834562086773,0.002343056644613078,0.012300000000000005,0.010123571428571426,825466069.0099994,0.023249999999999993,94.11050394656951,-9.750957854406153,90.24904214559385,95.65037760595385,0.09351,0.09249292172993857,0.08227428571428572,0.08488612253285091,0.067854,0.07061136509133073,50471.0,23874262.24999999,87181.0,18607667.40714286
2020-08-09,0.09246,0.09505,0.087,0.09382,35141799.4,12013.0,16350897.8,0.09407,0.08794857142857145,0.07167749999999999,0.09315323043248463,0.08854344392472865,0.07470608344210974,80.00293212138982,0.10326424463825384,0.040090755361746146,0.012589816342474108,0.010835348636482575,0.0017544677059915335,0.008050000000000002,0.010324999999999999,827415593.5099994,0.017530000000000004,77.38702968425034,-14.217821782178227,85.78217821782177,86.56979376098529,1.4709063378758385,0.09584,0.09821,0.091,0.09248,33192274.9,10875.0,14919516.9,-3.505843071786298,80.36845135290731,0.10032046900740423,0.039212530992595765,0.012449833715214242,0.01039673170998469,0.0020531020052295523,0.007210000000000008,0.01010785714285714,792273794.1099994,0.023700000000000013,83.92999204455054,-16.321839080459768,83.67816091954023,90.53043968461914,0.09512999999999999,0.09248646086496928,0.08477857142857144,0.08678459189963819,0.0697665,0.07269409222548971,44025.0,20113478.85333332,87877.0,18215814.39285714
2020-08-10,0.09382,0.10788,0.0868,0.10691,47177466.44,19138.0,25242995.28,0.09773666666666668,0.09298142857142856,0.074199,0.10003161521624232,0.09313508294354648,0.07777312311428977,81.05029174770769,0.1086033674706102,0.0397946325293898,0.013600232174743515,0.011388325344134764,0.0022119068306087515,0.02108,0.010680714285714283,874593059.9499993,0.03254,71.85339977495579,-2.067789383926665,97.93221061607333,89.13084991781177,13.95224898742273,0.09246,0.09505,0.087,0.09382,35141799.4,12013.0,16350897.8,1.4709063378758385,80.00293212138982,0.10326424463825384,0.040090755361746146,0.012589816342474108,0.010835348636482575,0.0017544677059915335,0.008050000000000002,0.010324999999999999,827415593.5099994,0.017530000000000004,77.38702968425034,-14.217821782178227,85.78217821782177,86.56979376098529,0.09407,0.09315323043248463,0.08794857142857145,0.08854344392472865,0.07167749999999999,0.07470608344210974,38905.0,17897908.483333323,88802.0,18121812.12142857
2020-08-11,0.10651,0.109,0.089,0.09418,51457827.0,19006.0,25061595.89,0.09830333333333334,0.09541714285714287,0.076165,0.09710580760812115,0.09339631220765986,0.07933568281769074,64.48963102612441,0.11040971591970358,0.04192028408029641,0.013221381534216772,0.011754936582151165,0.0014664449520656077,0.020000000000000004,0.011063571428571428,823135232.9499993,0.019229999999999997,29.617396091384517,-33.499095840867994,66.500904159132,83.40509766434236,-11.576377804900943,0.09382,0.10788,0.0868,0.10691,47177466.44,19138.0,25242995.28,13.95224898742273,81.05029174770769,0.1086033674706102,0.0397946325293898,0.013600232174743515,0.011388325344134764,0.0022119068306087515,0.02108,0.010680714285714283,874593059.9499993,0.03254,71.85339977495579,-2.067789383926665,97.93221061607333,89.13084991781177,0.09773666666666668,0.10003161521624232,0.09298142857142856,0.09313508294354648,0.074199,0.07777312311428977,42026.0,18837803.326666657,100131.0,20025226.932857145
2020-08-12,0.09418,0.10084,0.089,0.09679,39390115.9,13213.0,18940547.9,0.09929333333333334,0.09672714285714286,0.0783495,0.09694790380406057,0.09424473415574489,0.08099799873981543,69.18755993971777,0.11196742534066717,0.04473157465933284,0.012982095345379974,0.012000368334796927,0.0009817270105830465,0.011840000000000003,0.01134,862525348.8499993,0.025160000000000002,40.72404768828149,-27.599457504520792,72.4005424954792,78.94455242356152,2.771289021023573,0.10651,0.109,0.089,0.09418,51457827.0,19006.0,25061595.89,-11.576377804900943,64.48963102612441,0.11040971591970358,0.04192028408029641,0.013221381534216772,0.011754936582151165,0.0014664449520656077,0.020000000000000004,0.011063571428571428,823135232.9499993,0.019229999999999997,29.617396091384517,-33.499095840867994,66.500904159132,83.40509766434236,0.09830333333333334,0.09710580760812115,0.09541714285714287,0.09339631220765986,0.076165,0.07933568281769074,50157.0,22218496.323333323,111503.0,21885398.945714287
2020-08-13,0.09679,0.10149,0.09205,0.09497,33096219.1,12577.0,15437553.4,0.09531333333333332,0.09643714285714286,0.0806275,0.09595895190203028,0.09442605061680867,0.08232866552649967,63.87815750371472,0.11209425430221445,0.04916074569778555,0.01250149111942088,0.01210059289172172,0.0004008982276991601,0.00943999999999999,0.01121285714285714,829429129.7499993,0.023290000000000005,24.485515794992786,-31.71338155515371,68.2866184448463,69.06268836648583,-1.8803595412749272,0.09418,0.10084,0.089,0.09679,39390115.9,13213.0,18940547.9,2.771289021023573,69.18755993971777,0.11196742534066717,0.04473157465933284,0.012982095345379974,0.012000368334796927,0.0009817270105830465,0.011840000000000003,0.01134,862525348.8499993,0.025160000000000002,40.72404768828149,-27.599457504520792,72.4005424954792,78.94455242356152,0.09929333333333334,0.09694790380406057,0.09672714285714286,0.09424473415574489,0.0783495,0.08099799873981543,51357.0,23081713.023333322,107395.0,20848067.632857144
2020-08-14,0.09493,0.11677,0.09302,0.11117,49111344.96,22212.0,24597901.64,0.10097666666666667,0.09861714285714286,0.083672,0.10356447595101514,0.09861203796260651,0.08507545928588064,72.55454768325569,0.11455288463418126,0.052791115365818736,0.013274789903989448,0.012335432294175266,0.0009393576098141818,0.023749999999999993,0.012147142857142856,878540474.7099993,0.03404,49.48231813903454,-10.76716016150739,89.23283983849261,76.64000025960604,17.107342252185827,0.09679,0.10149,0.09205,0.09497,33096219.1,12577.0,15437553.4,-1.8803595412749272,63.87815750371472,0.11209425430221445,0.04916074569778555,0.01250149111942088,0.01210059289172172,0.0004008982276991601,0.00943999999999999,0.01121285714285714,829429129.7499993,0.023290000000000005,24.485515794992786,-31.71338155515371,68.2866184448463,69.06268836648583,0.09531333333333332,0.09595895190203028,0.09643714285714286,0.09442605061680867,0.0806275,0.08232866552649967,44796.0,19813232.396666657,102839.0,19768059.70285714
2020-08-15,0.11093,0.11965,0.10522,0.11678,34890976.71,16336.0,16166049.71,0.10764,0.10208857142857143,0.0868665,0.11017223797550757,0.10315402847195487,0.08809493935389201,74.1484816995728,0.1175576592105014,0.056175340789498596,0.014176892485586012,0.012703724332457417,0.0014731681531285953,0.014430000000000012,0.012707857142857142,913431451.4199994,0.02915999999999999,55.810540360240154,-5.228639096374588,94.7713609036254,84.0969397289881,5.273595961417104,0.09493,0.11677,0.09302,0.11117,49111344.96,22212.0,24597901.64,17.107342252185827,72.55454768325569,0.11455288463418126,0.052791115365818736,0.013274789903989448,0.012335432294175266,0.0009393576098141818,0.023749999999999993,0.012147142857142856,878540474.7099993,0.03404,49.48231813903454,-10.76716016150739,89.23283983849261,76.64000025960604,0.10097666666666667,0.10356447595101514,0.09861714285714286,0.09861203796260651,0.083672,0.08507545928588064,48002.0,19658667.646666657,109034.0,20078715.544285715
2020-08-16,0.11648,0.15,0.11585,0.1361,63557184.56,30071.0,30465326.74,0.12135,0.10812857142857142,0.090561,0.12313611898775378,0.11139052135396615,0.09266684989161658,81.41506675762597,0.12615300791425726,0.054968992085742754,0.016263304565348705,0.013415640379035676,0.002847664186313029,0.03415,0.014274999999999998,976988635.9799993,0.039099999999999996,90.00418818930615,-17.462311557788944,82.53768844221105,88.84729639477636,16.844093406593405,0.11093,0.11965,0.10522,0.11678,34890976.71,16336.0,16166049.71,5.273595961417104,74.1484816995728,0.1175576592105014,0.056175340789498596,0.014176892485586012,0.012703724332457417,0.0014731681531285953,0.014430000000000012,0.012707857142857142,913431451.4199994,0.02915999999999999,55.810540360240154,-5.228639096374588,94.7713609036254,84.0969397289881,0.10764,0.11017223797550757,0.10208857142857143,0.10315402847195487,0.0868665,0.08809493935389201,51125.0,18733834.916666657,114495.0,20256791.66
2020-08-17,0.13609,0.165,0.1312,0.15761,76481915.05,39356.0,36684502.86,0.13683,0.11537142857142857,0.0948085,0.1403730594938769,0.12294539101547461,0.0988519118067007,84.62964455549286,0.14030356590945206,0.04931343409054795,0.019428518535928058,0.014618216010414152,0.004810302525513906,0.0338,0.01624,1053470551.0299993,0.061700000000000005,119.8800223214286,-7.865048957002988,92.13495104299702,89.81466679627783,15.813064883532965,0.11648,0.15,0.11585,0.1361,63557184.56,30071.0,30465326.74,16.844093406593405,81.41506675762597,0.12615300791425726,0.054968992085742754,0.016263304565348705,0.013415640379035676,0.002847664186313029,0.03415,0.014274999999999998,976988635.9799993,0.039099999999999996,90.00418818930615,-17.462311557788944,82.53768844221105,88.84729639477636,0.12135,0.12313611898775378,0.10812857142857142,0.11139052135396615,0.090561,0.09266684989161658,68619.0,23743092.696666658,132553.0,22273138.651428573
2020-08-18,0.15768,0.19,0.13594,0.15153,145578270.55,64730.0,72155550.44,0.1484133333333333,0.12356428571428571,0.098946,0.14595152974693845,0.13009154326160594,0.10386887258701492,79.83159582999198,0.14926921318500316,0.04862278681499684,0.021201965167738923,0.015934965841879107,0.005266999325859816,0.05406,0.019652142857142858,907892280.4799993,0.05904999999999999,96.46052119797743,-33.551369265654984,66.44863073434502,80.37375673985103,-3.900304414003038,0.13609,0.165,0.1312,0.15761,76481915.05,39356.0,36684502.86,15.813064883532965,84.62964455549286,0.14030356590945206,0.04931343409054795,0.019428518535928058,0.014618216010414152,0.004810302525513906,0.0338,0.01624,1053470551.0299993,0.061700000000000005,119.8800223214286,-7.865048957002988,92.13495104299702,89.81466679627783,0.13683,0.1403730594938769,0.11537142857142857,0.12294539101547461,0.0948085,0.0988519118067007,85763.0,27771959.769999992,152771.0,23907639.734285712
2020-08-19,0.1514,0.1535,0.1222,0.12791,75689048.7,31264.0,34785162.3,0.14568333333333333,0.12800999999999998,0.101527,0.13693076487346922,0.12954615744620446,0.10615850376920397,64.61583109627801,0.15225104230114686,0.050802957698853145,0.020465583296163506,0.016841089332735988,0.003624493963427518,0.031299999999999994,0.020983571428571428,832203231.7799993,0.034089999999999995,45.98265236247432,-59.587332053742806,40.412667946257194,66.33208324119974,-15.515191545574645,0.15768,0.19,0.13594,0.15153,145578270.55,64730.0,72155550.44,-3.900304414003038,79.83159582999198,0.14926921318500316,0.04862278681499684,0.021201965167738923,0.015934965841879107,0.005266999325859816,0.05406,0.019652142857142858,907892280.4799993,0.05904999999999999,96.46052119797743,-33.551369265654984,66.44863073434502,80.37375673985103,0.1484133333333333,0.14595152974693845,0.12356428571428571,0.13009154326160594,0.098946,0.10386887258701492,134157.0,46435126.679999985,198495.0,30635347.527142856
2020-08-20,0.12792,0.143,0.11523,0.118,77938755.8,27766.0,36517108.2,0.13248000000000001,0.1313,0.10370850000000001,0.1274653824367346,0.12665961808465334,0.10728626531499406,57.58889852558542,0.15325398883814387,0.054163011161856144,0.018864878601383167,0.017245847186465425,0.0016190314149177425,0.02776999999999999,0.022084285714285716,754264475.9799993,0.011089999999999989,21.649484536082465,-69.76744186046513,30.232558139534877,45.69795227337903,-7.754846779237032,0.1514,0.1535,0.1222,0.12791,75689048.7,31264.0,34785162.3,-15.515191545574645,64.61583109627801,0.15225104230114686,0.050802957698853145,0.020465583296163506,0.016841089332735988,0.003624493963427518,0.031299999999999994,0.020983571428571428,832203231.7799993,0.034089999999999995,45.98265236247432,-59.587332053742806,40.412667946257194,66.33208324119974,0.14568333333333333,0.13693076487346922,0.12800999999999998,0.12954615744620446,0.101527,0.10615850376920397,135350.0,47875071.86666665,216546.0,32898863.869999997
2020-08-21,0.11808,0.129,0.10495,0.10529,79674889.0,29556.0,36958183.2,0.11706666666666665,0.13046,0.1052255,0.1163776912183673,0.12131721356349001,0.10709614480880415,53.12708361114815,0.1528855074982889,0.05756549250171112,0.01638187773109792,0.017073053295391924,-0.0006911755642940026,0.024050000000000002,0.022923571428571425,674589586.9799993,0.011109999999999995,9.780002085288286,-82.08333333333334,17.916666666666657,29.520630917486244,-10.831639566395673,0.12792,0.143,0.11523,0.118,77938755.8,27766.0,36517108.2,-7.754846779237032,57.58889852558542,0.15325398883814387,0.054163011161856144,0.018864878601383167,0.017245847186465425,0.0016190314149177425,0.02776999999999999,0.022084285714285716,754264475.9799993,0.011089999999999989,21.649484536082465,-69.76744186046513,30.232558139534877,45.69795227337903,0.13248000000000001,0.1274653824367346,0.1313,0.12665961808465334,0.10370850000000001,0.10728626531499406,123760.0,47819273.64666665,231735.0,35910228.84142857
2020-08-22,0.10546,0.13257,0.09625,0.12928,90381178.9,32978.0,45856683.3,0.11752333333333333,0.13224571428571427,0.10810800000000001,0.12282884560918365,0.12330791017261751,0.10920889292225137,60.78925765216371,0.1541589962632972,0.06205700373670282,0.016163550807300683,0.016891152797773677,-0.0007276019904729931,0.03631999999999999,0.02500285714285714,764970765.8799993,0.032490000000000005,39.79238754325258,-58.837209302325576,41.162790697674424,29.77067183462532,22.58676275365068,0.11808,0.129,0.10495,0.10529,79674889.0,29556.0,36958183.2,-10.831639566395673,53.12708361114815,0.1528855074982889,0.05756549250171112,0.01638187773109792,0.017073053295391924,-0.0006911755642940026,0.024050000000000002,0.022923571428571425,674589586.9799993,0.011109999999999995,9.780002085288286,-82.08333333333334,17.916666666666657,29.520630917486244,0.11706666666666665,0.1163776912183673,0.13046,0.12131721356349001,0.1052255,0.10709614480880415,88586.0,36086817.89999999,239079.0,37675983.35
2020-08-23,0.12913,0.13318,0.11067,0.11671,48356193.7,18646.0,21702479.9,0.11709333333333333,0.1294757142857143,0.11035949999999999,0.11976942280459182,0.12165843262946313,0.10992328407251314,56.29641855091599,0.1532029307314693,0.06751606926853068,0.014805561897689723,0.016474034617756886,-0.0016684727200671629,0.02250999999999999,0.02603571428571428,716614572.1799992,0.021739999999999995,24.397782988701767,-71.01744186046513,28.982558139534873,29.35400516795865,-9.618214202741424,0.10546,0.13257,0.09625,0.12928,90381178.9,32978.0,45856683.3,22.58676275365068,60.78925765216371,0.1541589962632972,0.06205700373670282,0.016163550807300683,0.016891152797773677,-0.0007276019904729931,0.03631999999999999,0.02500285714285714,764970765.8799993,0.032490000000000005,39.79238754325258,-58.837209302325576,41.162790697674424,29.77067183462532,0.11752333333333333,0.12282884560918365,0.13224571428571427,0.12330791017261751,0.10810800000000001,0.10920889292225137,90300.0,39777324.89999999,255721.0,41917502.43428571
2020-08-24,0.11651,0.13,0.1143,0.12526,36668890.8,14496.0,17404455.0,0.12375000000000001,0.12485428571428571,0.11276599999999999,0.12251471140229592,0.12255882447209734,0.11138392368465475,55.17688878857982,0.15308292417257227,0.07244907582742771,0.014254937402721712,0.01603021517474985,-0.001775277772028138,0.015700000000000006,0.02565142857142857,753283462.9799992,0.014090000000000005,17.16396969413525,-64.09900990099008,35.90099009900991,35.3487796454064,7.510084971247109,0.12913,0.13318,0.11067,0.11671,48356193.7,18646.0,21702479.9,-9.618214202741424,56.29641855091599,0.1532029307314693,0.06751606926853068,0.014805561897689723,0.016474034617756886,-0.0016684727200671629,0.02250999999999999,0.02603571428571428,716614572.1799992,0.021739999999999995,24.397782988701767,-71.01744186046513,28.982558139534873,29.35400516795865,0.11709333333333333,0.11976942280459182,0.1294757142857143,0.12165843262946313,0.11035949999999999,0.10992328407251314,81180.0,34839115.46666666,244296.0,40665667.17142857
2020-08-25,0.12526,0.12597,0.105,0.11393,51759330.6,19049.0,23880936.3,0.11863333333333333,0.11948285714285714,0.11408150000000002,0.11822235570114796,0.12040161835407301,0.11162640714325905,55.61622021270546,0.1526215162647126,0.07554148373528743,0.012757269352217188,0.01537562601024332,-0.0026183566580261323,0.020970000000000003,0.025720714285714284,701524132.3799992,-0.0028499999999999914,20.97048205563814,-75.3168316831683,24.68316831683169,29.855572185125492,-9.045186013092772,0.11651,0.13,0.1143,0.12526,36668890.8,14496.0,17404455.0,7.510084971247109,55.17688878857982,0.15308292417257227,0.07244907582742771,0.014254937402721712,0.01603021517474985,-0.001775277772028138,0.015700000000000006,0.02565142857142857,753283462.9799992,0.014090000000000005,17.16396969413525,-64.09900990099008,35.90099009900991,35.3487796454064,0.12375000000000001,0.12251471140229592,0.12485428571428571,0.12255882447209734,0.11276599999999999,0.11138392368465475,66120.0,28321206.06666665,219436.0,37911374.62
2020-08-26,0.11393,0.125,0.11046,0.11347,53309975.9,18016.0,25987914.8,0.11755333333333334,0.11742,0.11490500000000001,0.11584617785057398,0.11866871376555475,0.11180198741532962,54.80193459235375,0.15260286898905412,0.0772071310109459,0.0114018055593465,0.014580861920063956,-0.0031790563607174555,0.014539999999999997,0.025913571428571425,648214156.4799992,-0.022629999999999997,17.233185246409754,-78.13169984686064,21.86830015313935,27.484152856326986,-0.40375669270604936,0.12526,0.12597,0.105,0.11393,51759330.6,19049.0,23880936.3,-9.045186013092772,55.61622021270546,0.1526215162647126,0.07554148373528743,0.012757269352217188,0.01537562601024332,-0.0026183566580261323,0.020970000000000003,0.025720714285714284,701524132.3799992,-0.0028499999999999914,20.97048205563814,-75.3168316831683,24.68316831683169,29.855572185125492,0.11863333333333333,0.11822235570114796,0.11948285714285714,0.12040161835407301,0.11408150000000002,0.11162640714325905,52191.0,20995957.06666666,173755.0,31015001.17142857
2020-08-27,0.11384,0.11594,0.10074,0.10399,35939909.4,12814.0,16897509.4,0.11046333333333334,0.11541857142857144,0.11530900000000002,0.10991808892528698,0.11499903532416605,0.11105798861386966,52.487040917613314,0.15231661566005306,0.07830138433994699,0.009453658079925334,0.013555421152036232,-0.0041017630721108984,0.015200000000000005,0.026324999999999998,612274247.0799992,-0.05362,9.497736127198063,-88.68838935863064,11.311610641369349,19.287693037113467,-8.652494729444832,0.11393,0.125,0.11046,0.11347,53309975.9,18016.0,25987914.8,-0.40375669270604936,54.80193459235375,0.15260286898905412,0.0772071310109459,0.0114018055593465,0.014580861920063956,-0.0031790563607174555,0.014539999999999997,0.025913571428571425,648214156.4799992,-0.022629999999999997,17.233185246409754,-78.13169984686064,21.86830015313935,27.484152856326986,0.11755333333333334,0.11584617785057398,0.11742,0.11866871376555475,0.11490500000000001,0.11180198741532962,51561.0,22424435.366666656,160507.0,29758251.528571427
2020-08-28,0.10381,0.11085,0.10213,0.10736,21041207.8,8017.0,10215347.7,0.10827333333333333,0.11571428571428573,0.116053,0.1086390444626435,0.11308927649312454,0.11070579922207255,48.86950329357308,0.15170151755978956,0.08040448244021045,0.008088429620778562,0.012462022845784699,-0.004373593225006137,0.008720000000000006,0.02525142857142857,633315454.8799992,-0.04417,-3.4271835926958816,-88.14933333333333,11.85066666666666,15.010192487058456,3.4197090839032827,0.11384,0.11594,0.10074,0.10399,35939909.4,12814.0,16897509.4,-8.652494729444832,52.487040917613314,0.15231661566005306,0.07830138433994699,0.009453658079925334,0.013555421152036232,-0.0041017630721108984,0.015200000000000005,0.026324999999999998,612274247.0799992,-0.05362,9.497736127198063,-88.68838935863064,11.311610641369349,19.287693037113467,0.11046333333333334,0.10991808892528698,0.11541857142857144,0.11499903532416605,0.11530900000000002,0.11105798861386966,49879.0,22255453.49999999,145555.0,26955451.7
2020-08-29,0.10736,0.11587,0.106,0.1115,20282185.3,8052.0,10196562.0,0.10761666666666665,0.1131742857142857,0.116937,0.11006952223132174,0.1126919573698434,0.11078143739139898,48.41954022988506,0.151110471459292,0.08276352854070801,0.0072568867582472885,0.011420995628277218,-0.00416410887002993,0.009870000000000004,0.02492571428571428,653597640.1799991,-0.016409999999999994,-4.521322144202767,-83.73333333333333,16.266666666666666,13.142981324900894,3.856184798807754,0.10381,0.11085,0.10213,0.10736,21041207.8,8017.0,10215347.7,3.4197090839032827,48.86950329357308,0.15170151755978956,0.08040448244021045,0.008088429620778562,0.012462022845784699,-0.004373593225006137,0.008720000000000006,0.02525142857142857,633315454.8799992,-0.04417,-3.4271835926958816,-88.14933333333333,11.85066666666666,15.010192487058456,0.10827333333333333,0.1086390444626435,0.11571428571428573,0.11308927649312454,0.116053,0.11070579922207255,38847.0,17700257.299999993,124016.0,23135046.628571425
2020-08-30,0.11175,0.13,0.10798,0.12439,31635127.2,12816.0,16463172.6,0.11441666666666667,0.11427142857142857,0.117811,0.11722976111566087,0.11561646802738255,0.1120774909731705,46.354523379615216,0.15179831398005794,0.08382368601994206,0.007550955606597451,0.010646987623941265,-0.003096032017343814,0.022019999999999998,0.02405928571428571,685232767.3799992,0.006390000000000007,-8.60396767083027,-69.98400000000001,30.016,19.377777777777776,11.310961968680088,0.10736,0.11587,0.106,0.1115,20282185.3,8052.0,10196562.0,3.856184798807754,48.41954022988506,0.151110471459292,0.08276352854070801,0.0072568867582472885,0.011420995628277218,-0.00416410887002993,0.009870000000000004,0.02492571428571428,653597640.1799991,-0.016409999999999994,-4.521322144202767,-83.73333333333333,16.266666666666666,13.142981324900894,0.10761666666666665,0.11006952223132174,0.1131742857142857,0.1126919573698434,0.116937,0.11078143739139898,28883.0,12436473.033333322,99090.0,18040743.585714284
2020-08-31,0.1245,0.12934,0.11264,0.11328,31521103.4,14057.0,15851490.9,0.11639,0.11256,0.118766,0.11525488055783044,0.11503235102053691,0.11219201564239235,35.243991744890494,0.15098488455712514,0.08654711544287486,0.006809032845543045,0.009879396668261622,-0.003070363822718577,0.016700000000000007,0.022837857142857142,653711663.9799992,0.007990000000000011,-28.126387919548247,-81.83466666666666,18.165333333333336,21.48266666666667,-9.01204819277108,0.11175,0.13,0.10798,0.12439,31635127.2,12816.0,16463172.6,11.310961968680088,46.354523379615216,0.15179831398005794,0.08382368601994206,0.007550955606597451,0.010646987623941265,-0.003096032017343814,0.022019999999999998,0.02405928571428571,685232767.3799992,0.006390000000000007,-8.60396767083027,-69.98400000000001,30.016,19.377777777777776,0.11441666666666667,0.11722976111566087,0.11427142857142857,0.11561646802738255,0.117811,0.1120774909731705,28885.0,12291694.099999988,93260.0,17292271.114285715
2020-09-01,0.11328,0.11876,0.11,0.11023,35102852.3,13398.0,17124175.4,0.11596666666666666,0.11203142857142856,0.119438,0.11274244027891522,0.11383176326540269,0.11200515700978356,35.969561081668715,0.15025718582209685,0.08861881417790315,0.0059068536698389795,0.009084888068577093,-0.0031780343987381134,0.008760000000000004,0.019602142857142856,618608811.6799992,-0.01905000000000001,-27.255328977760186,-75.58078602620088,24.419213973799113,24.20018243571082,-2.6924435028248683,0.1245,0.12934,0.11264,0.11328,31521103.4,14057.0,15851490.9,-9.01204819277108,35.243991744890494,0.15098488455712514,0.08654711544287486,0.006809032845543045,0.009879396668261622,-0.003070363822718577,0.016700000000000007,0.022837857142857142,653711663.9799992,0.007990000000000011,-28.126387919548247,-81.83466666666666,18.165333333333336,21.48266666666667,0.11639,0.11525488055783044,0.11256,0.11503235102053691,0.118766,0.11219201564239235,34925.0,14170408.49999999,92821.0,17070419.1
2020-09-02,0.11029,0.11609,0.10145,0.10744,24363495.8,10724.0,11001277.5,0.11031666666666667,0.11117,0.1200615,0.1100912201394576,0.11223382244905201,0.11157038015170893,41.899485555995255,0.1492582894954599,0.09086471050454009,0.0049101394590185254,0.00824993834666538,-0.003339798887646855,0.01464,0.018412142857142856,594245315.8799993,-0.00927,-16.00343991869283,-76.06417112299467,23.935828877005335,22.17345872804593,-2.5840964729349944,0.11328,0.11876,0.11,0.11023,35102852.3,13398.0,17124175.4,-2.6924435028248683,35.969561081668715,0.15025718582209685,0.08861881417790315,0.0059068536698389795,0.009084888068577093,-0.0031780343987381134,0.008760000000000004,0.019602142857142856,618608811.6799992,-0.01905000000000001,-27.255328977760186,-75.58078602620088,24.419213973799113,24.20018243571082,0.11596666666666666,0.11274244027891522,0.11203142857142856,0.11383176326540269,0.119438,0.11200515700978356,40271.0,16479612.966666656,87170.0,16105167.542857142
2020-09-03,0.10745,0.11368,0.0912,0.0919,32599976.0,13470.0,15917163.6,0.10319,0.10944285714285715,0.119098,0.10099561006972879,0.10715036683678901,0.10969701061345094,40.112138202758,0.15070277685414174,0.08749322314585825,0.0028336238869054314,0.007166675454713391,-0.00433305156780796,0.02248,0.018034285714285715,561645339.8799993,-0.033360000000000015,-22.118644067796613,-98.3325393044307,1.667460695569301,16.674167848791253,-14.471847370870181,0.11029,0.11609,0.10145,0.10744,24363495.8,10724.0,11001277.5,-2.5840964729349944,41.899485555995255,0.1492582894954599,0.09086471050454009,0.0049101394590185254,0.00824993834666538,-0.003339798887646855,0.01464,0.018412142857142856,594245315.8799993,-0.00927,-16.00343991869283,-76.06417112299467,23.935828877005335,22.17345872804593,0.11031666666666667,0.1100912201394576,0.11117,0.11223382244905201,0.1200615,0.11157038015170893,38179.0,14658981.266666656,79878.0,13964219.357142856
2020-09-04,0.09172,0.095,0.07897,0.091,42432805.7,14772.0,20544697.2,0.09677999999999999,0.10710571428571428,0.11780900000000001,0.0959978050348644,0.10311277512759176,0.10791634293597943,44.05425647000084,0.1518228924558789,0.08379510754412112,0.0011026373402423933,0.0059538678318191915,-0.004851230491576798,0.016030000000000003,0.017461428571428572,519212534.1799993,-0.022930000000000006,-13.57203913002184,-77.80852241283895,22.19147758716104,15.931589053245228,-0.7849978194504997,0.10745,0.11368,0.0912,0.0919,32599976.0,13470.0,15917163.6,-14.471847370870181,40.112138202758,0.15070277685414174,0.08749322314585825,0.0028336238869054314,0.007166675454713391,-0.00433305156780796,0.02248,0.018034285714285715,561645339.8799993,-0.033360000000000015,-22.118644067796613,-98.3325393044307,1.667460695569301,16.674167848791253,0.10319,0.10099561006972879,0.10944285714285715,0.10715036683678901,0.119098,0.10969701061345094,37592.0,14680872.166666657,80534.0,13824169.957142856
2020-09-05,0.09071,0.09465,0.0635,0.07406,39251056.3,13442.0,18528811.8,0.08565333333333335,0.10175714285714287,0.114707,0.0850289025174322,0.09584958134569382,0.10469192932302901,25.59229137199435,0.15277191524529743,0.07664208475470258,-0.0016174533996245605,0.004439603585530441,-0.006057056985155002,0.031149999999999997,0.017092142857142858,479961477.8799993,-0.03941,-42.713490099009896,-84.84500574052812,15.154994259471874,13.004644180734074,-18.355197883364564,0.09172,0.095,0.07897,0.091,42432805.7,14772.0,20544697.2,-0.7849978194504997,44.05425647000084,0.1518228924558789,0.08379510754412112,0.0011026373402423933,0.0059538678318191915,-0.004851230491576798,0.016030000000000003,0.017461428571428572,519212534.1799993,-0.022930000000000006,-13.57203913002184,-77.80852241283895,22.19147758716104,15.931589053245228,0.09677999999999999,0.0959978050348644,0.10710571428571428,0.10311277512759176,0.11780900000000001,0.10791634293597943,38966.0,15821046.099999988,87289.0,15299791.314285714
2020-09-06,0.07426,0.08445,0.06793,0.08408,24631650.6,8803.0,12045011.4,0.08304666666666667,0.09599857142857145,0.1110305,0.0845544512587161,0.09290718600927036,0.10272888843512148,35.24464140363571,0.1457002717418457,0.07636072825815433,-0.0029308298664761784,0.0029655168951291176,-0.005896346761605296,0.016519999999999993,0.01666428571428572,504593128.4799993,-0.019909999999999997,-27.95818695912946,-69.05263157894737,30.94736842105263,22.764613422561847,13.223808241314295,0.09071,0.09465,0.0635,0.07406,39251056.3,13442.0,18528811.8,-18.355197883364564,25.59229137199435,0.15277191524529743,0.07664208475470258,-0.0016174533996245605,0.004439603585530441,-0.006057056985155002,0.031149999999999997,0.017092142857142858,479961477.8799993,-0.03941,-42.713490099009896,-84.84500574052812,15.154994259471874,13.004644180734074,0.08565333333333335,0.0850289025174322,0.10175714285714287,0.09584958134569382,0.114707,0.10469192932302901,41684.0,18330224.199999988,92679.0,16490112.714285715
2020-09-07,0.08393,0.0852,0.06842,0.08422,37620657.5,10846.0,18780238.0,0.08078666666666667,0.09184714285714286,0.10766499999999998,0.08438722562935805,0.09073538950695277,0.1009661371555861,29.913860610806566,0.13865405986923532,0.07667594013076465,-0.00391526066111518,0.001589361383880258,-0.005504622044995439,0.016780000000000003,0.016741428571428574,542213785.9799993,-0.023139999999999994,-32.763851189525795,-68.84210526315789,31.157894736842106,25.753419139122204,0.3455260335994264,0.07426,0.08445,0.06793,0.08408,24631650.6,8803.0,12045011.4,13.223808241314295,35.24464140363571,0.1457002717418457,0.07636072825815433,-0.0029308298664761784,0.0029655168951291176,-0.005896346761605296,0.016519999999999993,0.01666428571428572,504593128.4799993,-0.019909999999999997,-27.95818695912946,-69.05263157894737,30.94736842105263,22.764613422561847,0.08304666666666667,0.0845544512587161,0.09599857142857145,0.09290718600927036,0.1110305,0.10272888843512148,37017.0,17039506.79999999,88666.0,15858946.828571428
2020-09-08,0.08421,0.0846,0.07258,0.07511,24453735.8,8651.0,11709975.3,0.08113666666666666,0.08682999999999999,0.105025,0.07974861281467902,0.08682904213021458,0.09850364790267313,30.57834700820493,0.1377023853879037,0.0723476146120963,-0.005368643640833878,0.00019776037893743065,-0.005566404019771309,0.012019999999999989,0.01610214285714286,517760050.1799993,-0.036390000000000006,-34.073553936627754,-82.54135338345866,17.458646616541344,26.521303258145362,-10.806317539484619,0.08393,0.0852,0.06842,0.08422,37620657.5,10846.0,18780238.0,0.3455260335994264,29.913860610806566,0.13865405986923532,0.07667594013076465,-0.00391526066111518,0.001589361383880258,-0.005504622044995439,0.016780000000000003,0.016741428571428574,542213785.9799993,-0.023139999999999994,-32.763851189525795,-68.84210526315789,31.157894736842106,25.753419139122204,0.08078666666666667,0.08438722562935805,0.09184714285714286,0.09073538950695277,0.10766499999999998,0.1009661371555861,33091.0,16451353.733333325,85455.0,16277339.271428572
2020-09-09,0.07495,0.08171,0.072,0.07683,20620180.5,6815.0,9895795.7,0.07872,0.08245714285714285,0.1029665,0.0782893064073395,0.08432928159766094,0.0964394909595614,31.89723320158103,0.13734508468964754,0.06858791531035247,-0.006308944908239314,-0.0011035806784979183,-0.005205364229741396,0.00971000000000001,0.01575714285714286,538380230.6799994,-0.047560000000000005,-32.29047325284217,-79.95488721804513,20.045112781954877,22.88721804511278,2.5083388925950536,0.08421,0.0846,0.07258,0.07511,24453735.8,8651.0,11709975.3,-10.806317539484619,30.57834700820493,0.1377023853879037,0.0723476146120963,-0.005368643640833878,0.00019776037893743065,-0.005566404019771309,0.012019999999999989,0.01610214285714286,517760050.1799993,-0.036390000000000006,-34.073553936627754,-82.54135338345866,17.458646616541344,26.521303258145362,0.08113666666666666,0.07974861281467902,0.08682999999999999,0.08682904213021458,0.105025,0.09850364790267313,28300.0,14178408.233333325,80708.0,15503882.114285713
2020-09-10,0.07681,0.095,0.07681,0.08685,36841553.8,12030.0,18204803.3,0.07959666666666666,0.08173571428571427,0.10204450000000001,0.08256965320366974,0.0849594611982457,0.09552620610626984,41.57656772164341,0.13714227289380873,0.06694672710619129,-0.006174435133035713,-0.0021177515694054774,-0.004056683563630236,0.018189999999999998,0.015970714285714286,575221784.4799993,-0.02643000000000001,-16.48235407250698,-64.88721804511279,35.11278195488721,24.205513784461147,13.071214685587803,0.07495,0.08171,0.072,0.07683,20620180.5,6815.0,9895795.7,2.5083388925950536,31.89723320158103,0.13734508468964754,0.06858791531035247,-0.006308944908239314,-0.0011035806784979183,-0.005205364229741396,0.00971000000000001,0.01575714285714286,538380230.6799994,-0.047560000000000005,-32.29047325284217,-79.95488721804513,20.045112781954877,22.88721804511278,0.07872,0.0782893064073395,0.08245714285714285,0.08432928159766094,0.1029665,0.0964394909595614,26312.0,13462002.99999999,76799.0,15345956.142857144
2020-09-11,0.08693,0.08768,0.0786,0.08252,14127262.7,6068.0,6504311.9,0.08206666666666666,0.08052428571428571,0.0997065,0.08254482660183488,0.08434959589868427,0.09428751981043461,37.906523855890946,0.1333655135108923,0.06604748648910772,-0.006344099153796023,-0.0029630210862835868,-0.0033810780675124366,0.00907999999999999,0.01599642857142857,561094521.7799993,-0.02771,-23.137108792846494,-71.39849624060152,28.60150375939849,27.91979949874686,-5.07304727942022,0.07681,0.095,0.07681,0.08685,36841553.8,12030.0,18204803.3,13.071214685587803,41.57656772164341,0.13714227289380873,0.06694672710619129,-0.006174435133035713,-0.0021177515694054774,-0.004056683563630236,0.018189999999999998,0.015970714285714286,575221784.4799993,-0.02643000000000001,-16.48235407250698,-64.88721804511279,35.11278195488721,24.205513784461147,0.07959666666666666,0.08256965320366974,0.08173571428571427,0.0849594611982457,0.10204450000000001,0.09552620610626984,27496.0,13270191.433333324,75359.0,15672761.814285714
2020-09-12,0.08219,0.08679,0.08109,0.0867,13174921.9,5385.0,6693644.5,0.08535666666666665,0.08233,0.098206,0.08462241330091744,0.08493719692401319,0.0935648988761075,37.930698851469735,0.13134504893340546,0.06506695106659455,-0.006071282085687482,-0.0035846732861643665,-0.0024866087995231156,0.005700000000000011,0.01569857142857143,574269443.6799992,-0.020739999999999995,-22.242152466367713,-65.11278195488723,34.887218045112775,32.8671679197995,5.487285557853753,0.08693,0.08768,0.0786,0.08252,14127262.7,6068.0,6504311.9,-5.07304727942022,37.906523855890946,0.1333655135108923,0.06604748648910772,-0.006344099153796023,-0.0029630210862835868,-0.0033810780675124366,0.00907999999999999,0.01599642857142857,561094521.7799993,-0.02771,-23.137108792846494,-71.39849624060152,28.60150375939849,27.91979949874686,0.08206666666666666,0.08254482660183488,0.08052428571428571,0.08434959589868427,0.0997065,0.09428751981043461,24913.0,11534970.299999991,66655.0,13666992.485714287
2020-09-13,0.08652,0.0893,0.07477,0.07655,25884496.5,7844.0,15243668.3,0.08192333333333333,0.08125428571428571,0.0957705,0.08058620665045872,0.0828403976930099,0.09194443231647823,26.080000000000013,0.1276745135901114,0.0638664864098886,-0.006598034729355287,-0.004187345574802551,-0.0024106891545527358,0.014530000000000001,0.015163571428571429,548384947.1799992,-0.015349999999999989,-38.45968325428088,-80.17922235722963,19.82077764277036,27.76983314909388,-11.523347202958846,0.08219,0.08679,0.08109,0.0867,13174921.9,5385.0,6693644.5,5.487285557853753,37.930698851469735,0.13134504893340546,0.06506695106659455,-0.006071282085687482,-0.0035846732861643665,-0.0024866087995231156,0.005700000000000011,0.01569857142857143,574269443.6799992,-0.020739999999999995,-22.242152466367713,-65.11278195488723,34.887218045112775,32.8671679197995,0.08535666666666665,0.08462241330091744,0.08233,0.08493719692401319,0.098206,0.0935648988761075,23483.0,10467586.566666657,58598.0,11976254.3
2020-09-14,0.07622,0.08103,0.07329,0.07402,30528674.9,6967.0,18414649.7,0.07909000000000001,0.07979714285714286,0.09377500000000001,0.07730310332522936,0.08063529826975743,0.09023734352443268,28.52767446948151,0.12588841841201875,0.06166158158798128,-0.007137364752407213,-0.004777349410323484,-0.0023600153420837294,0.007740000000000011,0.014523571428571429,517856272.27999926,-0.016979999999999995,-34.657485875706215,-80.96272167933407,19.037278320665944,24.581758002849696,-2.886381527158218,0.08652,0.0893,0.07477,0.07655,25884496.5,7844.0,15243668.3,-11.523347202958846,26.080000000000013,0.1276745135901114,0.0638664864098886,-0.006598034729355287,-0.004187345574802551,-0.0024106891545527358,0.014530000000000001,0.015163571428571429,548384947.1799992,-0.015349999999999989,-38.45968325428088,-80.17922235722963,19.82077764277036,27.76983314909388,0.08192333333333333,0.08058620665045872,0.08125428571428571,0.0828403976930099,0.0957705,0.09194443231647823,19297.0,9480541.566666657,57639.0,12433205.285714285
2020-09-15,0.07402,0.0775,0.06509,0.06568,39502814.0,8711.0,23061930.2,0.07208333333333335,0.07845,0.0913855,0.07149155166261467,0.07689647370231807,0.08789854890305814,26.967221590321586,0.12442704353155268,0.058343956468447304,-0.008143878420013032,-0.005450655212261394,-0.0026932232077516377,0.012410000000000004,0.014784285714285713,478353458.27999926,-0.008379999999999999,-40.41549487435362,-95.85472523293402,4.1452747670659855,14.334443576834103,-11.267225074304243,0.07622,0.08103,0.07329,0.07402,30528674.9,6967.0,18414649.7,-2.886381527158218,28.52767446948151,0.12588841841201875,0.06166158158798128,-0.007137364752407213,-0.004777349410323484,-0.0023600153420837294,0.007740000000000011,0.014523571428571429,517856272.27999926,-0.016979999999999995,-34.657485875706215,-80.96272167933407,19.037278320665944,24.581758002849696,0.07909000000000001,0.07730310332522936,0.07979714285714286,0.08063529826975743,0.09377500000000001,0.09023734352443268,20196.0,13450654.166666659,53760.0,12380978.385714287
2020-09-16,0.06566,0.07139,0.06443,0.06971,35578759.8,8111.0,18602185.7,0.06980333333333333,0.07743285714285715,0.0896715,0.07060077583130733,0.07509985527673856,0.08616630615038592,30.740173557937723,0.12350695339308924,0.05583604660691076,-0.008518168291555911,-0.006064157828120297,-0.002454010463435614,0.006959999999999994,0.014235714285714287,513932218.07999927,-0.014370000000000008,-35.11727475800447,-87.62455161418895,12.375448385811067,11.852667157847671,6.168138897349982,0.07402,0.0775,0.06509,0.06568,39502814.0,8711.0,23061930.2,-11.267225074304243,26.967221590321586,0.12442704353155268,0.058343956468447304,-0.008143878420013032,-0.005450655212261394,-0.0026932232077516377,0.012410000000000004,0.014784285714285713,478353458.27999926,-0.008379999999999999,-40.41549487435362,-95.85472523293402,4.1452747670659855,14.334443576834103,0.07208333333333335,0.07149155166261467,0.07845,0.07689647370231807,0.0913855,0.08789854890305814,23522.0,18906749.39999999,53820.0,14002686.22857143
2020-09-17,0.06959,0.07098,0.0653,0.06896,31014730.1,5054.0,14947007.0,0.06811666666666667,0.07487714285714286,0.0877515,0.06978038791565366,0.0735648914575539,0.08452761032653965,36.2073112073112,0.12171846616606262,0.05378453383393737,-0.008774171258815383,-0.006606160514259315,-0.0021680107445560684,0.0056800000000000045,0.013035714285714288,482917487.97999924,-0.01526000000000001,-24.961915125136024,-82.66666666666669,17.333333333333307,11.284685495403458,-0.9053024859893742,0.06566,0.07139,0.06443,0.06971,35578759.8,8111.0,18602185.7,6.168138897349982,30.740173557937723,0.12350695339308924,0.05583604660691076,-0.008518168291555911,-0.006064157828120297,-0.002454010463435614,0.006959999999999994,0.014235714285714287,513932218.07999927,-0.014370000000000008,-35.11727475800447,-87.62455161418895,12.375448385811067,11.852667157847671,0.06980333333333333,0.07060077583130733,0.07743285714285715,0.07509985527673856,0.0896715,0.08616630615038592,23789.0,20026255.19999999,55116.0,15246456.228571428
2020-09-18,0.06896,0.06934,0.06435,0.06569,27611341.3,4776.0,13137790.0,0.06812,0.07247285714285713,0.085461,0.06773519395782683,0.07159616859316542,0.08273355220020254,35.204021980591605,0.11885852899778701,0.05206347100221298,-0.00913560752935981,-0.007112049917279414,-0.0020235576120803955,0.0049899999999999944,0.012247142857142857,455306146.67999923,-0.009419999999999998,-27.813186813186807,-93.04761904761905,6.952380952380945,12.22038755717511,-4.741879350348021,0.06959,0.07098,0.0653,0.06896,31014730.1,5054.0,14947007.0,-0.9053024859893742,36.2073112073112,0.12171846616606262,0.05378453383393737,-0.008774171258815383,-0.006606160514259315,-0.0021680107445560684,0.0056800000000000045,0.013035714285714288,482917487.97999924,-0.01526000000000001,-24.961915125136024,-82.66666666666669,17.333333333333307,11.284685495403458,0.06811666666666667,0.06978038791565366,0.07487714285714286,0.0735648914575539,0.0877515,0.08452761032653965,21876.0,18870374.299999993,48140.0,14781056.757142859
2020-09-19,0.06577,0.07075,0.06528,0.06784,23235708.3,4979.0,13522490.7,0.06749666666666666,0.06977857142857143,0.0826335,0.06778759697891341,0.07065712644487407,0.08131511865732612,45.60361888606163,0.11140945288101957,0.05385754711898043,-0.009143164635577114,-0.007518272860938955,-0.001624891774638159,0.005469999999999989,0.01041285714285714,478541854.97999924,-0.008989999999999998,-8.398595733189307,-88.61337683523656,11.386623164763437,11.890779150159233,3.1473316101566104,0.06896,0.06934,0.06435,0.06569,27611341.3,4776.0,13137790.0,-4.741879350348021,35.204021980591605,0.11885852899778701,0.05206347100221298,-0.00913560752935981,-0.007112049917279414,-0.0020235576120803955,0.0049899999999999944,0.012247142857142857,455306146.67999923,-0.009419999999999998,-27.813186813186807,-93.04761904761905,6.952380952380945,12.22038755717511,0.06812,0.06773519395782683,0.07247285714285713,0.07159616859316542,0.085461,0.08273355220020254,17941.0,15562327.566666657,46848.0,15728696.485714287
2020-09-20,0.06785,0.069,0.06426,0.06626,25085529.5,5431.0,14327167.4,0.06659666666666667,0.06830857142857143,0.0802825,0.0670237984894567,0.06955784483365555,0.07988129783281886,35.698234349919744,0.10604090373854773,0.054524096261452284,-0.009170929722948779,-0.00784880423334092,-0.0013221254896078581,0.004740000000000008,0.009571428571428573,453456325.47999924,-0.020589999999999997,-21.194100856327314,-93.49381912817176,6.506180871828242,8.281728329657545,-2.3434045689019816,0.06577,0.07075,0.06528,0.06784,23235708.3,4979.0,13522490.7,3.1473316101566104,45.60361888606163,0.11140945288101957,0.05385754711898043,-0.009143164635577114,-0.007518272860938955,-0.001624891774638159,0.005469999999999989,0.01041285714285714,478541854.97999924,-0.008989999999999998,-8.398595733189307,-88.61337683523656,11.386623164763437,11.890779150159233,0.06749666666666666,0.06778759697891341,0.06977857142857143,0.07065712644487407,0.0826335,0.08131511865732612,14809.0,13869095.899999991,46442.0,16704245.942857143
2020-09-21,0.06626,0.0699,0.05751,0.05752,36223684.6,8740.0,19940977.3,0.06387333333333334,0.06595142857142858,0.077647,0.062271899244728354,0.06654838362524167,0.07775165042016945,31.170662905500706,0.10119522339929904,0.05409877660070095,-0.009785378954103807,-0.0082361191774935,-0.001549259776610308,0.012390000000000005,0.009257857142857142,417232640.8799992,-0.024999999999999994,-31.70268344811209,-99.9733262203254,0.026673779674588054,5.97315927208876,-13.19046181708421,0.06785,0.069,0.06426,0.06626,25085529.5,5431.0,14327167.4,-2.3434045689019816,35.698234349919744,0.10604090373854773,0.054524096261452284,-0.009170929722948779,-0.00784880423334092,-0.0013221254896078581,0.004740000000000008,0.009571428571428573,453456325.47999924,-0.020589999999999997,-21.194100856327314,-93.49381912817176,6.506180871828242,8.281728329657545,0.06659666666666667,0.0670237984894567,0.06830857142857143,0.06955784483365555,0.0802825,0.07988129783281886,15186.0,13662482.699999994,44029.0,16573317.242857143
2020-09-22,0.05767,0.0591,0.0514,0.05516,34271325.4,7827.0,16174762.9,0.05964666666666666,0.06444857142857142,0.07503299999999999,0.05871594962236418,0.06370128771893124,0.07560006466586759,34.45050662509743,0.09613598966098685,0.05393001033901312,-0.010343532865075916,-0.008657601915009984,-0.0016859309500659326,0.0076999999999999985,0.008949285714285715,382961315.47999924,-0.03154,-26.56104380242311,-91.37614678899084,8.623853211009173,5.052235954170673,-4.352349575169063,0.06626,0.0699,0.05751,0.05752,36223684.6,8740.0,19940977.3,-13.19046181708421,31.170662905500706,0.10119522339929904,0.05409877660070095,-0.009785378954103807,-0.0082361191774935,-0.001549259776610308,0.012390000000000005,0.009257857142857142,417232640.8799992,-0.024999999999999994,-31.70268344811209,-99.9733262203254,0.026673779674588054,5.97315927208876,0.06387333333333334,0.062271899244728354,0.06595142857142858,0.06654838362524167,0.077647,0.07775165042016945,19150.0,15930211.799999991,45802.0,16791364.042857144
2020-09-23,0.0552,0.05744,0.04713,0.04735,24776736.2,6851.0,12662612.9,0.05334333333333333,0.06125428571428571,0.0728055,0.05303297481118209,0.05961346578919843,0.07290958231673735,29.01480637813212,0.09573773194774998,0.04987326805225001,-0.011285977862389385,-0.009183277104485865,-0.00210270075790352,0.01031,0.008992142857142857,358184579.27999926,-0.029200000000000004,-38.37042821814395,-99.54042197618548,0.4595780238145078,3.036701671499428,-14.221014492753618,0.05767,0.0591,0.0514,0.05516,34271325.4,7827.0,16174762.9,-4.352349575169063,34.45050662509743,0.09613598966098685,0.05393001033901312,-0.010343532865075916,-0.008657601915009984,-0.0016859309500659326,0.0076999999999999985,0.008949285714285715,382961315.47999924,-0.03154,-26.56104380242311,-91.37614678899084,8.623853211009173,5.052235954170673,0.05964666666666666,0.05871594962236418,0.06444857142857142,0.06370128771893124,0.07503299999999999,0.07560006466586759,21998.0,16814302.533333324,44918.0,15807483.0
2020-09-24,0.04737,0.05907,0.04639,0.05764,32154884.6,8407.0,16076857.6,0.05338333333333334,0.05963714285714287,0.0711375,0.055336487405591044,0.059120099341898824,0.07145533638180998,29.286626010494956,0.09333883981258402,0.04893616018741599,-0.01107489086185276,-0.009561599855959245,-0.0015132910058935148,0.012679999999999997,0.00859857142857143,390339463.8799993,-0.016380000000000006,-33.63270005757053,-73.78233512001864,26.217664879981346,11.767032038268347,21.680388431496713,0.0552,0.05744,0.04713,0.04735,24776736.2,6851.0,12662612.9,-14.221014492753618,29.01480637813212,0.09573773194774998,0.04987326805225001,-0.011285977862389385,-0.009183277104485865,-0.00210270075790352,0.01031,0.008992142857142857,358184579.27999926,-0.029200000000000004,-38.37042821814395,-99.54042197618548,0.4595780238145078,3.036701671499428,0.05334333333333333,0.05303297481118209,0.06125428571428571,0.05961346578919843,0.0728055,0.07290958231673735,23418.0,16259451.033333326,43658.0,14958972.6
2020-09-25,0.05768,0.06214,0.0553,0.06113,36092516.9,9530.0,20551359.3,0.05537333333333333,0.05898571428571429,0.070491,0.05823324370279552,0.059622574506424116,0.07047197101211379,34.64905985359552,0.09308360419275898,0.04789839580724102,-0.010504895167849956,-0.009750258918337388,-0.0007546362495125681,0.006839999999999999,0.00843857142857143,426431980.77999926,-0.004550000000000005,-25.920988851187587,-65.64903285947334,34.35096714052667,20.342736681440844,5.981276005547841,0.04737,0.05907,0.04639,0.05764,32154884.6,8407.0,16076857.6,21.680388431496713,29.286626010494956,0.09333883981258402,0.04893616018741599,-0.01107489086185276,-0.009561599855959245,-0.0015132910058935148,0.012679999999999997,0.00859857142857143,390339463.8799993,-0.016380000000000006,-33.63270005757053,-73.78233512001864,26.217664879981346,11.767032038268347,0.05338333333333334,0.055336487405591044,0.05963714285714287,0.059120099341898824,0.0711375,0.07145533638180998,23085.0,14971411.133333325,47011.0,15120379.828571428
2020-09-26,0.0608,0.06258,0.05731,0.05893,24306411.5,4917.0,15402100.9,0.05923333333333333,0.057712857142857135,0.06923349999999999,0.05858162185139776,0.05944943087981809,0.06937273567762677,29.487368887575713,0.09143777675732614,0.047029223242673834,-0.01011410201536514,-0.009823027537742939,-0.000291074477622201,0.005269999999999997,0.008407857142857144,402125569.27999926,-0.010779999999999991,-32.029988465974625,-70.77604288044745,29.22395711955256,29.930863046686863,-3.0756578947368367,0.05768,0.06214,0.0553,0.06113,36092516.9,9530.0,20551359.3,5.981276005547841,34.64905985359552,0.09308360419275898,0.04789839580724102,-0.010504895167849956,-0.009750258918337388,-0.0007546362495125681,0.006839999999999999,0.00843857142857143,426431980.77999926,-0.004550000000000005,-25.920988851187587,-65.64903285947334,34.35096714052667,20.342736681440844,0.05537333333333333,0.05823324370279552,0.05898571428571429,0.059622574506424116,0.070491,0.07047197101211379,24788.0,16430276.599999994,51765.0,16179461.157142859
2020-09-27,0.05883,0.06078,0.05416,0.05924,21864298.1,4860.0,12862023.9,0.05976666666666667,0.056709999999999997,0.0679845,0.05891081092569888,0.059397073159863575,0.06840771323213851,35.03889369057907,0.08943685550801476,0.04653214449198524,-0.009667935277488257,-0.009792009085692003,0.00012407380820374583,0.006620000000000001,0.007842857142857143,423989867.3799993,-0.009719999999999993,-22.61267145656435,-62.90415704387991,37.09584295612009,33.55692240539978,0.6969233384327734,0.0608,0.06258,0.05731,0.05893,24306411.5,4917.0,15402100.9,-3.0756578947368367,29.487368887575713,0.09143777675732614,0.047029223242673834,-0.01011410201536514,-0.009823027537742939,-0.000291074477622201,0.005269999999999997,0.008407857142857144,402125569.27999926,-0.010779999999999991,-32.029988465974625,-70.77604288044745,29.22395711955256,29.930863046686863,0.05923333333333333,0.05858162185139776,0.057712857142857135,0.05944943087981809,0.06923349999999999,0.06937273567762677,22854.0,17343439.26666666,51703.0,16447976.900000002
2020-09-28,0.05941,0.06875,0.05941,0.06259,29051294.7,7479.0,17540054.7,0.060253333333333346,0.057434285714285715,0.0673585,0.06075040546284945,0.06019530486989768,0.06785364530526818,40.25907618885291,0.08866556458085623,0.04605143541914378,-0.008940962075134715,-0.009621799683580545,0.0006808376084458303,0.009340000000000008,0.007957142857142857,453041162.07999927,-0.0030999999999999917,-15.441772493920558,-47.926711668273846,52.073288331726154,39.46436280246627,5.352634236660511,0.05883,0.06078,0.05416,0.05924,21864298.1,4860.0,12862023.9,0.6969233384327734,35.03889369057907,0.08943685550801476,0.04653214449198524,-0.009667935277488257,-0.009792009085692003,0.00012407380820374583,0.006620000000000001,0.007842857142857143,423989867.3799993,-0.009719999999999993,-22.61267145656435,-62.90415704387991,37.09584295612009,33.55692240539978,0.05976666666666667,0.05891081092569888,0.056709999999999997,0.059397073159863575,0.0679845,0.06840771323213851,19307.0,16271828.033333326,51132.0,16238670.685714286
2020-09-29,0.06234,0.07274,0.0615,0.07136,36334829.7,9297.0,20599007.7,0.06439666666666667,0.05974857142857143,0.067085,0.06605520273142473,0.06298647865242327,0.06818758384762358,54.805414551607456,0.08801729134740816,0.046152708652591856,-0.007569903730554203,-0.009211420492975277,0.0016415167624210733,0.01124,0.007873571428571428,489375991.77999926,0.0035200000000000092,8.647990255785643,-5.237191650853861,94.76280834914614,61.310646545664135,14.469040744305433,0.05941,0.06875,0.05941,0.06259,29051294.7,7479.0,17540054.7,5.352634236660511,40.25907618885291,0.08866556458085623,0.04605143541914378,-0.008940962075134715,-0.009621799683580545,0.0006808376084458303,0.009340000000000008,0.007957142857142857,453041162.07999927,-0.0030999999999999917,-15.441772493920558,-47.926711668273846,52.073288331726154,39.46436280246627,0.060253333333333346,0.06075040546284945,0.057434285714285715,0.06019530486989768,0.0673585,0.06785364530526818,17256.0,15268059.833333327,49871.0,15895681.742857143
2020-09-30,0.07138,0.07598,0.06723,0.06888,36206017.9,11745.0,18228105.4,0.06761,0.06282428571428571,0.0661865,0.06746760136571237,0.06445985898931744,0.068253528243088,49.278887923544744,0.08498002998970208,0.04739297001029791,-0.00660728076849762,-0.008690592548079745,0.0020833117795821254,0.008750000000000008,0.008001428571428573,453169973.8799993,0.0026199999999999973,-1.190646966002007,-23.994592767826994,76.005407232173,74.28050130434843,-3.502381619501264,0.06234,0.07274,0.0615,0.07136,36334829.7,9297.0,20599007.7,14.469040744305433,54.805414551607456,0.08801729134740816,0.046152708652591856,-0.007569903730554203,-0.009211420492975277,0.0016415167624210733,0.01124,0.007873571428571428,489375991.77999926,0.0035200000000000092,8.647990255785643,-5.237191650853861,94.76280834914614,61.310646545664135,0.06439666666666667,0.06605520273142473,0.05974857142857143,0.06298647865242327,0.067085,0.06818758384762358,21636.0,17000362.099999994,51341.0,16527716.714285715
2020-10-01,0.06888,0.07204,0.06,0.06166,31656024.1,9675.0,15813191.5,0.06730000000000001,0.06339857142857143,0.0651435,0.06456380068285618,0.06375989424198808,0.06762557317231771,44.298656669790695,0.08237036796838439,0.0479166320316156,-0.0063537467581285395,-0.008223223390089504,0.0018694766319609646,0.012040000000000009,0.008455714285714287,421513949.77999926,0.004139999999999998,-10.585846867749416,-48.394727948631306,51.60527205136869,74.12449587756261,-10.481997677119626,0.07138,0.07598,0.06723,0.06888,36206017.9,11745.0,18228105.4,-3.502381619501264,49.278887923544744,0.08498002998970208,0.04739297001029791,-0.00660728076849762,-0.008690592548079745,0.0020833117795821254,0.008750000000000008,0.008001428571428573,453169973.8799993,0.0026199999999999973,-1.190646966002007,-23.994592767826994,76.005407232173,74.28050130434843,0.06761,0.06746760136571237,0.06282428571428571,0.06445985898931744,0.0661865,0.068253528243088,28521.0,18789055.933333322,56235.0,17322787.07142857
2020-10-02,0.06169,0.0617,0.05263,0.05477,36925723.7,11006.0,16552598.4,0.06176999999999999,0.062490000000000004,0.06354699999999999,0.05966690034142809,0.061512420681491056,0.06640123287019221,41.92785334121821,0.07806801359374141,0.04902598640625858,-0.006632331259883495,-0.007905044964048303,0.001272713704164808,0.009069999999999995,0.008747142857142858,384588226.07999927,-0.00039000000000000146,-16.623534784594305,-71.6796214937479,28.3203785062521,51.9770192632646,-11.217377208623768,0.06888,0.07204,0.06,0.06166,31656024.1,9675.0,15813191.5,-10.481997677119626,44.298656669790695,0.08237036796838439,0.0479166320316156,-0.0063537467581285395,-0.008223223390089504,0.0018694766319609646,0.012040000000000009,0.008455714285714287,421513949.77999926,0.004139999999999998,-10.585846867749416,-48.394727948631306,51.60527205136869,74.12449587756261,0.06730000000000001,0.06456380068285618,0.06339857142857143,0.06375989424198808,0.0651435,0.06762557317231771,30717.0,18213434.86666666,57503.0,17285120.485714283
2020-10-03,0.05478,0.05604,0.05088,0.05104,27245635.0,5716.0,14109752.8,0.055823333333333336,0.06136285714285715,0.0622715,0.055353450170714046,0.058894315511118296,0.06493825831112629,37.86477896561688,0.07646114229363103,0.04808185770636897,-0.007072563205590264,-0.007738548612356696,0.0006659854067664322,0.005159999999999998,0.008725000000000002,357342591.07999927,0.003689999999999999,-24.764150943396224,-84.28523149712741,15.714768502872595,31.88013968683114,-6.827309236947792,0.06169,0.0617,0.05263,0.05477,36925723.7,11006.0,16552598.4,-11.217377208623768,41.92785334121821,0.07806801359374141,0.04902598640625858,-0.006632331259883495,-0.007905044964048303,0.001272713704164808,0.009069999999999995,0.008747142857142858,384588226.07999927,-0.00039000000000000146,-16.623534784594305,-71.6796214937479,28.3203785062521,51.9770192632646,0.06176999999999999,0.05966690034142809,0.062490000000000004,0.061512420681491056,0.06354699999999999,0.06640123287019221,32426.0,16864631.76666666,58979.0,16713868.92857143
2020-10-04,0.05104,0.05269,0.05031,0.05235,26851922.9,5032.0,16746259.3,0.05272000000000001,0.060378571428571434,0.061188,0.05385172508535702,0.057258236633338726,0.0637393765672095,39.91298042059463,0.07490178653227408,0.04747421346772591,-0.007232373838772593,-0.0076373136576398755,0.00040493981886728213,0.00238,0.008556428571428572,384194513.97999924,-0.005289999999999996,-20.99305765167522,-79.85806015545793,20.141939844542073,21.3923622845556,2.5666144200626935,0.05478,0.05604,0.05088,0.05104,27245635.0,5716.0,14109752.8,-6.827309236947792,37.86477896561688,0.07646114229363103,0.04808185770636897,-0.007072563205590264,-0.007738548612356696,0.0006659854067664322,0.005159999999999998,0.008725000000000002,357342591.07999927,0.003689999999999999,-24.764150943396224,-84.28523149712741,15.714768502872595,31.88013968683114,0.055823333333333336,0.055353450170714046,0.06136285714285715,0.058894315511118296,0.0622715,0.06493825831112629,26397.0,15491847.56666666,59778.0,16529247.77142857
2020-10-05,0.05236,0.05415,0.05056,0.05177,30342626.8,4635.0,19994567.0,0.051719999999999995,0.05883285714285714,0.06049249999999999,0.05281086254267851,0.055886177475004045,0.06259943594176098,45.270603717716725,0.07465077059763799,0.046334229402361995,-0.007321429191393829,-0.007574136764390667,0.00025270757299683793,0.003589999999999996,0.007927857142857143,353851887.17999923,-0.00936,-9.996522948539644,-81.81818181818184,18.181818181818166,18.012842176410956,-1.1268143621084803,0.05104,0.05269,0.05031,0.05235,26851922.9,5032.0,16746259.3,2.5666144200626935,39.91298042059463,0.07490178653227408,0.04747421346772591,-0.007232373838772593,-0.0076373136576398755,0.00040493981886728213,0.00238,0.008556428571428572,384194513.97999924,-0.005289999999999996,-20.99305765167522,-79.85806015545793,20.141939844542073,21.3923622845556,0.05272000000000001,0.05385172508535702,0.060378571428571434,0.057258236633338726,0.061188,0.0637393765672095,21754.0,15802870.166666659,59950.0,17084138.542857144
2020-10-06,0.05178,0.05191,0.04392,0.04407,27866836.2,6641.0,13510514.4,0.049396666666666665,0.05493428571428571,0.0592105,0.048440431271339256,0.05293213310625303,0.06083472775683137,41.615000756086495,0.07445610122928109,0.04396489877071891,-0.007922011827306265,-0.007643711776973787,-0.0002783000503324782,0.007989999999999997,0.00794857142857143,325985050.97999924,-0.014860000000000005,-20.105148658448158,-99.5321272613849,0.4678727386150884,12.930543588325117,-14.889918887601395,0.05236,0.05415,0.05056,0.05177,30342626.8,4635.0,19994567.0,-1.1268143621084803,45.270603717716725,0.07465077059763799,0.046334229402361995,-0.007321429191393829,-0.007574136764390667,0.00025270757299683793,0.003589999999999996,0.007927857142857143,353851887.17999923,-0.00936,-9.996522948539644,-81.81818181818184,18.181818181818166,18.012842176410956,0.051719999999999995,0.05281086254267851,0.05883285714285714,0.055886177475004045,0.06049249999999999,0.06259943594176098,15383.0,16950193.033333328,57106.0,17434783.157142855
2020-10-07,0.04405,0.04681,0.04326,0.04642,28681241.8,5242.0,17462700.9,0.04742,0.051725714285714285,0.058083499999999996,0.047430215635669626,0.05130409982968978,0.05946189654189504,49.23355859568155,0.07362411744354028,0.042542882556459716,-0.008114810053992005,-0.007737931432377431,-0.0003768786216145747,0.0035499999999999976,0.007465714285714286,354666292.77999926,-0.012819999999999998,-1.9640971488912307,-90.34229828850854,9.65770171149145,9.435797543974912,5.380249716231565,0.05178,0.05191,0.04392,0.04407,27866836.2,6641.0,13510514.4,-14.889918887601395,41.615000756086495,0.07445610122928109,0.04396489877071891,-0.007922011827306265,-0.007643711776973787,-0.0002783000503324782,0.007989999999999997,0.00794857142857143,325985050.97999924,-0.014860000000000005,-20.105148658448158,-99.5321272613849,0.4678727386150884,12.930543588325117,0.049396666666666665,0.048440431271339256,0.05493428571428571,0.05293213310625303,0.0592105,0.06083472775683137,16308.0,16750446.899999991,54450.0,16422141.257142857
2020-10-08,0.04642,0.05319,0.0432,0.05109,33842530.4,8032.0,21834082.3,0.04719333333333334,0.050215714285714294,0.0573535,0.04926010781783481,0.051250574872267335,0.05866457306171456,44.05086285195277,0.0727607331270651,0.04194626687293491,-0.007800850715309983,-0.007750515288963942,-5.033542634604125e-05,0.009989999999999999,0.007273571428571429,388508823.17999923,-0.011500000000000003,-11.363636363636353,-75.93044539353264,24.069554606467356,11.398376352191308,10.06031882809134,0.04405,0.04681,0.04326,0.04642,28681241.8,5242.0,17462700.9,5.380249716231565,49.23355859568155,0.07362411744354028,0.042542882556459716,-0.008114810053992005,-0.007737931432377431,-0.0003768786216145747,0.0035499999999999976,0.007465714285714286,354666292.77999926,-0.012819999999999998,-1.9640971488912307,-90.34229828850854,9.65770171149145,9.435797543974912,0.04742,0.047430215635669626,0.051725714285714285,0.05130409982968978,0.058083499999999996,0.05946189654189504,16518.0,16989260.76666666,47947.0,16312797.757142859
2020-10-09,0.05109,0.05517,0.0485,0.05365,23158701.6,7549.0,13158809.3,0.05038666666666667,0.05005571428571428,0.05664399999999999,0.05145505390891741,0.0518504311542005,0.0581869946748846,43.08943089430895,0.07130687743715386,0.041981122562846133,-0.007261756068589767,-0.007652763444889107,0.0003910073762993403,0.006669999999999995,0.0072614285714285715,411667524.77999926,-0.017710000000000004,-12.236217896286593,-68.12080536912751,31.879194630872483,21.868816982943773,5.010765316108827,0.04642,0.05319,0.0432,0.05109,33842530.4,8032.0,21834082.3,10.06031882809134,44.05086285195277,0.0727607331270651,0.04194626687293491,-0.007800850715309983,-0.007750515288963942,-5.033542634604125e-05,0.009989999999999999,0.007273571428571429,388508823.17999923,-0.011500000000000003,-11.363636363636353,-75.93044539353264,24.069554606467356,11.398376352191308,0.04719333333333334,0.04926010781783481,0.050215714285714294,0.051250574872267335,0.0573535,0.05866457306171456,19915.0,17602432.533333328,46304.0,17172925.014285717
2020-10-10,0.05351,0.05625,0.052,0.05217,21746139.1,5589.0,13720811.0,0.052303333333333334,0.050217142857142856,0.055939499999999996,0.051812526954458704,0.05193032336565037,0.057613947562990826,43.67041198501873,0.06999856858486145,0.041880431415138544,-0.006874696091033021,-0.00749714997411789,0.0006224538830848694,0.004250000000000004,0.007188571428571429,389921385.67999923,-0.016709999999999996,-11.471237060919737,-72.63575350823673,27.36424649176326,27.770998576367713,-2.504204821528688,0.05109,0.05517,0.0485,0.05365,23158701.6,7549.0,13158809.3,5.010765316108827,43.08943089430895,0.07130687743715386,0.041981122562846133,-0.007261756068589767,-0.007652763444889107,0.0003910073762993403,0.006669999999999995,0.0072614285714285715,411667524.77999926,-0.017710000000000004,-12.236217896286593,-68.12080536912751,31.879194630872483,21.868816982943773,0.05038666666666667,0.05145505390891741,0.05005571428571428,0.0518504311542005,0.05664399999999999,0.0581869946748846,20823.0,17485197.499999993,42847.0,16688098.0
2020-10-11,0.05223,0.05448,0.05002,0.05378,21135253.9,4020.0,14770700.2,0.053200000000000004,0.05042142857142857,0.055752499999999997,0.05279626347722935,0.05239274252423778,0.05724880969984884,45.0091407678245,0.06982254114759054,0.041682458852409454,-0.006364666808434054,-0.007270653340981124,0.0009059865325470699,0.004459999999999999,0.007034285714285714,411056639.5799992,-0.007879999999999998,-9.216745442268737,-67.72422208663819,32.2757779133618,30.506406345332522,2.9676431169825825,0.05351,0.05625,0.052,0.05217,21746139.1,5589.0,13720811.0,-2.504204821528688,43.67041198501873,0.06999856858486145,0.041880431415138544,-0.006874696091033021,-0.00749714997411789,0.0006224538830848694,0.004250000000000004,0.007188571428571429,389921385.67999923,-0.016709999999999996,-11.471237060919737,-72.63575350823673,27.36424649176326,27.770998576367713,0.052303333333333334,0.051812526954458704,0.050217142857142856,0.05193032336565037,0.055939499999999996,0.057613947562990826,21170.0,16237900.86666666,42720.0,16632534.885714287
2020-10-12,0.05384,0.0587,0.05288,0.05404,37288496.3,9619.0,22310861.3,0.05333000000000001,0.05074571428571429,0.0556965,0.05341813173861468,0.05280455689317833,0.056943208776053716,41.71672156558806,0.06978537321332715,0.04160762678667287,-0.0058717986604327616,-0.006990882404871452,0.0011190837444386903,0.005819999999999999,0.006782857142857142,448345135.8799992,-0.0007300000000000015,-13.66032912605849,-66.93105552165957,33.068944478340434,30.902989627821842,0.3714710252600275,0.05223,0.05448,0.05002,0.05378,21135253.9,4020.0,14770700.2,2.9676431169825825,45.0091407678245,0.06982254114759054,0.041682458852409454,-0.006364666808434054,-0.007270653340981124,0.0009059865325470699,0.004459999999999999,0.007034285714285714,411056639.5799992,-0.007879999999999998,-9.216745442268737,-67.72422208663819,32.2757779133618,30.506406345332522,0.053200000000000004,0.05279626347722935,0.05042142857142857,0.05239274252423778,0.055752499999999997,0.05724880969984884,17158.0,13883440.166666659,41708.0,16350312.157142859
2020-10-13,0.05402,0.058,0.05174,0.053,26254553.3,6169.0,16593949.7,0.053606666666666664,0.05202142857142857,0.055979,0.053209065869307334,0.052853417669883745,0.056567665083096214,29.07930720145852,0.06958138818041451,0.04237661181958549,-0.0055016962805407715,-0.006693045180005316,0.0011913488994645446,0.006260000000000002,0.006427142857142858,422090582.5799992,0.0019599999999999965,-25.728699551569512,-70.10372178157415,29.896278218425852,31.747000203376043,-1.8881895594224363,0.05384,0.0587,0.05288,0.05404,37288496.3,9619.0,22310861.3,0.3714710252600275,41.71672156558806,0.06978537321332715,0.04160762678667287,-0.0058717986604327616,-0.006990882404871452,0.0011190837444386903,0.005819999999999999,0.006782857142857142,448345135.8799992,-0.0007300000000000015,-13.66032912605849,-66.93105552165957,33.068944478340434,30.902989627821842,0.05333000000000001,0.05341813173861468,0.05074571428571429,0.05280455689317833,0.0556965,0.056943208776053716,19228.0,16934124.16666666,46692.0,16681211.342857141
2020-10-14,0.05301,0.05432,0.0496,0.05191,19566719.8,4315.0,13456028.6,0.052983333333333334,0.05280571428571429,0.0556925,0.052559532934653666,0.052617563252412805,0.05612407793232515,30.03059543421982,0.06938863679685074,0.041996363203149256,-0.0052359842019297845,-0.006401632984390211,0.0011656487824604263,0.004720000000000002,0.006139285714285714,402523862.7799992,-0.0004400000000000029,-24.63704994192799,-69.79889042995842,30.20110957004159,31.055444088935968,-2.075080173552167,0.05402,0.058,0.05174,0.053,26254553.3,6169.0,16593949.7,-1.8881895594224363,29.07930720145852,0.06958138818041451,0.04237661181958549,-0.0055016962805407715,-0.006693045180005316,0.0011913488994645446,0.006260000000000002,0.006427142857142858,422090582.5799992,0.0019599999999999965,-25.728699551569512,-70.10372178157415,29.896278218425852,31.747000203376043,0.053606666666666664,0.053209065869307334,0.05202142857142857,0.052853417669883745,0.055979,0.056567665083096214,19808.0,17891837.06666666,46220.0,17121702.1
2020-10-15,0.05191,0.05198,0.0485,0.05039,22648498.8,4212.0,16313092.9,0.05176666666666666,0.052705714285714286,0.0551555,0.051474766467326835,0.052060672439309605,0.05557797527210371,34.68333786354988,0.06879605481971421,0.041514945180285805,-0.0050893894485800895,-0.006139184277228187,0.0010497948286480978,0.003479999999999997,0.005527857142857142,379875363.9799992,-0.0013799999999999993,-18.277651638014923,-61.13513513513516,38.86486486486484,32.987417551110774,-2.92814486611443,0.05301,0.05432,0.0496,0.05191,19566719.8,4315.0,13456028.6,-2.075080173552167,30.03059543421982,0.06938863679685074,0.041996363203149256,-0.0052359842019297845,-0.006401632984390211,0.0011656487824604263,0.004720000000000002,0.006139285714285714,402523862.7799992,-0.0004400000000000029,-24.63704994192799,-69.79889042995842,30.20110957004159,31.055444088935968,0.052983333333333334,0.052559532934653666,0.05280571428571429,0.052617563252412805,0.0556925,0.05612407793232515,20103.0,17453613.19999999,45293.0,16549320.342857143
2020-10-16,0.05035,0.05198,0.0434,0.04366,37966570.9,7716.0,22127908.7,0.04865333333333333,0.05127857142857143,0.05439200000000001,0.04756738323366341,0.0499605043294822,0.05444293000809383,34.83483483483484,0.06882914886563744,0.039954851134362576,-0.00545340336605734,-0.006002028094994017,0.0005486247289366777,0.008579999999999997,0.005492857142857141,341908793.0799992,-0.00041000000000000064,-20.28482746028848,-97.03225806451616,2.9677419354838395,24.011238790130104,-13.28699106256207,0.05191,0.05198,0.0485,0.05039,22648498.8,4212.0,16313092.9,-2.92814486611443,34.68333786354988,0.06879605481971421,0.041514945180285805,-0.0050893894485800895,-0.006139184277228187,0.0010497948286480978,0.003479999999999997,0.005527857142857142,379875363.9799992,-0.0013799999999999993,-18.277651638014923,-61.13513513513516,38.86486486486484,32.987417551110774,0.05176666666666666,0.051474766467326835,0.052705714285714286,0.052060672439309605,0.0551555,0.05557797527210371,14696.0,15454357.066666657,41473.0,15760607.57142857
2020-10-17,0.04367,0.0475,0.04338,0.0472,22343037.0,4441.0,15728104.4,0.04708333333333333,0.05056857142857143,0.05378999999999999,0.0473836916168317,0.04927037824711165,0.05375312715018013,44.73106476399561,0.06837926930821155,0.03920073069178843,-0.005394059245949122,-0.005880434325185038,0.00048637507923591627,0.004119999999999999,0.005418571428571427,364251830.0799992,0.000779999999999996,-7.523510971786839,-74.1935483870968,25.806451612903203,22.546352804417307,8.083352415846115,0.05035,0.05198,0.0434,0.04366,37966570.9,7716.0,22127908.7,-13.28699106256207,34.83483483483484,0.06882914886563744,0.039954851134362576,-0.00545340336605734,-0.006002028094994017,0.0005486247289366777,0.008579999999999997,0.005492857142857141,341908793.0799992,-0.00041000000000000064,-20.28482746028848,-97.03225806451616,2.9677419354838395,24.011238790130104,0.04865333333333333,0.04756738323366341,0.05127857142857143,0.0499605043294822,0.05439200000000001,0.05444293000809383,16243.0,17299010.06666666,41640.0,17041907.485714287
2020-10-18,0.04723,0.0506,0.04608,0.04868,23852214.3,5373.0,15743547.1,0.04651333333333333,0.04984,0.0530945,0.04803184580841585,0.04912278368533374,0.05326997218349631,44.987708276427206,0.06723678370600762,0.038952216293992384,-0.005168031126252373,-0.005737953685398506,0.0005699225591461327,0.004519999999999996,0.00557142857142857,388104044.3799992,-0.0024100000000000024,-7.01050620821394,-64.64516129032259,35.35483870967741,21.376344086021493,3.0700825746347657,0.04367,0.0475,0.04338,0.0472,22343037.0,4441.0,15728104.4,8.083352415846115,44.73106476399561,0.06837926930821155,0.03920073069178843,-0.005394059245949122,-0.005880434325185038,0.00048637507923591627,0.004119999999999999,0.005418571428571427,364251830.0799992,0.000779999999999996,-7.523510971786839,-74.1935483870968,25.806451612903203,22.546352804417307,0.04708333333333333,0.0473836916168317,0.05056857142857143,0.04927037824711165,0.05378999999999999,0.05375312715018013,16369.0,18056368.66666666,40492.0,17328663.685714286
2020-10-19,0.04874,0.052,0.04653,0.05006,31886709.0,5417.0,22159129.4,0.048646666666666664,0.04927142857142857,0.05202949999999999,0.04904592290420792,0.0493570877640003,0.05296426054697285,47.714514835605456,0.06329579902338682,0.040763200976613165,-0.004821963156390226,-0.00555475557959685,0.0007327924232066246,0.005469999999999996,0.0057057142857142844,419990753.3799992,-0.003590000000000003,-3.3030712768012283,-55.741935483870975,44.25806451612902,35.13978494623655,2.7082478457119445,0.04723,0.0506,0.04608,0.04868,23852214.3,5373.0,15743547.1,3.0700825746347657,44.987708276427206,0.06723678370600762,0.038952216293992384,-0.005168031126252373,-0.005737953685398506,0.0005699225591461327,0.004519999999999996,0.00557142857142857,388104044.3799992,-0.0024100000000000024,-7.01050620821394,-64.64516129032259,35.35483870967741,21.376344086021493,0.04651333333333333,0.04803184580841585,0.04984,0.04912278368533374,0.0530945,0.05326997218349631,17530.0,17866520.06666666,41845.0,17467641.814285714
2020-10-20,0.05017,0.05237,0.04436,0.04514,34482008.2,8105.0,19364117.8,0.04796,0.04814857142857143,0.0508425,0.04709296145210396,0.04830281582300022,0.052219092875832575,51.54490326306671,0.05928127734971434,0.042403722650285657,-0.004888354767963871,-0.005421475417270254,0.0005331206493063836,0.008010000000000003,0.005707142857142855,385508745.17999923,-0.0070300000000000015,2.4279555253006624,-87.48387096774195,12.516129032258046,30.709677419354836,-10.025911899541558,0.04874,0.052,0.04653,0.05006,31886709.0,5417.0,22159129.4,2.7082478457119445,47.714514835605456,0.06329579902338682,0.040763200976613165,-0.004821963156390226,-0.00555475557959685,0.0007327924232066246,0.005469999999999996,0.0057057142857142844,419990753.3799992,-0.003590000000000003,-3.3030712768012283,-55.741935483870975,44.25806451612902,35.13978494623655,0.048646666666666664,0.04904592290420792,0.04927142857142857,0.0493570877640003,0.05202949999999999,0.05296426054697285,15231.0,17876926.966666657,37643.0,17445965.828571428
2020-10-21,0.04505,0.04831,0.04476,0.04545,34022496.9,6369.0,21081296.2,0.04688333333333333,0.04722571428571428,0.050032,0.04627148072605198,0.047589611867250164,0.05157441736384852,48.51181343970542,0.05709836391275782,0.04296563608724218,-0.004859933896484939,-0.005309167113113191,0.00044923321662825207,0.0035499999999999976,0.005707142857142855,419531242.0799992,-0.008330000000000004,-2.089616544592865,-85.48387096774196,14.516129032258032,23.76344086021504,0.8879023307436128,0.05017,0.05237,0.04436,0.04514,34482008.2,8105.0,19364117.8,-10.025911899541558,51.54490326306671,0.05928127734971434,0.042403722650285657,-0.004888354767963871,-0.005421475417270254,0.0005331206493063836,0.008010000000000003,0.005707142857142855,385508745.17999923,-0.0070300000000000015,2.4279555253006624,-87.48387096774195,12.516129032258046,30.709677419354836,0.04796,0.04709296145210396,0.04814857142857143,0.04830281582300022,0.0508425,0.052219092875832575,18895.0,19088931.433333326,39579.0,17841704.12857143
2020-10-22,0.04564,0.051,0.04558,0.04901,33790561.9,7194.0,20170063.1,0.046533333333333336,0.047028571428571427,0.049744,0.047640740363025985,0.04794470890043762,0.05133018713872008,46.69631512071155,0.05645802428543574,0.04302997571456425,-0.004498294365879112,-0.005146992563666375,0.0006486981977872636,0.005419999999999994,0.005380714285714285,453321803.9799992,-0.00503,-4.071246819338437,-63.25065274151439,36.749347258485614,21.26053510766724,7.3838737949167355,0.04505,0.04831,0.04476,0.04545,34022496.9,6369.0,21081296.2,0.8879023307436128,48.51181343970542,0.05709836391275782,0.04296563608724218,-0.004859933896484939,-0.005309167113113191,0.00044923321662825207,0.0035499999999999976,0.005707142857142855,419531242.0799992,-0.008330000000000004,-2.089616544592865,-85.48387096774196,14.516129032258032,23.76344086021504,0.04688333333333333,0.04627148072605198,0.04722571428571428,0.047589611867250164,0.050032,0.05157441736384852,19891.0,20868181.133333325,41633.0,18931028.07142857
2020-10-23,0.0491,0.05349,0.04808,0.05312,30044464.3,7000.0,18095039.3,0.04919333333333333,0.04838,0.049847999999999996,0.05038037018151299,0.04923853167532822,0.051500645506461024,49.197699061459275,0.05670937196654689,0.0429866280334531,-0.003835832689582472,-0.004884760588849594,0.0010489278992671224,0.005410000000000005,0.005290714285714286,483366268.2799992,0.00012000000000000205,-0.9878844361603023,-36.42297650130549,63.57702349869451,38.280833263146064,8.187372708757644,0.04564,0.051,0.04558,0.04901,33790561.9,7194.0,20170063.1,7.3838737949167355,46.69631512071155,0.05645802428543574,0.04302997571456425,-0.004498294365879112,-0.005146992563666375,0.0006486981977872636,0.005419999999999994,0.005380714285714285,453321803.9799992,-0.00503,-4.071246819338437,-63.25065274151439,36.749347258485614,21.26053510766724,0.046533333333333336,0.047640740363025985,0.047028571428571427,0.04794470890043762,0.049744,0.05133018713872008,21668.0,20205159.033333328,44615.0,19482023.814285714
2020-10-24,0.05318,0.0577,0.05152,0.05642,31180127.9,7673.0,20400599.6,0.05285,0.04969714285714285,0.05005149999999999,0.053400185090756495,0.051033898756496165,0.05196915545822664,56.09756097560975,0.05744602791989131,0.04265697208010867,-0.003009848952431747,-0.004509778261566025,0.0014999293091342777,0.006179999999999998,0.005428571428571428,514546396.1799992,0.00451,8.146444316657075,-14.88250652741517,85.11749347258483,61.81462140992166,6.092515983452426,0.0491,0.05349,0.04808,0.05312,30044464.3,7000.0,18095039.3,8.187372708757644,49.197699061459275,0.05670937196654689,0.0429866280334531,-0.003835832689582472,-0.004884760588849594,0.0010489278992671224,0.005410000000000005,0.005290714285714286,483366268.2799992,0.00012000000000000205,-0.9878844361603023,-36.42297650130549,63.57702349869451,38.280833263146064,0.04919333333333333,0.05038037018151299,0.04838,0.04923853167532822,0.049847999999999996,0.051500645506461024,20563.0,19782132.86666666,43899.0,18905899.614285715
2020-10-25,0.05636,0.0576,0.05082,0.0511,39395324.4,8619.0,22460273.8,0.053546666666666666,0.050042857142857146,0.05001799999999999,0.05225009254537825,0.051050424067372126,0.05188637874791934,46.52489626556016,0.05738576935464971,0.04265023064535028,-0.002752797888254603,-0.004158382186903741,0.001405584298649138,0.006780000000000001,0.005594285714285713,475151071.7799992,0.0007100000000000023,-4.983265154332472,-49.60835509138383,50.39164490861617,66.36205395996518,-9.332860184528036,0.05318,0.0577,0.05152,0.05642,31180127.9,7673.0,20400599.6,6.092515983452426,56.09756097560975,0.05744602791989131,0.04265697208010867,-0.003009848952431747,-0.004509778261566025,0.0014999293091342777,0.006179999999999998,0.005428571428571428,514546396.1799992,0.00451,8.146444316657075,-14.88250652741517,85.11749347258483,61.81462140992166,0.05285,0.053400185090756495,0.04969714285714285,0.051033898756496165,0.05005149999999999,0.05196915545822664,21867.0,19555233.999999996,47131.0,19573398.92857143
2020-10-26,0.0511,0.05301,0.04628,0.04778,38711997.8,10286.0,21534270.4,0.05176666666666666,0.049717142857142856,0.0502035,0.05001504627268913,0.05023281805052909,0.051495295057641305,42.47957712638156,0.05711330775116444,0.04329369224883556,-0.0027848769930929745,-0.0038836811481415883,0.0010988041550486138,0.00673,0.005659285714285713,436439073.9799992,0.004120000000000006,-11.584011843079189,-69.90424076607387,30.095759233926135,55.20163253837572,-6.497064579256354,0.05636,0.0576,0.05082,0.0511,39395324.4,8619.0,22460273.8,-9.332860184528036,46.52489626556016,0.05738576935464971,0.04265023064535028,-0.002752797888254603,-0.004158382186903741,0.001405584298649138,0.006780000000000001,0.005594285714285713,475151071.7799992,0.0007100000000000023,-4.983265154332472,-49.60835509138383,50.39164490861617,66.36205395996518,0.053546666666666666,0.05225009254537825,0.050042857142857146,0.051050424067372126,0.05001799999999999,0.05188637874791934,23292.0,20318637.56666666,50377.0,20532931.314285718
2020-10-27,0.04782,0.04859,0.04556,0.04683,27875526.0,7342.0,15860499.9,0.04857,0.04995857142857142,0.050224000000000005,0.04842252313634456,0.049382113537896816,0.051050981242627844,42.571634962677585,0.05708883150405783,0.04335916849594218,-0.002854057180723117,-0.0036777563546578945,0.0008236991739347774,0.003029999999999998,0.005428571428571428,408563547.9799992,-0.00037000000000000227,-11.641509433962272,-75.90782122905031,24.092178770949683,34.859860971164004,-2.070263488080311,0.0511,0.05301,0.04628,0.04778,38711997.8,10286.0,21534270.4,-6.497064579256354,42.47957712638156,0.05711330775116444,0.04329369224883556,-0.0027848769930929745,-0.0038836811481415883,0.0010988041550486138,0.00673,0.005659285714285713,436439073.9799992,0.004120000000000006,-11.584011843079189,-69.90424076607387,30.095759233926135,55.20163253837572,0.05176666666666666,0.05001504627268913,0.049717142857142856,0.05023281805052909,0.0502035,0.051495295057641305,26578.0,21465047.933333326,55246.0,20443665.74285714
2020-10-28,0.04671,0.04737,0.0435,0.04518,27523441.8,6197.0,13931128.3,0.04659666666666667,0.04992,0.0499285,0.046801261568172284,0.04833158515342261,0.050491840171901385,42.00522689474935,0.05713658982654393,0.04272041017345607,-0.0030073572458951814,-0.0035436765329053517,0.0005363192870101703,0.0038700000000000054,0.005367857142857141,381040106.1799992,-0.003500000000000003,-12.964746676940864,-87.43016759776539,12.56983240223461,22.252590135703485,-3.2755298651252485,0.04782,0.04859,0.04556,0.04683,27875526.0,7342.0,15860499.9,-2.070263488080311,42.571634962677585,0.05708883150405783,0.04335916849594218,-0.002854057180723117,-0.0036777563546578945,0.0008236991739347774,0.003029999999999998,0.005428571428571428,408563547.9799992,-0.00037000000000000227,-11.641509433962272,-75.90782122905031,24.092178770949683,34.859860971164004,0.04857,0.04842252313634456,0.04995857142857142,0.049382113537896816,0.050224000000000005,0.051050981242627844,26247.0,19951681.366666656,54483.0,19943148.900000002
2020-10-29,0.04509,0.0477,0.04382,0.04583,26187300.6,5267.0,16611122.9,0.04594666666666667,0.049465714285714286,0.0495375,0.04631563078408614,0.04770618886506696,0.050047855393625065,44.468704512372646,0.05674399086077778,0.04233100913922222,-0.0030413404052648044,-0.0034432093073772426,0.00040186890211243824,0.0038800000000000015,0.00539642857142857,407227406.7799992,-0.004229999999999998,-9.049414566382207,-82.89106145251395,17.108938547486037,17.92364990689012,1.6411621202040465,0.04671,0.04737,0.0435,0.04518,27523441.8,6197.0,13931128.3,-3.2755298651252485,42.00522689474935,0.05713658982654393,0.04272041017345607,-0.0030073572458951814,-0.0035436765329053517,0.0005363192870101703,0.0038700000000000054,0.005367857142857141,381040106.1799992,-0.003500000000000003,-12.964746676940864,-87.43016759776539,12.56983240223461,22.252590135703485,0.04659666666666667,0.046801261568172284,0.04992,0.04833158515342261,0.0499285,0.050491840171901385,23825.0,17108632.86666666,54311.0,18921696.342857145
2020-10-30,0.04576,0.04602,0.04351,0.04512,22327018.2,4423.0,14252083.5,0.04537666666666667,0.04832285714285715,0.049185,0.045717815392043074,0.04705964164880022,0.049578535832327436,52.07386363636364,0.056537526239696205,0.041832473760303794,-0.0030899444143975344,-0.003372556328781301,0.0002826119143837665,0.0025099999999999983,0.004962857142857142,384900388.5799992,-1.9999999999999185e-05,3.344021988089785,-87.84916201117319,12.150837988826806,13.943202979515826,-1.3986013986014023,0.04509,0.0477,0.04382,0.04583,26187300.6,5267.0,16611122.9,1.6411621202040465,44.468704512372646,0.05674399086077778,0.04233100913922222,-0.0030413404052648044,-0.0034432093073772426,0.00040186890211243824,0.0038800000000000015,0.00539642857142857,407227406.7799992,-0.004229999999999998,-9.049414566382207,-82.89106145251395,17.108938547486037,17.92364990689012,0.04594666666666667,0.04631563078408614,0.049465714285714286,0.04770618886506696,0.0495375,0.050047855393625065,18806.0,15467583.699999994,52384.0,18413276.314285718
2020-10-31,0.0452,0.04687,0.04387,0.04405,23523066.6,3896.0,16916807.3,0.045000000000000005,0.04655571428571429,0.0486985,0.04488390769602153,0.04630723123660017,0.04905200861020101,45.18790100824931,0.056058475042874624,0.041338524957125374,-0.0031781675621294775,-0.0033336785754509365,0.00015551101332145906,0.0030000000000000027,0.004882857142857143,361377321.9799992,-0.0013999999999999985,-6.673728813559321,-96.12676056338026,3.8732394366197305,11.044338657644202,-2.5442477876106158,0.04576,0.04602,0.04351,0.04512,22327018.2,4423.0,14252083.5,-1.3986013986014023,52.07386363636364,0.056537526239696205,0.041832473760303794,-0.0030899444143975344,-0.003372556328781301,0.0002826119143837665,0.0025099999999999983,0.004962857142857142,384900388.5799992,-1.9999999999999185e-05,3.344021988089785,-87.84916201117319,12.150837988826806,13.943202979515826,0.04537666666666667,0.045717815392043074,0.04832285714285715,0.04705964164880022,0.049185,0.049578535832327436,15887.0,14931444.899999993,49807.0,17864282.62857143
2020-11-01,0.04405,0.04576,0.04372,0.04523,18396410.0,3658.0,10575330.5,0.0448,0.04571714285714285,0.048258,0.04505695384801077,0.046037923427450125,0.04868800779018186,44.68085106382978,0.05532045700500379,0.04119554299499621,-0.0031169387740319424,-0.003290330615167138,0.00017339184113519552,0.00204,0.004705714285714285,379773731.9799992,-0.0037799999999999986,-7.087099424815124,-87.81690140845069,12.183098591549308,9.402392005665291,2.6787741203178217,0.0452,0.04687,0.04387,0.04405,23523066.6,3896.0,16916807.3,-2.5442477876106158,45.18790100824931,0.056058475042874624,0.041338524957125374,-0.0031781675621294775,-0.0033336785754509365,0.00015551101332145906,0.0030000000000000027,0.004882857142857143,361377321.9799992,-0.0013999999999999985,-6.673728813559321,-96.12676056338026,3.8732394366197305,11.044338657644202,0.045000000000000005,0.04488390769602153,0.04655571428571429,0.04630723123660017,0.0486985,0.04905200861020101,13586.0,15926671.233333325,46030.0,17366598.014285717
2020-11-02,0.04542,0.04629,0.04012,0.0404,35114303.0,7158.0,16113056.8,0.04322666666666667,0.044662857142857136,0.047628000000000004,0.04272847692400539,0.044628442570587595,0.04789867371492645,36.53846153846153,0.05514283473223402,0.04011316526776599,-0.0034187459768155667,-0.003316013687496824,-0.00010273228931874292,0.006169999999999995,0.004755714285714286,344659428.9799992,-0.012720000000000002,-19.296843787455053,-98.40728100113768,1.5927189988623185,5.883019009010461,-11.052399823866146,0.04405,0.04576,0.04372,0.04523,18396410.0,3658.0,10575330.5,2.6787741203178217,44.68085106382978,0.05532045700500379,0.04119554299499621,-0.0031169387740319424,-0.003290330615167138,0.00017339184113519552,0.00204,0.004705714285714285,379773731.9799992,-0.0037799999999999986,-7.087099424815124,-87.81690140845069,12.183098591549308,9.402392005665291,0.0448,0.04505695384801077,0.04571714285714285,0.046037923427450125,0.048258,0.04868800779018186,11977.0,13914740.433333328,41069.0,15668748.971428573
2020-11-03,0.04038,0.04078,0.03699,0.03699,22796705.0,5743.0,10930252.1,0.04087333333333334,0.04325714285714286,0.046882,0.03985923846200269,0.042718831927940695,0.046859752408742975,38.14372999709049,0.0554897898624414,0.0382742101375586,-0.0038882673353860323,-0.003430464417074666,-0.0004578029183113664,0.0037899999999999948,0.004454285714285714,321862723.9799992,-0.019429999999999996,-18.05494018608772,-100.0,0.0,4.591939196803885,-8.395245170876665,0.04542,0.04629,0.04012,0.0404,35114303.0,7158.0,16113056.8,-11.052399823866146,36.53846153846153,0.05514283473223402,0.04011316526776599,-0.0034187459768155667,-0.003316013687496824,-0.00010273228931874292,0.006169999999999995,0.004755714285714286,344659428.9799992,-0.012720000000000002,-19.296843787455053,-98.40728100113768,1.5927189988623185,5.883019009010461,0.04322666666666667,0.04272847692400539,0.044662857142857136,0.044628442570587595,0.047628000000000004,0.04789867371492645,14712.0,14535064.86666666,37941.0,14894289.885714287
2020-11-04,0.03718,0.03985,0.03678,0.03956,23540196.6,4076.0,12529070.8,0.038983333333333335,0.042454285714285715,0.0463405,0.039709619231001345,0.04192912394595552,0.046164537893624596,41.96014196014197,0.05537129987132642,0.03730970012867358,-0.0040068009657715994,-0.003545731726814053,-0.0004610692389575466,0.0030699999999999963,0.0044199999999999995,345402920.5799992,-0.011540000000000002,-12.959295929592962,-86.7112810707457,13.288718929254289,4.960479309372212,6.401291016675632,0.04038,0.04078,0.03699,0.03699,22796705.0,5743.0,10930252.1,-8.395245170876665,38.14372999709049,0.0554897898624414,0.0382742101375586,-0.0038882673353860323,-0.003430464417074666,-0.0004578029183113664,0.0037899999999999948,0.004454285714285714,321862723.9799992,-0.019429999999999996,-18.05494018608772,-100.0,0.0,4.591939196803885,0.04087333333333334,0.03985923846200269,0.04325714285714286,0.042718831927940695,0.046882,0.046859752408742975,16559.0,12539546.46666666,36342.0,14189968.77142857
2020-11-05,0.0395,0.041,0.0372,0.03972,33036826.8,5392.0,19727021.2,0.03875666666666667,0.04158142857142856,0.0461435,0.03971480961550067,0.04137684295946664,0.045550772379946064,36.0216671682215,0.0555831437823152,0.036703856217684794,-0.00404124411247514,-0.0036448342039462705,-0.00039640990852886923,0.0038000000000000048,0.0043042857142857145,378439747.3799992,-0.008060000000000005,-18.955315241787385,-85.94646271510517,14.05353728489483,9.114085404716382,0.5569620253164506,0.03718,0.03985,0.03678,0.03956,23540196.6,4076.0,12529070.8,6.401291016675632,41.96014196014197,0.05537129987132642,0.03730970012867358,-0.0040068009657715994,-0.003545731726814053,-0.0004610692389575466,0.0030699999999999963,0.0044199999999999995,345402920.5799992,-0.011540000000000002,-12.959295929592962,-86.7112810707457,13.288718929254289,4.960479309372212,0.038983333333333335,0.039709619231001345,0.042454285714285715,0.04192912394595552,0.0463405,0.046164537893624596,16977.0,13190793.233333327,34221.0,13989674.842857143
2020-11-06,0.0399,0.04523,0.03956,0.04374,37269901.9,6783.0,22745807.9,0.041006666666666663,0.041384285714285714,0.045970500000000004,0.041727404807750335,0.04196763221959998,0.045378317867570246,35.84791792395896,0.05545533215733371,0.0364856678426663,-0.0037014916591804753,-0.0036561656949931115,-4.532596418736377e-05,0.005670000000000001,0.004322857142857143,415709649.2799992,-0.0030899999999999955,-17.658132530120486,-66.73040152963671,33.26959847036329,20.203951561504145,9.624060150375948,0.0395,0.041,0.0372,0.03972,33036826.8,5392.0,19727021.2,0.5569620253164506,36.0216671682215,0.0555831437823152,0.036703856217684794,-0.00404124411247514,-0.0036448342039462705,-0.00039640990852886923,0.0038000000000000048,0.0043042857142857145,378439747.3799992,-0.008060000000000005,-18.955315241787385,-85.94646271510517,14.05353728489483,9.114085404716382,0.03875666666666667,0.03971480961550067,0.04158142857142856,0.04137684295946664,0.0461435,0.045550772379946064,15211.0,14395448.033333326,34346.0,14434803.17142857
2020-11-07,0.04374,0.04919,0.03893,0.04005,46949319.4,10410.0,27288541.7,0.041170000000000005,0.040812857142857144,0.045538999999999996,0.04088870240387517,0.04148822416469999,0.04487085902303975,25.589024753951705,0.05528640753658996,0.03579159246341003,-0.0036874805728763366,-0.003662428670569757,-2.5051902306579606e-05,0.010259999999999998,0.004614285714285714,368760329.8799992,-0.005129999999999996,-29.014533853243528,-84.29394812680114,15.70605187319886,21.00972920948567,-8.436213991769545,0.0399,0.04523,0.03956,0.04374,37269901.9,6783.0,22745807.9,9.624060150375948,35.84791792395896,0.05545533215733371,0.0364856678426663,-0.0037014916591804753,-0.0036561656949931115,-4.532596418736377e-05,0.005670000000000001,0.004322857142857143,415709649.2799992,-0.0030899999999999955,-17.658132530120486,-66.73040152963671,33.26959847036329,20.203951561504145,0.041006666666666663,0.041727404807750335,0.041384285714285714,0.04196763221959998,0.045970500000000004,0.045378317867570246,16251.0,18333966.633333325,36706.0,15648192.37142857
2020-11-08,0.04005,0.04448,0.03955,0.04196,30190063.7,5872.0,17279048.9,0.041916666666666665,0.04034571428571428,0.045133999999999994,0.04142435120193758,0.04160616812352499,0.04459363435417882,34.8273572377158,0.054762861002771134,0.035505138997228854,-0.0034821159830611056,-0.003626366133068027,0.00014425015000692123,0.004929999999999997,0.004482142857142857,398950393.5799992,-0.0038700000000000054,-17.886497064579267,-68.08379544054223,31.91620455945777,26.96395163433998,4.769038701622959,0.04374,0.04919,0.03893,0.04005,46949319.4,10410.0,27288541.7,-8.436213991769545,25.589024753951705,0.05528640753658996,0.03579159246341003,-0.0036874805728763366,-0.003662428670569757,-2.5051902306579606e-05,0.010259999999999998,0.004614285714285714,368760329.8799992,-0.005129999999999996,-29.014533853243528,-84.29394812680114,15.70605187319886,21.00972920948567,0.041170000000000005,0.04088870240387517,0.040812857142857144,0.04148822416469999,0.045538999999999996,0.04487085902303975,22585.0,23253790.266666662,43220.0,17129868.714285713
2020-11-09,0.04196,0.04305,0.0392,0.04225,29658642.3,7309.0,16779228.1,0.041420000000000005,0.04061,0.0449895,0.04183717560096879,0.04176712609264374,0.044370431082352266,39.793281653746774,0.05470433829809099,0.035274661701909016,-0.003258401663598337,-0.003552773239174089,0.00029437157557575186,0.0038499999999999993,0.004276428571428571,428609035.8799992,-0.0028699999999999976,-11.573880284637927,-55.92264302981464,44.07735697018536,30.56653780094734,0.6911344137273726,0.04005,0.04448,0.03955,0.04196,30190063.7,5872.0,17279048.9,4.769038701622959,34.8273572377158,0.054762861002771134,0.035505138997228854,-0.0034821159830611056,-0.003626366133068027,0.00014425015000692123,0.004929999999999997,0.004482142857142857,398950393.5799992,-0.0038700000000000054,-17.886497064579267,-68.08379544054223,31.91620455945777,26.96395163433998,0.041916666666666665,0.04142435120193758,0.04034571428571428,0.04160616812352499,0.045133999999999994,0.04459363435417882,23065.0,22437799.49999999,45434.0,18087542.77142857
2020-11-10,0.0423,0.04773,0.04136,0.0457,41682448.5,11015.0,21224418.8,0.04330333333333333,0.04185428571428572,0.045002,0.0437685878004844,0.042750344569482804,0.044497056693556816,48.09057113889827,0.05471997596427702,0.03528402403572298,-0.002770780454177668,-0.003396374682174805,0.0006255942279971369,0.006370000000000001,0.004514999999999999,470291484.3799992,0.0016499999999999987,-2.412983130471913,-28.12248186946012,71.87751813053988,49.290359886727686,8.037825059101655,0.04196,0.04305,0.0392,0.04225,29658642.3,7309.0,16779228.1,0.6911344137273726,39.793281653746774,0.05470433829809099,0.035274661701909016,-0.003258401663598337,-0.003552773239174089,0.00029437157557575186,0.0038499999999999993,0.004276428571428571,428609035.8799992,-0.0028699999999999976,-11.573880284637927,-55.92264302981464,44.07735697018536,30.56653780094734,0.041420000000000005,0.04183717560096879,0.04061,0.04176712609264374,0.0449895,0.044370431082352266,23591.0,20448939.56666666,45585.0,18182710.1
2020-11-11,0.04572,0.04915,0.04406,0.04484,39715356.2,7435.0,27224703.4,0.04426333333333333,0.04260857142857143,0.0447935,0.044304293900242195,0.043272758427112104,0.04452971796083712,49.40972222222222,0.054326580962193685,0.035260419037806315,-0.0024257691880597287,-0.00320225358335179,0.0007764843952920613,0.005089999999999997,0.004602142857142856,430576128.17999923,-0.00039000000000000146,-0.7525453740593213,-35.05237711522966,64.94762288477034,60.30083266183187,-1.924759405074363,0.0423,0.04773,0.04136,0.0457,41682448.5,11015.0,21224418.8,8.037825059101655,48.09057113889827,0.05471997596427702,0.03528402403572298,-0.002770780454177668,-0.003396374682174805,0.0006255942279971369,0.006370000000000001,0.004514999999999999,470291484.3799992,0.0016499999999999987,-2.412983130471913,-28.12248186946012,71.87751813053988,49.290359886727686,0.04330333333333333,0.0437685878004844,0.04185428571428572,0.042750344569482804,0.045002,0.044497056693556816,24196.0,18427565.266666654,50857.0,19653305.342857145
2020-11-12,0.0449,0.04675,0.041,0.04173,31411823.5,6150.0,18904470.4,0.04409,0.04289571428571428,0.044224,0.0430171469501211,0.04288706882033408,0.04426307815504311,43.442098528470886,0.05299291735501643,0.035455082644983565,-0.0023759082908099555,-0.0030369845248434234,0.000661076234033468,0.005749999999999998,0.004735714285714285,399164304.67999923,0.0013300000000000048,-8.94610517128518,-60.112812248186906,39.88718775181309,58.904109589041106,-7.06013363028953,0.04572,0.04915,0.04406,0.04484,39715356.2,7435.0,27224703.4,-1.924759405074363,49.40972222222222,0.054326580962193685,0.035260419037806315,-0.0024257691880597287,-0.00320225358335179,0.0007764843952920613,0.005089999999999997,0.004602142857142856,430576128.17999923,-0.00039000000000000146,-0.7525453740593213,-35.05237711522966,64.94762288477034,60.30083266183187,0.04426333333333333,0.044304293900242195,0.04260857142857143,0.043272758427112104,0.0447935,0.04452971796083712,25759.0,21742783.433333326,54216.0,21752681.42857143
2020-11-13,0.04176,0.04835,0.04112,0.046,38227801.0,8796.0,22718655.1,0.04419,0.04321857142857143,0.043703,0.04450857347506055,0.04366530161525056,0.04442849928313424,51.2636415852958,0.05041871636655025,0.03698728363344975,-0.001969140826687657,-0.0028234157852122703,0.0008542749585246133,0.00723,0.005072857142857142,437392105.67999923,0.009009999999999997,1.9503546099290725,-25.705076551168403,74.2949234488316,59.70991136180502,10.153256704980846,0.0449,0.04675,0.041,0.04173,31411823.5,6150.0,18904470.4,-7.06013363028953,43.442098528470886,0.05299291735501643,0.035455082644983565,-0.0023759082908099555,-0.0030369845248434234,0.000661076234033468,0.005749999999999998,0.004735714285714285,399164304.67999923,0.0013300000000000048,-8.94610517128518,-60.112812248186906,39.88718775181309,58.904109589041106,0.04409,0.0430171469501211,0.04289571428571428,0.04288706882033408,0.044224,0.04426307815504311,24600.0,22451197.53333332,54974.0,21635174.17142857
2020-11-14,0.04615,0.0464,0.04231,0.04454,41096441.9,7381.0,23855640.4,0.04409,0.04386,0.043375000000000004,0.044524286737530276,0.04388397621143792,0.044439118399026215,50.69582504970179,0.04914355906482479,0.03760644093517522,-0.0017444752542079348,-0.0026076276790114035,0.0008631524248034687,0.004089999999999996,0.0051507142857142845,396295663.77999926,0.004980000000000005,1.1123723041997824,-37.46978243352132,62.53021756647868,58.90410958904113,-3.4886240520043197,0.04176,0.04835,0.04112,0.046,38227801.0,8796.0,22718655.1,10.153256704980846,51.2636415852958,0.05041871636655025,0.03698728363344975,-0.001969140826687657,-0.0028234157852122703,0.0008542749585246133,0.00723,0.005072857142857142,437392105.67999923,0.009009999999999997,1.9503546099290725,-25.705076551168403,74.2949234488316,59.70991136180502,0.04419,0.04450857347506055,0.04321857142857143,0.04366530161525056,0.043703,0.04442849928313424,22381.0,22949276.299999993,56987.0,21631295.2
2020-11-15,0.04436,0.04544,0.04071,0.04241,36970534.1,10253.0,22104310.8,0.04431666666666667,0.043924285714285714,0.0431065,0.04346714336876514,0.04351548215857844,0.044245869027690385,46.10066371681417,0.048499432119197036,0.03771356788080296,-0.0017184896888268603,-0.0024298000809744947,0.0007113103921476344,0.004729999999999998,0.005342857142857141,359325129.67999923,0.002690000000000005,-6.234799911563115,-54.63336019339239,45.36663980660761,60.73059360730597,-4.395852119026135,0.04615,0.0464,0.04231,0.04454,41096441.9,7381.0,23855640.4,-3.4886240520043197,50.69582504970179,0.04914355906482479,0.03760644093517522,-0.0017444752542079348,-0.0026076276790114035,0.0008631524248034687,0.004089999999999996,0.0051507142857142845,396295663.77999926,0.004980000000000005,1.1123723041997824,-37.46978243352132,62.53021756647868,58.90410958904113,0.04409,0.044524286737530276,0.04386,0.04388397621143792,0.043375000000000004,0.044439118399026215,22327.0,21826255.299999993,53958.0,21140880.728571426
2020-11-16,0.04234,0.04476,0.04157,0.04279,32093086.9,8862.0,18963578.9,0.043246666666666676,0.04400142857142857,0.0429045,0.04312857168438257,0.04333411161893383,0.04410721483457702,53.768527278461065,0.048004908549183385,0.03780409145081661,-0.0016482333092396745,-0.0022734867266275306,0.0006252534173878561,0.0031899999999999984,0.005129999999999998,391418216.5799992,-0.0009499999999999995,5.915841584158432,-51.57131345688958,48.428686543110416,52.10851463873225,1.0628247520075553,0.04436,0.04544,0.04071,0.04241,36970534.1,10253.0,22104310.8,-4.395852119026135,46.10066371681417,0.048499432119197036,0.03771356788080296,-0.0017184896888268603,-0.0024298000809744947,0.0007113103921476344,0.004729999999999998,0.005342857142857141,359325129.67999923,0.002690000000000005,-6.234799911563115,-54.63336019339239,45.36663980660761,60.73059360730597,0.04431666666666667,0.04346714336876514,0.043924285714285714,0.04351548215857844,0.0431065,0.044245869027690385,26430.0,22892868.766666662,58339.0,21830203.85714286
2020-11-17,0.04272,0.05139,0.04222,0.05092,63463532.4,19470.0,35678493.8,0.04537333333333334,0.04474714285714286,0.0431915,0.04702428584219129,0.04523058371420037,0.044756051516998255,69.11885808399671,0.04936427989070639,0.037018720109293614,-0.0009258588430760481,-0.0020039611499172343,0.0010781023068411862,0.009169999999999998,0.005514285714285713,454881748.9799992,0.010869999999999998,37.6588267099216,-3.216974674880207,96.7830253251198,63.52611722494595,19.194756554307112,0.04234,0.04476,0.04157,0.04279,32093086.9,8862.0,18963578.9,1.0628247520075553,53.768527278461065,0.048004908549183385,0.03780409145081661,-0.0016482333092396745,-0.0022734867266275306,0.0006252534173878561,0.0031899999999999984,0.005129999999999998,391418216.5799992,-0.0009499999999999995,5.915841584158432,-51.57131345688958,48.428686543110416,52.10851463873225,0.043246666666666676,0.04312857168438257,0.04400142857142857,0.04333411161893383,0.0429045,0.04410721483457702,26496.0,21641176.69999999,59892.0,22142253.971428573
2020-11-18,0.05086,0.05245,0.04323,0.04639,59084928.6,18643.0,26557541.9,0.0467,0.04496857142857143,0.0432195,0.046707142921095644,0.04552043778565028,0.04491166565823651,58.89554571502997,0.04944750627050302,0.036991493729496984,-0.0007107123656763317,-0.0017453113930690537,0.001034599027392722,0.009219999999999999,0.005953571428571427,395796820.37999916,0.004430000000000003,17.264914054600624,-39.73770491803276,60.262295081967245,68.49133565006582,-8.788832088084943,0.04272,0.05139,0.04222,0.05092,63463532.4,19470.0,35678493.8,19.194756554307112,69.11885808399671,0.04936427989070639,0.037018720109293614,-0.0009258588430760481,-0.0020039611499172343,0.0010781023068411862,0.009169999999999998,0.005514285714285713,454881748.9799992,0.010869999999999998,37.6588267099216,-3.216974674880207,96.7830253251198,63.52611722494595,0.04537333333333334,0.04702428584219129,0.04474714285714286,0.04523058371420037,0.0431915,0.044756051516998255,38585.0,25582127.833333325,68347.0,24207121.82857143
2020-11-19,0.04636,0.05699,0.04578,0.05311,89001701.7,30542.0,46927867.9,0.05014,0.04659428571428571,0.043619,0.04990857146054782,0.0474178283392377,0.04569245940507113,64.89432703003338,0.051231474250247926,0.03600652574975207,2.0173515533766784e-06,-0.0013958456441445677,0.0013978629956979444,0.011209999999999998,0.006482857142857142,484798522.07999915,0.010859999999999995,33.71097683786506,-21.48394241417498,78.51605758582501,78.5204593309707,14.559965487489212,0.05086,0.05245,0.04323,0.04639,59084928.6,18643.0,26557541.9,-8.788832088084943,58.89554571502997,0.04944750627050302,0.036991493729496984,-0.0007107123656763317,-0.0017453113930690537,0.001034599027392722,0.009219999999999999,0.005953571428571427,395796820.37999916,0.004430000000000003,17.264914054600624,-39.73770491803276,60.262295081967245,68.49133565006582,0.0467,0.046707142921095644,0.04496857142857143,0.04552043778565028,0.0432195,0.04491166565823651,46975.0,27066538.199999988,79555.0,24111813.04285714
2020-11-20,0.05312,0.05698,0.05076,0.05373,64405311.6,21577.0,31891252.4,0.051076666666666666,0.04769857142857143,0.044103,0.05181928573027391,0.04899587125442828,0.04645793946173102,62.021660649819495,0.0529600259948724,0.035245974005127606,0.0006098595248638025,-0.0009947046103428935,0.001604564135206696,0.006220000000000003,0.006522142857142856,549203833.6799991,0.008030000000000002,22.839506172839496,-18.050941306755256,81.94905869324475,73.57580378701235,1.1483433734939748,0.04636,0.05699,0.04578,0.05311,89001701.7,30542.0,46927867.9,14.559965487489212,64.89432703003338,0.051231474250247926,0.03600652574975207,2.0173515533766784e-06,-0.0013958456441445677,0.0013978629956979444,0.011209999999999998,0.006482857142857142,484798522.07999915,0.010859999999999995,33.71097683786506,-21.48394241417498,78.51605758582501,78.5204593309707,0.05014,0.04990857146054782,0.04659428571428571,0.0474178283392377,0.043619,0.04569245940507113,68655.0,36387967.86666665,103947.0,28115155.54285714
2020-11-21,0.05373,0.0591,0.05089,0.05839,52989408.3,20434.0,26578471.6,0.05507666666666666,0.04967714285714286,0.044760999999999995,0.05510464286513696,0.05134440344082121,0.047594326179661396,71.56632173095015,0.05568477204950901,0.03383722795049098,0.0014508770734703927,-0.0005055882735802363,0.001956465347050629,0.008210000000000002,0.006375714285714285,602193241.9799991,0.01355,45.792759051186,-3.5678391959799107,96.43216080402009,85.63242569436329,8.67299460264284,0.05312,0.05698,0.05076,0.05373,64405311.6,21577.0,31891252.4,1.1483433734939748,62.021660649819495,0.0529600259948724,0.035245974005127606,0.0006098595248638025,-0.0009947046103428935,0.001604564135206696,0.006220000000000003,0.006522142857142856,549203833.6799991,0.008030000000000002,22.839506172839496,-18.050941306755256,81.94905869324475,73.57580378701235,0.051076666666666666,0.05181928573027391,0.04769857142857143,0.04899587125442828,0.044103,0.04645793946173102,70762.0,35125554.066666655,116728.0,29425526.585714284
2020-11-22,0.05847,0.06253,0.05082,0.05424,64168702.8,22897.0,32986833.8,0.055453333333333334,0.051367142857142854,0.045453,0.05467232143256848,0.05206830258061591,0.04822724749588412,63.717605004468275,0.056951902647880075,0.033954097352119926,0.0017622056135642022,-5.2029496151348616e-05,0.0018142351097155509,0.011710000000000005,0.006859999999999999,538024539.1799991,0.012509999999999993,29.26596758817921,-35.53364766395201,64.46635233604798,80.94919061110427,-7.234479220112886,0.05373,0.0591,0.05089,0.05839,52989408.3,20434.0,26578471.6,8.67299460264284,71.56632173095015,0.05568477204950901,0.03383722795049098,0.0014508770734703927,-0.0005055882735802363,0.001956465347050629,0.008210000000000002,0.006375714285714285,602193241.9799991,0.01355,45.792759051186,-3.5678391959799107,96.43216080402009,85.63242569436329,0.05507666666666666,0.05510464286513696,0.04967714285714286,0.05134440344082121,0.044760999999999995,0.047594326179661396,72553.0,35132530.63333332,129781.0,29814502.47142857
2020-11-23,0.0542,0.0641,0.0529,0.06314,60902526.3,23741.0,34059347.6,0.05859,0.05427428571428571,0.046760499999999997,0.05890616071628424,0.05483622693546194,0.04964750963913325,69.57091999250517,0.06001972991334324,0.03350127008665675,0.0026960133801497976,0.0004975790791088806,0.002198434301040917,0.011200000000000002,0.007385000000000001,598927065.4799991,0.017140000000000002,49.44378698224852,-4.104318084651571,95.89568191534843,85.59806501847218,16.494464944649454,0.05847,0.06253,0.05082,0.05424,64168702.8,22897.0,32986833.8,-7.234479220112886,63.717605004468275,0.056951902647880075,0.033954097352119926,0.0017622056135642022,-5.2029496151348616e-05,0.0018142351097155509,0.011710000000000005,0.006859999999999999,538024539.1799991,0.012509999999999993,29.26596758817921,-35.53364766395201,64.46635233604798,80.94919061110427,0.055453333333333334,0.05467232143256848,0.051367142857142854,0.05206830258061591,0.045453,0.04822724749588412,64908.0,30485519.266666654,142425.0,31369148.614285715
2020-11-24,0.0631,0.06529,0.05784,0.06227,55364128.1,23719.0,27878982.9,0.05988333333333334,0.05589571428571428,0.047896,0.060588080358142116,0.05669467020159645,0.05084965157826342,66.3122661941327,0.062390966676316544,0.03340103332368346,0.003327503643085511,0.0010635639919042068,0.002263939651181304,0.007449999999999998,0.0074621428571428556,543562937.379999,0.017729999999999996,36.258205689277915,-12.28641171684297,87.71358828315702,82.69187417818448,-1.3153724247226692,0.0542,0.0641,0.0529,0.06314,60902526.3,23741.0,34059347.6,16.494464944649454,69.57091999250517,0.06001972991334324,0.03350127008665675,0.0026960133801497976,0.0004975790791088806,0.002198434301040917,0.011200000000000002,0.007385000000000001,598927065.4799991,0.017140000000000002,49.44378698224852,-4.104318084651571,95.89568191534843,85.59806501847218,0.05859,0.05890616071628424,0.05427428571428571,0.05483622693546194,0.046760499999999997,0.04964750963913325,67072.0,31208217.666666657,157304.0,33525687.0
2020-11-25,0.06237,0.06833,0.057,0.05959,52527229.3,23801.0,26705648.3,0.06166666666666667,0.057781428571428574,0.048889499999999995,0.06008904017907106,0.057418502651197335,0.0516820657136669,64.0182474814674,0.06374427839123793,0.03403472160876206,0.0035705515283703526,0.0015649614991974361,0.0020055900291729165,0.01133,0.007907857142857144,491035708.079999,0.017179999999999994,32.89473684210527,-31.64373642288199,68.35626357711801,83.98851125854117,-4.457271123937797,0.0631,0.06529,0.05784,0.06227,55364128.1,23719.0,27878982.9,-1.3153724247226692,66.3122661941327,0.062390966676316544,0.03340103332368346,0.003327503643085511,0.0010635639919042068,0.002263939651181304,0.007449999999999998,0.0074621428571428556,543562937.379999,0.017729999999999996,36.258205689277915,-12.28641171684297,87.71358828315702,82.69187417818448,0.05988333333333334,0.060588080358142116,0.05589571428571428,0.05669467020159645,0.047896,0.05084965157826342,70357.0,31641721.433333326,161553.0,32411471.157142855
2020-11-26,0.05958,0.062,0.04583,0.04975,68591104.9,21804.0,32295856.2,0.05720333333333333,0.057301428571428566,0.04919,0.05491952008953553,0.05550137698839801,0.051498059455222435,56.757667677789016,0.06384801882212024,0.03453198117787975,0.0029353263498514137,0.0018390344693282317,0.001096291880523182,0.016169999999999997,0.008652142857142857,422444603.179999,0.006960000000000001,19.218787443086516,-67.27009413468501,32.72990586531499,62.93325257519668,-16.49882510909701,0.06237,0.06833,0.057,0.05959,52527229.3,23801.0,26705648.3,-4.457271123937797,64.0182474814674,0.06374427839123793,0.03403472160876206,0.0035705515283703526,0.0015649614991974361,0.0020055900291729165,0.01133,0.007907857142857144,491035708.079999,0.017179999999999994,32.89473684210527,-31.64373642288199,68.35626357711801,83.98851125854117,0.06166666666666667,0.06008904017907106,0.057781428571428574,0.057418502651197335,0.048889499999999995,0.0516820657136669,71261.0,29547992.933333326,166711.0,32432629.214285713
2020-11-27,0.04977,0.05187,0.04566,0.0493,33565974.1,12569.0,17394084.8,0.05288,0.05666857142857142,0.0496525,0.052109760044767764,0.053951032741298505,0.051288720459486965,52.971902017291065,0.0636657837355414,0.0356392162644586,0.002368294356996384,0.0019448864468618622,0.00042340791013452156,0.00621,0.008579285714285715,388878629.07999897,-0.0016200000000000034,7.173913043478253,-68.89934829833456,31.100651701665438,44.062273714699494,-0.9443439823186761,0.05958,0.062,0.04583,0.04975,68591104.9,21804.0,32295856.2,-16.49882510909701,56.757667677789016,0.06384801882212024,0.03453198117787975,0.0029353263498514137,0.0018390344693282317,0.001096291880523182,0.016169999999999997,0.008652142857142857,422444603.179999,0.006960000000000001,19.218787443086516,-67.27009413468501,32.72990586531499,62.93325257519668,0.05720333333333333,0.05491952008953553,0.057301428571428566,0.05550137698839801,0.04919,0.051498059455222435,69324.0,28960162.466666657,157973.0,30342341.82857143
2020-11-28,0.04936,0.05215,0.04753,0.05209,30544063.2,10277.0,17649637.3,0.05038,0.055768571428571424,0.050158999999999995,0.05209988002238388,0.05348577455597388,0.05136503279667868,56.64028144239226,0.06372679142715142,0.03659120857284858,0.002119613515221122,0.001979831860533714,0.00013978165468740786,0.004619999999999999,0.008617142857142856,419422692.27999896,0.005699999999999997,16.9510552312528,-58.797972483707476,41.202027516292524,35.01086169442433,5.5307941653160375,0.04977,0.05187,0.04566,0.0493,33565974.1,12569.0,17394084.8,-0.9443439823186761,52.971902017291065,0.0636657837355414,0.0356392162644586,0.002368294356996384,0.0019448864468618622,0.00042340791013452156,0.00621,0.008579285714285715,388878629.07999897,-0.0016200000000000034,7.173913043478253,-68.89934829833456,31.100651701665438,44.062273714699494,0.05288,0.052109760044767764,0.05666857142857142,0.053951032741298505,0.0496525,0.051288720459486965,58174.0,25465196.433333322,148965.0,28271317.885714285
2020-11-29,0.05192,0.05212,0.04867,0.04992,21163418.8,7443.0,10178463.0,0.050436666666666664,0.055151428571428567,0.050542500000000004,0.05100994001119194,0.05259433091698041,0.05122741062556642,56.60045702232379,0.06359274278863279,0.037492257211367216,0.0017275175449958102,0.0019293689974261335,-0.0002018514524303233,0.0034500000000000017,0.008525714285714286,398259273.47999895,-0.0031899999999999984,17.708087715161504,-68.796711509716,31.20328849028399,34.50198923608066,-3.852080123266567,0.04936,0.05215,0.04753,0.05209,30544063.2,10277.0,17649637.3,5.5307941653160375,56.64028144239226,0.06372679142715142,0.03659120857284858,0.002119613515221122,0.001979831860533714,0.00013978165468740786,0.004619999999999999,0.008617142857142856,419422692.27999896,0.005699999999999997,16.9510552312528,-58.797972483707476,41.202027516292524,35.01086169442433,0.05038,0.05209988002238388,0.055768571428571424,0.05348577455597388,0.050158999999999995,0.05136503279667868,44650.0,22446526.099999994,138808.0,26995770.12857143
2020-11-30,0.04991,0.05181,0.0486,0.05069,26578302.3,9376.0,12908450.7,0.0509,0.053372857142857145,0.05079199999999999,0.05084997000559597,0.052118248187735305,0.05117622866122676,56.895949720670394,0.06364168908082374,0.03794231091917624,0.0014620575393207644,0.0018359067058050598,-0.0003738491664842954,0.0032100000000000045,0.008527142857142858,424837575.77999896,-0.003040000000000001,18.46225753680766,-67.56032171581771,32.4396782841823,34.94833143025294,1.5628130635143174,0.05192,0.05212,0.04867,0.04992,21163418.8,7443.0,10178463.0,-3.852080123266567,56.60045702232379,0.06359274278863279,0.037492257211367216,0.0017275175449958102,0.0019293689974261335,-0.0002018514524303233,0.0034500000000000017,0.008525714285714286,398259273.47999895,-0.0031899999999999984,17.708087715161504,-68.796711509716,31.20328849028399,34.50198923608066,0.050436666666666664,0.05100994001119194,0.055151428571428567,0.05259433091698041,0.050542500000000004,0.05122741062556642,30289.0,15074061.69999999,123354.0,23737431.442857143
2020-12-01,0.05069,0.054,0.04703,0.04903,36387443.2,12051.0,17342055.4,0.04988,0.05148142857142857,0.0510015,0.04993998500279798,0.05134618614080148,0.05097182593158612,48.140129895689824,0.06357628224150261,0.03842671775849739,0.0011049927765916373,0.0016897239199623756,-0.0005847311433707383,0.006969999999999997,0.00837,388450132.57999897,-0.00936,-3.7117046347211358,-76.89243027888448,23.10756972111553,28.916845498527284,-3.274807654369702,0.04991,0.05181,0.0486,0.05069,26578302.3,9376.0,12908450.7,1.5628130635143174,56.895949720670394,0.06364168908082374,0.03794231091917624,0.0014620575393207644,0.0018359067058050598,-0.0003738491664842954,0.0032100000000000045,0.008527142857142858,424837575.77999896,-0.003040000000000001,18.46225753680766,-67.56032171581771,32.4396782841823,34.94833143025294,0.0509,0.05084997000559597,0.053372857142857145,0.052118248187735305,0.05079199999999999,0.05117622866122676,27096.0,13578850.333333323,108989.0,20715874.74285714
2020-12-02,0.04881,0.0539,0.04815,0.05272,26186867.9,9303.0,15271171.3,0.05081333333333334,0.050499999999999996,0.051551,0.051329992501399,0.051689639605601106,0.05113831870000649,56.3338002801681,0.06335686812163424,0.039745131878365765,0.0011070076459452766,0.0015731806651589559,-0.0004661730192136793,0.005750000000000005,0.008122142857142857,414637000.47999895,-0.0015199999999999936,13.64518215132573,-68.85752095280104,31.142479047198957,28.8965756841656,8.010653554599475,0.05069,0.054,0.04703,0.04903,36387443.2,12051.0,17342055.4,-3.274807654369702,48.140129895689824,0.06357628224150261,0.03842671775849739,0.0011049927765916373,0.0016897239199623756,-0.0005847311433707383,0.006969999999999997,0.00837,388450132.57999897,-0.00936,-3.7117046347211358,-76.89243027888448,23.10756972111553,28.916845498527284,0.04988,0.04993998500279798,0.05148142857142857,0.05134618614080148,0.0510015,0.05097182593158612,28870.0,13476323.033333322,97321.0,19210599.385714285
2020-12-03,0.05277,0.05847,0.05249,0.05524,29794004.0,10931.0,14957582.6,0.052329999999999995,0.05128428571428572,0.052013,0.0532849962506995,0.052577229704200826,0.05152895501429159,52.32685164955211,0.0636258261214259,0.04040017387857409,0.0012969964165676917,0.0015179438154407031,-0.00022094739887301143,0.005979999999999999,0.007748571428571429,444431004.47999895,-0.007900000000000004,4.010544153643392,-57.74150860167624,42.25849139832376,32.16951338887943,4.68068978586318,0.04881,0.0539,0.04815,0.05272,26186867.9,9303.0,15271171.3,8.010653554599475,56.3338002801681,0.06335686812163424,0.039745131878365765,0.0011070076459452766,0.0015731806651589559,-0.0004661730192136793,0.005750000000000005,0.008122142857142857,414637000.47999895,-0.0015199999999999936,13.64518215132573,-68.85752095280104,31.142479047198957,28.8965756841656,0.05081333333333334,0.051329992501399,0.050499999999999996,0.051689639605601106,0.051551,0.05113831870000649,30730.0,15173892.466666656,82823.0,17577102.67142857
2020-12-04,0.05534,0.05595,0.04967,0.05021,29077964.3,8498.0,15124659.8,0.05272333333333334,0.05141428571428571,0.0522965,0.05174749812534975,0.051985422278150624,0.05140334025102572,46.49262654444002,0.06340715733050684,0.04118584266949317,0.0010298138702853274,0.0014203178264096282,-0.00039050395612430077,0.006280000000000001,0.007752857142857145,415353040.17999893,-0.012060000000000001,-6.551274892983439,-79.92942214380238,20.07057785619761,31.15718276724012,-9.269967473798342,0.05277,0.05847,0.05249,0.05524,29794004.0,10931.0,14957582.6,4.68068978586318,52.32685164955211,0.0636258261214259,0.04040017387857409,0.0012969964165676917,0.0015179438154407031,-0.00022094739887301143,0.005979999999999999,0.007748571428571429,444431004.47999895,-0.007900000000000004,4.010544153643392,-57.74150860167624,42.25849139832376,32.16951338887943,0.052329999999999995,0.0532849962506995,0.05128428571428572,0.052577229704200826,0.052013,0.05152895501429159,32285.0,15856936.433333322,71950.0,15100206.442857144
2020-12-05,0.05028,0.0539,0.04916,0.05347,20515210.3,6326.0,12345892.1,0.05297333333333334,0.05161142857142858,0.052849499999999994,0.052608749062674875,0.05235656670861297,0.05160016498902327,44.95694956949569,0.06294264405139749,0.0427563559486025,0.0010688040249611439,0.0013500150661199313,-0.0002812110411587875,0.004740000000000001,0.007505,435868250.47999895,-0.0061200000000000004,-8.426100359650624,-65.54918394353773,34.450816056462266,32.25996177032789,6.3444709626093845,0.05534,0.05595,0.04967,0.05021,29077964.3,8498.0,15124659.8,-9.269967473798342,46.49262654444002,0.06340715733050684,0.04118584266949317,0.0010298138702853274,0.0014203178264096282,-0.00039050395612430077,0.006280000000000001,0.007752857142857145,415353040.17999893,-0.012060000000000001,-6.551274892983439,-79.92942214380238,20.07057785619761,31.15718276724012,0.05272333333333334,0.05174749812534975,0.05141428571428571,0.051985422278150624,0.0522965,0.05140334025102572,28732.0,15117804.566666657,67879.0,14776002.87142857
2020-12-06,0.05349,0.05399,0.05103,0.05201,23198109.1,5345.0,15077357.9,0.05189666666666667,0.05191,0.053310500000000004,0.05230937453133744,0.052269925031459726,0.051639196894830576,47.58082013451942,0.062244771036157547,0.04437622896384246,0.0009707045276278262,0.0012741529584215105,-0.00030344843079368436,0.0029600000000000043,0.00688,412670141.3799989,0.002259999999999998,-4.111356932153387,-71.98941332157035,28.010586678429643,27.51066019702985,-2.766872312581795,0.05028,0.0539,0.04916,0.05347,20515210.3,6326.0,12345892.1,6.3444709626093845,44.95694956949569,0.06294264405139749,0.0427563559486025,0.0010688040249611439,0.0013500150661199313,-0.0002812110411587875,0.004740000000000001,0.007505,435868250.47999895,-0.0061200000000000004,-8.426100359650624,-65.54918394353773,34.450816056462266,32.25996177032789,0.05297333333333334,0.052608749062674875,0.05161142857142858,0.05235656670861297,0.052849499999999994,0.05160016498902327,25755.0,14142711.49999999,63928.0,14018324.985714287
2020-12-07,0.05207,0.05398,0.05119,0.05318,27932374.7,5859.0,19163346.2,0.052886666666666665,0.05226571428571428,0.0534235,0.05274468726566872,0.0524974437735948,0.05178594004770386,37.01772679874868,0.06228735748271255,0.044559642517287446,0.0009761171205703509,0.0012145457908512788,-0.00023842867028092793,0.002790000000000001,0.006279285714285715,440602516.0799989,0.0038800000000000015,-15.774469433006022,-66.82840758711956,33.17159241288045,31.877665049257462,2.1317457269060878,0.05349,0.05399,0.05103,0.05201,23198109.1,5345.0,15077357.9,-2.766872312581795,47.58082013451942,0.062244771036157547,0.04437622896384246,0.0009707045276278262,0.0012741529584215105,-0.00030344843079368436,0.0029600000000000043,0.00688,412670141.3799989,0.002259999999999998,-4.111356932153387,-71.98941332157035,28.010586678429643,27.51066019702985,0.05189666666666667,0.05230937453133744,0.05191,0.052269925031459726,0.053310500000000004,0.051639196894830576,20169.0,14182636.599999988,61830.0,14718167.114285713
2020-12-08,0.0532,0.05359,0.04635,0.04793,31293936.2,8779.0,18373083.2,0.05104,0.05210857142857143,0.05350049999999999,0.05033734363283436,0.051355582830196096,0.051418707662208255,33.224145999064106,0.06213077346033455,0.044870226539665437,0.0005504304954333517,0.0010817227317676936,-0.0005312922363343419,0.0072399999999999964,0.006264285714285714,409308579.8799989,-0.004159999999999997,-23.028745784486915,-89.98676665196295,10.013233348037058,23.73180414644906,-9.90601503759398,0.05207,0.05398,0.05119,0.05318,27932374.7,5859.0,19163346.2,2.1317457269060878,37.01772679874868,0.06228735748271255,0.044559642517287446,0.0009761171205703509,0.0012145457908512788,-0.00023842867028092793,0.002790000000000001,0.006279285714285715,440602516.0799989,0.0038800000000000015,-15.774469433006022,-66.82840758711956,33.17159241288045,31.877665049257462,0.052886666666666665,0.05274468726566872,0.05226571428571428,0.0524974437735948,0.0534235,0.05178594004770386,17530.0,15528865.399999991,58313.0,15611723.614285713
2020-12-09,0.04779,0.04893,0.04442,0.04855,24739635.7,7887.0,14833678.9,0.04988666666666667,0.05151285714285714,0.0532725,0.04944367181641718,0.050654187122647076,0.051145497408664614,36.4306784660767,0.06218261223274742,0.044362387767252584,0.000260101310548988,0.0009173984475239525,-0.0006572971369749645,0.00451,0.005777142857142857,434048215.5799989,-0.0013699999999999962,-18.52659842255411,-76.50739476678042,23.492605233219578,22.225810331379037,1.5902908558275868,0.0532,0.05359,0.04635,0.04793,31293936.2,8779.0,18373083.2,-9.90601503759398,33.224145999064106,0.06213077346033455,0.044870226539665437,0.0005504304954333517,0.0010817227317676936,-0.0005312922363343419,0.0072399999999999964,0.006264285714285714,409308579.8799989,-0.004159999999999997,-23.028745784486915,-89.98676665196295,10.013233348037058,23.73180414644906,0.05104,0.05033734363283436,0.05210857142857143,0.051355582830196096,0.05350049999999999,0.051418707662208255,19983.0,17537929.09999999,55041.0,15759013.3
2020-12-10,0.04855,0.053,0.04622,0.05014,25235534.2,9267.0,15046500.6,0.04887333333333333,0.05078428571428572,0.053093,0.049791835908208584,0.050525640341985305,0.05104973575069656,50.60129509713227,0.062108329868159805,0.0440776701318402,0.00015650891429430658,0.0007652205408780234,-0.0006087116265837168,0.006780000000000001,0.005106428571428573,459283749.7799989,-0.0005500000000000019,0.7839195979899349,-59.28825622775804,40.71174377224197,24.739194117832877,3.274974253347053,0.04779,0.04893,0.04442,0.04855,24739635.7,7887.0,14833678.9,1.5902908558275868,36.4306784660767,0.06218261223274742,0.044362387767252584,0.000260101310548988,0.0009173984475239525,-0.0006572971369749645,0.00451,0.005777142857142857,434048215.5799989,-0.0013699999999999962,-18.52659842255411,-76.50739476678042,23.492605233219578,22.225810331379037,0.04988666666666667,0.04944367181641718,0.05151285714285714,0.050654187122647076,0.0532725,0.051145497408664614,22525.0,17456702.76666666,53625.0,15696514.385714287
2020-12-11,0.05031,0.05282,0.04698,0.05096,23043311.9,9372.0,10540426.2,0.049883333333333335,0.050891428571428574,0.0527215,0.05037591795410429,0.05063423025648898,0.05104118948872546,52.53048780487805,0.06142471241358299,0.04401828758641701,0.00013897630851876508,0.0006399716944061718,-0.0005009953858874067,0.005839999999999998,0.005080000000000001,482327061.6799989,0.0019300000000000012,3.367139959432053,-53.45195729537369,46.54804270462631,36.91746390336262,1.291989664082683,0.04855,0.053,0.04622,0.05014,25235534.2,9267.0,15046500.6,3.274974253347053,50.60129509713227,0.062108329868159805,0.0440776701318402,0.00015650891429430658,0.0007652205408780234,-0.0006087116265837168,0.006780000000000001,0.005106428571428573,459283749.7799989,-0.0005500000000000019,0.7839195979899349,-59.28825622775804,40.71174377224197,24.739194117832877,0.04887333333333333,0.049791835908208584,0.05078428571428572,0.050525640341985305,0.053093,0.05104973575069656,25933.0,16084420.899999991,51961.0,15709216.957142858
2020-12-12,0.05106,0.05444,0.05022,0.05069,29208243.2,10119.0,14253746.4,0.05059666666666666,0.050494285714285714,0.052544,0.05053295897705214,0.05064817269236674,0.051007742870751605,47.68824306472919,0.061261605658734994,0.04382639434126501,0.00010211769933828746,0.000532400895392595,-0.0004302831960543075,0.0042200000000000015,0.005051428571428572,453118818.4799989,-0.002030000000000004,-2.6876559800345534,-55.37366548042706,44.626334519572936,43.962040332147076,-0.7246376811594247,0.05031,0.05282,0.04698,0.05096,23043311.9,9372.0,10540426.2,1.291989664082683,52.53048780487805,0.06142471241358299,0.04401828758641701,0.00013897630851876508,0.0006399716944061718,-0.0005009953858874067,0.005839999999999998,0.005080000000000001,482327061.6799989,0.0019300000000000012,3.367139959432053,-53.45195729537369,46.54804270462631,36.91746390336262,0.049883333333333335,0.05037591795410429,0.050891428571428574,0.05063423025648898,0.0527215,0.05104118948872546,26526.0,13473535.233333325,52835.0,15054326.442857143
2020-12-13,0.0506,0.05299,0.04996,0.05199,18505544.4,6303.0,10776610.1,0.05121333333333333,0.05049142857142857,0.051986500000000005,0.05126147948852607,0.050983629519275056,0.051101291168775265,53.51921115266917,0.05913602563756935,0.04483697436243066,0.00017577984087108894,0.0004610766844882938,-0.00028529684361720483,0.003030000000000005,0.005021428571428572,471624362.87999886,-0.003249999999999996,4.146634615384626,-46.120996441281136,53.879003558718864,48.35112692763938,2.747035573122534,0.05106,0.05444,0.05022,0.05069,29208243.2,10119.0,14253746.4,-0.7246376811594247,47.68824306472919,0.061261605658734994,0.04382639434126501,0.00010211769933828746,0.000532400895392595,-0.0004302831960543075,0.0042200000000000015,0.005051428571428572,453118818.4799989,-0.002030000000000004,-2.6876559800345534,-55.37366548042706,44.626334519572936,43.962040332147076,0.05059666666666666,0.05053295897705214,0.050494285714285714,0.05064817269236674,0.052544,0.051007742870751605,28758.0,13280224.399999991,56628.0,15326877.057142857
2020-12-14,0.05194,0.0555,0.0517,0.05268,24227499.0,7788.0,13109224.2,0.05178666666666667,0.050420000000000006,0.05150699999999999,0.051970739744263035,0.0514077221394563,0.05125164439079667,53.392430958063414,0.0567971461526073,0.04621685384739268,0.0002865318908939832,0.00042616772576943167,-0.0001396358348754485,0.003799999999999998,0.005063571428571429,495851861.87999886,0.00247,3.925823633852832,-41.20996441281141,58.790035587188584,52.431791221826806,1.4247208317289133,0.0506,0.05299,0.04996,0.05199,18505544.4,6303.0,10776610.1,2.747035573122534,53.51921115266917,0.05913602563756935,0.04483697436243066,0.00017577984087108894,0.0004610766844882938,-0.00028529684361720483,0.003030000000000005,0.005021428571428572,471624362.87999886,-0.003249999999999996,4.146634615384626,-46.120996441281136,53.879003558718864,48.35112692763938,0.05121333333333333,0.05126147948852607,0.05049142857142857,0.050983629519275056,0.051986500000000005,0.051101291168775265,25794.0,11856927.566666657,57586.0,14712484.514285713
2020-12-15,0.0528,0.05367,0.05074,0.05202,26175709.8,6404.0,17291467.0,0.05223,0.05100428571428571,0.0511285,0.05199536987213152,0.05156079160459222,0.051324821115482706,55.2770914225203,0.05482757114943437,0.04742942885056563,0.00031738854671370387,0.00040441188995828613,-8.702334324458226e-05,0.002930000000000002,0.0047750000000000015,469676152.07999885,-0.00145,6.09830715888231,-45.90747330960857,54.09252669039143,55.58718861209963,-1.4772727272727328,0.05194,0.0555,0.0517,0.05268,24227499.0,7788.0,13109224.2,1.4247208317289133,53.392430958063414,0.0567971461526073,0.04621685384739268,0.0002865318908939832,0.00042616772576943167,-0.0001396358348754485,0.003799999999999998,0.005063571428571429,495851861.87999886,0.00247,3.925823633852832,-41.20996441281141,58.790035587188584,52.431791221826806,0.05178666666666667,0.051970739744263035,0.050420000000000006,0.0514077221394563,0.05150699999999999,0.05125164439079667,24210.0,12713193.566666657,59515.0,13847609.942857143
2020-12-16,0.05203,0.05755,0.05122,0.05589,33221404.9,10372.0,19172519.2,0.053529999999999994,0.052052857142857144,0.0514355,0.05394268493606576,0.052643093703444166,0.05175960005686531,55.55945282357067,0.05563779248213635,0.047233207517863654,0.0006466649745301353,0.000452862506872656,0.00019380246765747934,0.006329999999999995,0.004816428571428571,502897556.9799988,0.0038800000000000015,6.0128983308042505,-18.362989323843408,81.63701067615659,64.83985765124554,7.418796847972328,0.0528,0.05367,0.05074,0.05202,26175709.8,6404.0,17291467.0,-1.4772727272727328,55.2770914225203,0.05482757114943437,0.04742942885056563,0.00031738854671370387,0.00040441188995828613,-8.702334324458226e-05,0.002930000000000002,0.0047750000000000015,469676152.07999885,-0.00145,6.09830715888231,-45.90747330960857,54.09252669039143,55.58718861209963,0.05223,0.05199536987213152,0.05100428571428571,0.05156079160459222,0.0511285,0.051324821115482706,20495.0,13725767.099999988,57140.0,13693093.342857141
2020-12-17,0.05591,0.0595,0.05348,0.05699,44517934.4,15020.0,24083290.4,0.054966666666666664,0.05303142857142857,0.05182,0.05546634246803288,0.05372982027758312,0.0522577333847829,53.229974160206716,0.05657099546357319,0.0470690045364268,0.0009850249681238668,0.0005592949991228982,0.00042572996900096857,0.006019999999999998,0.004819285714285714,547415491.3799988,0.003810000000000001,3.167994207096303,-16.6445623342175,83.35543766578249,73.02832501077684,1.9316759077088135,0.05203,0.05755,0.05122,0.05589,33221404.9,10372.0,19172519.2,7.418796847972328,55.55945282357067,0.05563779248213635,0.047233207517863654,0.0006466649745301353,0.000452862506872656,0.00019380246765747934,0.006329999999999995,0.004816428571428571,502897556.9799988,0.0038800000000000015,6.0128983308042505,-18.362989323843408,81.63701067615659,64.83985765124554,0.053529999999999994,0.05394268493606576,0.052052857142857144,0.052643093703444166,0.0514355,0.05175960005686531,24564.0,16524403.466666656,59625.0,14312927.671428572
2020-12-18,0.057,0.06282,0.0555,0.05995,28261064.1,11392.0,15600470.8,0.05761,0.05431571428571429,0.052212999999999996,0.05770817123401644,0.055284865208187345,0.05299033020527977,69.46442845723423,0.05819810115116107,0.04622789884883892,0.0014750218295648335,0.0007424403652112853,0.0007325814643535482,0.00732,0.0048935714285714286,575676555.4799988,0.012020000000000003,19.398526190001995,-15.597826086956509,84.40217391304348,83.13154075166086,5.17543859649123,0.05591,0.0595,0.05348,0.05699,44517934.4,15020.0,24083290.4,1.9316759077088135,53.229974160206716,0.05657099546357319,0.0470690045364268,0.0009850249681238668,0.0005592949991228982,0.00042572996900096857,0.006019999999999998,0.004819285714285714,547415491.3799988,0.003810000000000001,3.167994207096303,-16.6445623342175,83.35543766578249,73.02832501077684,0.054966666666666664,0.05546634246803288,0.05303142857142857,0.05372982027758312,0.05182,0.0522577333847829,31796.0,20182425.533333324,65378.0,15603897.642857144
2020-12-19,0.05981,0.06417,0.058,0.05898,27129445.9,12507.0,13185077.0,0.058640000000000005,0.0555,0.052666000000000004,0.05834408561700822,0.05620864890614051,0.053560774947634074,62.12054553453585,0.059260767942140344,0.046071232057859665,0.001764734221524962,0.0009468991364740206,0.0008178350850509414,0.006170000000000002,0.004995714285714286,548547109.5799989,0.010429999999999995,10.304843837665988,-26.27848101265826,73.72151898734174,80.49304352205591,-1.3877278047149377,0.057,0.06282,0.0555,0.05995,28261064.1,11392.0,15600470.8,5.17543859649123,69.46442845723423,0.05819810115116107,0.04622789884883892,0.0014750218295648335,0.0007424403652112853,0.0007325814643535482,0.00732,0.0048935714285714286,575676555.4799988,0.012020000000000003,19.398526190001995,-15.597826086956509,84.40217391304348,83.13154075166086,0.05761,0.05770817123401644,0.05431571428571429,0.055284865208187345,0.052212999999999996,0.05299033020527977,36784.0,19618760.13333332,67398.0,16326761.157142859
2020-12-20,0.059,0.0603,0.05562,0.05643,22961788.8,9929.0,11261719.7,0.05845333333333333,0.05613428571428571,0.05295300000000001,0.05738704280850411,0.05626398667960538,0.05383403447643083,59.277917716204875,0.059683884355764986,0.04622211564423503,0.0017681871300803398,0.0011111567351952845,0.0006570303948850553,0.004679999999999997,0.005118571428571429,525585320.77999884,0.006290000000000004,8.498365698904053,-39.18987341772153,60.81012658227847,72.97793982755458,-4.355932203389823,0.05981,0.06417,0.058,0.05898,27129445.9,12507.0,13185077.0,-1.3877278047149377,62.12054553453585,0.059260767942140344,0.046071232057859665,0.001764734221524962,0.0009468991364740206,0.0008178350850509414,0.006170000000000002,0.004995714285714286,548547109.5799989,0.010429999999999995,10.304843837665988,-26.27848101265826,73.72151898734174,80.49304352205591,0.058640000000000005,0.05834408561700822,0.0555,0.05620864890614051,0.052666000000000004,0.053560774947634074,38919.0,17622946.06666666,69786.0,16174094.1
2020-12-21,0.05625,0.05812,0.05029,0.05289,19675340.7,8774.0,9102293.6,0.056100000000000004,0.056164285714285715,0.05314599999999999,0.05513852140425206,0.05542049000970403,0.053744126431056465,49.446353570064915,0.059619701942649234,0.04667229805735075,0.0014683489572381928,0.0011825951796038663,0.0002857537776343264,0.007829999999999997,0.005478571428571428,505909980.07999885,0.0019300000000000012,-0.545317788642341,-57.113924050632924,42.886075949367076,59.13924050632911,-5.973333333333337,0.059,0.0603,0.05562,0.05643,22961788.8,9929.0,11261719.7,-4.355932203389823,59.277917716204875,0.059683884355764986,0.04622211564423503,0.0017681871300803398,0.0011111567351952845,0.0006570303948850553,0.004679999999999997,0.005118571428571429,525585320.77999884,0.006290000000000004,8.498365698904053,-39.18987341772153,60.81012658227847,72.97793982755458,0.05845333333333333,0.05738704280850411,0.05613428571428571,0.05626398667960538,0.05295300000000001,0.05383403447643083,33828.0,13349089.166666657,73412.0,16243395.47142857
2020-12-22,0.05296,0.05562,0.04909,0.05391,23102277.6,9175.0,10520449.6,0.05440999999999999,0.05643428571428572,0.0532055,0.05452426070212603,0.05504286750727802,0.05375992391381299,63.61566484517303,0.05968458854864694,0.04672641145135307,0.001298067209772255,0.0012056895856375441,9.237762413471097e-05,0.006530000000000001,0.005427857142857142,529012257.6799989,0.0032200000000000006,12.476528270394315,-51.94936708860761,48.05063291139239,50.58227848101266,1.7938066465256788,0.05625,0.05812,0.05029,0.05289,19675340.7,8774.0,9102293.6,-5.973333333333337,49.446353570064915,0.059619701942649234,0.04667229805735075,0.0014683489572381928,0.0011825951796038663,0.0002857537776343264,0.007829999999999997,0.005478571428571428,505909980.07999885,0.0019300000000000012,-0.545317788642341,-57.113924050632924,42.886075949367076,59.13924050632911,0.056100000000000004,0.05513852140425206,0.056164285714285715,0.05542049000970403,0.05314599999999999,0.053744126431056465,31210.0,11183030.099999988,74398.0,15670976.814285714
2020-12-23,0.054,0.05968,0.047,0.0505,42670058.1,17983.0,21961398.6,0.05243333333333333,0.055664285714285715,0.052968499999999995,0.052512130351063016,0.05390715063045852,0.05344945496964033,53.93939393939394,0.05948092464347937,0.04645607535652062,0.0008778400035266212,0.0011401196692153595,-0.0002622796656887383,0.012679999999999997,0.00601142857142857,486342199.57999885,-0.0014899999999999983,4.0164778578784865,-76.1559888579387,23.844011142061305,38.260240000940264,-6.481481481481474,0.05296,0.05562,0.04909,0.05391,23102277.6,9175.0,10520449.6,1.7938066465256788,63.61566484517303,0.05968458854864694,0.04672641145135307,0.001298067209772255,0.0012056895856375441,9.237762413471097e-05,0.006530000000000001,0.005427857142857142,529012257.6799989,0.0032200000000000006,12.476528270394315,-51.94936708860761,48.05063291139239,50.58227848101266,0.05440999999999999,0.05452426070212603,0.05643428571428572,0.05504286750727802,0.0532055,0.05375992391381299,27878.0,10294820.966666656,77169.0,14703688.614285713
2020-12-24,0.05048,0.05239,0.04656,0.05129,31567537.3,10415.0,16238998.9,0.0519,0.05485,0.05302250000000001,0.05190106517553151,0.05325286297284389,0.053243792591579346,52.4008350730689,0.05945604981002325,0.04658895018997677,0.0006016182322113525,0.0010324193818145582,-0.00043080114960320566,0.005830000000000002,0.005943571428571428,517909736.87999886,-0.0013899999999999954,2.2935779816513957,-73.1402612152186,26.85973878478139,32.91812761274504,1.6045958795562703,0.054,0.05968,0.047,0.0505,42670058.1,17983.0,21961398.6,-6.481481481481474,53.93939393939394,0.05948092464347937,0.04645607535652062,0.0008778400035266212,0.0011401196692153595,-0.0002622796656887383,0.012679999999999997,0.00601142857142857,486342199.57999885,-0.0014899999999999983,4.0164778578784865,-76.1559888579387,23.844011142061305,38.260240000940264,0.05243333333333333,0.052512130351063016,0.055664285714285715,0.05390715063045852,0.052968499999999995,0.05344945496964033,35932.0,13861380.599999988,84780.0,15102099.957142858
2020-12-25,0.05129,0.05305,0.04842,0.052,22385578.1,8324.0,12339006.5,0.051263333333333334,0.053714285714285714,0.05294899999999999,0.05195053258776575,0.052939647229632916,0.05312533615428607,52.18120805369127,0.0593946003762785,0.04650339962372148,0.00043498729192490565,0.0009129329638366277,-0.000477945671911722,0.004630000000000002,0.005857142857142857,540295314.9799988,-1.9999999999999185e-05,2.0408163265306145,-69.1084611016468,30.8915388983532,27.19842960839864,1.3842854357574486,0.05048,0.05239,0.04656,0.05129,31567537.3,10415.0,16238998.9,1.6045958795562703,52.4008350730689,0.05945604981002325,0.04658895018997677,0.0006016182322113525,0.0010324193818145582,-0.00043080114960320566,0.005830000000000002,0.005943571428571428,517909736.87999886,-0.0013899999999999954,2.2935779816513957,-73.1402612152186,26.85973878478139,32.91812761274504,0.0519,0.05190106517553151,0.05485,0.05325286297284389,0.05302250000000001,0.053243792591579346,37573.0,16240282.366666658,80175.0,13981486.885714287
2020-12-26,0.05195,0.05409,0.0481,0.05031,20840171.2,7647.0,8991622.9,0.0512,0.05247571428571429,0.052864,0.05113026629388288,0.05228223542222469,0.05285720890149692,49.247822644497234,0.059405856810300216,0.04632214318969979,0.00016466405048196076,0.0007632791811656944,-0.0005986151306837336,0.005990000000000002,0.005983571428571428,519455143.77999884,-0.005580000000000002,-0.7496547642533047,-78.7052810902896,21.294718909710404,26.34866553094834,-3.156881616939369,0.05129,0.05305,0.04842,0.052,22385578.1,8324.0,12339006.5,1.3842854357574486,52.18120805369127,0.0593946003762785,0.04650339962372148,0.00043498729192490565,0.0009129329638366277,-0.000477945671911722,0.004630000000000002,0.005857142857142857,540295314.9799988,-1.9999999999999185e-05,2.0408163265306145,-69.1084611016468,30.8915388983532,27.19842960839864,0.051263333333333334,0.05195053258776575,0.053714285714285714,0.052939647229632916,0.05294899999999999,0.05312533615428607,36722.0,16846467.99999999,77107.0,13515563.414285714
2020-12-27,0.05038,0.05789,0.04829,0.05313,23274589.6,10644.0,11489972.3,0.05181333333333333,0.05200428571428571,0.052861500000000006,0.05213013314694144,0.05249417656666852,0.052883189006116264,52.12845407020164,0.059402886542231886,0.046320113457768125,0.0001759530886622021,0.000645813962664996,-0.00046986087400279386,0.009599999999999997,0.006452857142857142,542729733.3799988,-0.0038600000000000023,2.1927293710328755,-62.69165247018741,37.308347529812586,29.831535112625406,5.458515283842786,0.05195,0.05409,0.0481,0.05031,20840171.2,7647.0,8991622.9,-3.156881616939369,49.247822644497234,0.059405856810300216,0.04632214318969979,0.00016466405048196076,0.0007632791811656944,-0.0005986151306837336,0.005990000000000002,0.005983571428571428,519455143.77999884,-0.005580000000000002,-0.7496547642533047,-78.7052810902896,21.294718909710404,26.34866553094834,0.0512,0.05113026629388288,0.05247571428571429,0.05228223542222469,0.052864,0.05285720890149692,26386.0,12523209.433333322,72247.0,12916498.542857142
2020-12-28,0.05321,0.058,0.05297,0.05469,21424539.1,9462.0,12126240.4,0.05271,0.05226142857142857,0.0531995,0.05341006657347072,0.05304313242500139,0.053055266243629,53.63471971066909,0.05935520073826714,0.047043799261732855,0.00030723705773604004,0.0005780985816792049,-0.00027086152394316485,0.00503,0.006540714285714284,564154272.4799988,-0.005260000000000001,3.815489749430534,-53.83304940374786,46.166950596252136,34.92333901192505,2.7814320616425525,0.05038,0.05789,0.04829,0.05313,23274589.6,10644.0,11489972.3,5.458515283842786,52.12845407020164,0.059402886542231886,0.046320113457768125,0.0001759530886622021,0.000645813962664996,-0.00046986087400279386,0.009599999999999997,0.006452857142857142,542729733.3799988,-0.0038600000000000023,2.1927293710328755,-62.69165247018741,37.308347529812586,29.831535112625406,0.05181333333333333,0.05213013314694144,0.05200428571428571,0.05249417656666852,0.052861500000000006,0.052883189006116264,26615.0,10940200.566666657,72962.0,12949106.057142856
2020-12-29,0.05475,0.05919,0.05,0.05231,28729791.4,13080.0,14179629.5,0.05337666666666666,0.052032857142857145,0.0533875,0.05286003328673536,0.05285984931875104,0.05298428850614053,50.49370105549882,0.05916324921092697,0.047611750789073023,0.00021673604139518798,0.0005058260736224015,-0.0002890900322272135,0.009189999999999997,0.006987857142857142,535424481.07999885,-0.006669999999999995,0.5574778931180413,-67.34809767177738,32.65190232822262,38.70906681809579,-4.456621004566206,0.05321,0.058,0.05297,0.05469,21424539.1,9462.0,12126240.4,2.7814320616425525,53.63471971066909,0.05935520073826714,0.047043799261732855,0.00030723705773604004,0.0005780985816792049,-0.00027086152394316485,0.00503,0.006540714285714284,564154272.4799988,-0.005260000000000001,3.815489749430534,-53.83304940374786,46.166950596252136,34.92333901192505,0.05271,0.05341006657347072,0.05226142857142857,0.05304313242500139,0.0531995,0.053055266243629,27753.0,10869278.533333324,73650.0,13381098.457142858
2020-12-30,0.05232,0.0535,0.05001,0.05205,17586079.6,6353.0,9586423.5,0.05301666666666666,0.05225428571428571,0.053483,0.05245501664336768,0.052657386989063276,0.05289530864841286,42.54658385093167,0.05909345677849077,0.04787254322150924,0.000122620019573777,0.0004291848628126766,-0.0003065648432388996,0.00349,0.006784999999999999,517838401.4799988,-0.004380000000000002,-6.870638754696734,-68.82453151618398,31.17546848381601,36.6647738027636,-0.5160550458715585,0.05475,0.05919,0.05,0.05231,28729791.4,13080.0,14179629.5,-4.456621004566206,50.49370105549882,0.05916324921092697,0.047611750789073023,0.00021673604139518798,0.0005058260736224015,-0.0002890900322272135,0.009189999999999997,0.006987857142857142,535424481.07999885,-0.006669999999999995,0.5574778931180413,-67.34809767177738,32.65190232822262,38.70906681809579,0.05337666666666666,0.05286003328673536,0.052032857142857145,0.05285984931875104,0.0533875,0.05298428850614053,33186.0,12598614.066666657,77555.0,13903838.442857144
2020-12-31,0.05219,0.05457,0.05008,0.05152,13816606.0,5925.0,8249292.5,0.051960000000000006,0.05228714285714286,0.053510999999999996,0.05198750832168384,0.05237304024179746,0.052764326872373535,39.14251687177452,0.05907382737654222,0.04794817262345777,5.205814219977345e-06,0.0003443890530941368,-0.00033918323887415945,0.004490000000000001,0.006675714285714286,504021795.4799988,-0.0013699999999999962,-9.598175118441821,-71.8341851220897,28.1658148779103,30.664395229982986,-1.2837708373251524,0.05232,0.0535,0.05001,0.05205,17586079.6,6353.0,9586423.5,-0.5160550458715585,42.54658385093167,0.05909345677849077,0.04787254322150924,0.000122620019573777,0.0004291848628126766,-0.0003065648432388996,0.00349,0.006784999999999999,517838401.4799988,-0.004380000000000002,-6.870638754696734,-68.82453151618398,31.17546848381601,36.6647738027636,0.05301666666666666,0.05245501664336768,0.05225428571428571,0.052657386989063276,0.053483,0.05289530864841286,28895.0,11964097.79999999,65925.0,12135984.857142856
2021-01-01,0.0516,0.05607,0.0515,0.05333,15879644.5,7113.0,8273815.7,0.052300000000000006,0.052477142857142854,0.053642999999999996,0.052658754160841925,0.0526122801813481,0.05281820050357606,36.231281198003316,0.0590469989092043,0.048239001090795694,5.7542766558518754e-05,0.00028701979578701323,-0.00022947702922849447,0.004570000000000005,0.006479285714285714,519901439.9799988,-0.0005799999999999972,-11.042535446205171,-61.55593412833616,38.44406587166384,32.59511641113006,3.352713178294578,0.05219,0.05457,0.05008,0.05152,13816606.0,5925.0,8249292.5,-1.2837708373251524,39.14251687177452,0.05907382737654222,0.04794817262345777,5.205814219977345e-06,0.0003443890530941368,-0.00033918323887415945,0.004490000000000001,0.006675714285714286,504021795.4799988,-0.0013699999999999962,-9.598175118441821,-71.8341851220897,28.1658148779103,30.664395229982986,0.051960000000000006,0.05198750832168384,0.05228714285714286,0.05237304024179746,0.053510999999999996,0.052764326872373535,25358.0,10671781.833333323,61435.0,10994598.22857143
2021-01-02,0.05333,0.0553,0.05015,0.05127,16856607.1,7381.0,6780050.8,0.05204,0.05261428571428572,0.053607,0.05196437708042097,0.052276710136011074,0.052670752836568815,34.65976920015916,0.05906667070533391,0.04814732929466609,-6.643874105725228e-05,0.00021632808841816014,-0.00028276682947541245,0.005150000000000002,0.006406428571428572,503044832.8799988,0.0007699999999999999,-13.072227873855535,-65.72052401746721,34.27947598253279,33.629785577368985,-3.862741421338832,0.0516,0.05607,0.0515,0.05333,15879644.5,7113.0,8273815.7,3.352713178294578,36.231281198003316,0.0590469989092043,0.048239001090795694,5.7542766558518754e-05,0.00028701979578701323,-0.00022947702922849447,0.004570000000000005,0.006479285714285714,519901439.9799988,-0.0005799999999999972,-11.042535446205171,-61.55593412833616,38.44406587166384,32.59511641113006,0.052300000000000006,0.052658754160841925,0.052477142857142854,0.0526122801813481,0.053642999999999996,0.05281820050357606,19391.0,8703177.233333325,60224.0,10413856.685714286
2021-01-03,0.05123,0.0585,0.05,0.05671,25197786.7,10502.0,12636928.8,0.053770000000000005,0.05312571428571429,0.0538085,0.05433718854021048,0.05338503260200831,0.05305544304260988,50.49964311206282,0.05941949024942142,0.048197509750578585,0.00027114200073730804,0.00022729087088198973,4.385112985531831e-05,0.0085,0.006679285714285715,528242619.5799988,0.005420000000000001,0.4961899698741945,-22.63719512195117,77.36280487804883,50.02878224408183,10.696857310169834,0.05333,0.0553,0.05015,0.05127,16856607.1,7381.0,6780050.8,-3.862741421338832,34.65976920015916,0.05906667070533391,0.04814732929466609,-6.643874105725228e-05,0.00021632808841816014,-0.00028276682947541245,0.005150000000000002,0.006406428571428572,503044832.8799988,0.0007699999999999999,-13.072227873855535,-65.72052401746721,34.27947598253279,33.629785577368985,0.05204,0.05196437708042097,0.05261428571428572,0.052276710136011074,0.053607,0.052670752836568815,20419.0,7767719.666666657,59958.0,10097917.814285714
2021-01-04,0.05684,0.06737,0.05103,0.05723,55930957.6,20697.0,27202883.7,0.05507000000000001,0.053488571428571434,0.054069,0.05578359427010524,0.054346274451506235,0.053453019895694655,58.68000000000001,0.05981257270073042,0.04832542729926958,0.0005740198810522817,0.00029663667291604816,0.0002773832081362336,0.01634,0.0072871428571428575,584173577.1799988,0.0052300000000000055,8.20570996407639,-48.72657376261411,51.2734262373859,54.305235699322516,0.6861365235749497,0.05123,0.0585,0.05,0.05671,25197786.7,10502.0,12636928.8,10.696857310169834,50.49964311206282,0.05941949024942142,0.048197509750578585,0.00027114200073730804,0.00022729087088198973,4.385112985531831e-05,0.0085,0.006679285714285715,528242619.5799988,0.005420000000000001,0.4961899698741945,-22.63719512195117,77.36280487804883,50.02878224408183,0.053770000000000005,0.05433718854021048,0.05312571428571429,0.05338503260200831,0.0538085,0.05305544304260988,24996.0,9230265.09999999,59816.0,10261768.742857143
2021-01-05,0.05697,0.0645,0.05618,0.06182,34720941.5,15981.0,16123646.9,0.05858666666666667,0.05484714285714286,0.0543655,0.058801797135052625,0.05621470583862967,0.05424987514372373,63.84319215960799,0.06104145362792909,0.0476895463720709,0.0011709296746773776,0.00047149527326831406,0.0006994344014090635,0.008320000000000001,0.007415000000000001,618894518.6799988,0.01151,14.672602485624186,-26.66987025468524,73.33012974531475,67.3221202869165,8.513252589081974,0.05684,0.06737,0.05103,0.05723,55930957.6,20697.0,27202883.7,0.6861365235749497,58.68000000000001,0.05981257270073042,0.04832542729926958,0.0005740198810522817,0.00029663667291604816,0.0002773832081362336,0.01634,0.0072871428571428575,584173577.1799988,0.0052300000000000055,8.20570996407639,-48.72657376261411,51.2734262373859,54.305235699322516,0.05507000000000001,0.05578359427010524,0.053488571428571434,0.054346274451506235,0.054069,0.053453019895694655,38580.0,15539954.433333322,71051.0,12415574.92857143
2021-01-06,0.06182,0.076,0.058,0.07311,69266740.0,27064.0,34597465.5,0.06405333333333334,0.05785571428571429,0.0551715,0.06595589856752632,0.06043852937897225,0.05604607751098814,81.01508916323732,0.06586508149841819,0.044477918501581816,0.002525876895612393,0.0008823715977371298,0.0016435052978752633,0.017999999999999995,0.007795000000000001,688161258.6799988,0.019979999999999998,44.772277227722746,-9.816576086956534,90.18342391304347,71.59565996524805,18.262698155936583,0.05697,0.0645,0.05618,0.06182,34720941.5,15981.0,16123646.9,8.513252589081974,63.84319215960799,0.06104145362792909,0.0476895463720709,0.0011709296746773776,0.00047149527326831406,0.0006994344014090635,0.008320000000000001,0.007415000000000001,618894518.6799988,0.01151,14.672602485624186,-26.66987025468524,73.33012974531475,67.3221202869165,0.05858666666666667,0.058801797135052625,0.05484714285714286,0.05621470583862967,0.0543655,0.05424987514372373,47180.0,18654486.466666657,73952.0,12693291.700000001
2021-01-07,0.07311,0.08418,0.064,0.07112,65402785.7,27984.0,31277842.5,0.06868333333333333,0.06065571428571429,0.05573,0.06853794928376317,0.06310889703422919,0.057481689176608314,76.3346613545817,0.06844929657108881,0.0430107034289112,0.0033999138704690277,0.0013858800522835095,0.002014033818185518,0.020180000000000003,0.00882,622758472.9799987,0.01643,38.66250731136673,-36.19733924611973,63.80266075388027,75.77207147074617,-2.7219258651347173,0.06182,0.076,0.058,0.07311,69266740.0,27064.0,34597465.5,18.262698155936583,81.01508916323732,0.06586508149841819,0.044477918501581816,0.002525876895612393,0.0008823715977371298,0.0016435052978752633,0.017999999999999995,0.007795000000000001,688161258.6799988,0.019979999999999998,44.772277227722746,-9.816576086956534,90.18342391304347,71.59565996524805,0.06405333333333334,0.06595589856752632,0.05785571428571429,0.06043852937897225,0.0551715,0.05604607751098814,63742.0,25974665.366666656,94663.0,16266297.700000001
2021-01-08,0.071,0.08195,0.0602,0.07104,57147614.7,27050.0,28030710.2,0.07175666666666668,0.06318571428571429,0.056333,0.06978897464188158,0.06509167277567189,0.05877295687407419,75.7158292814695,0.07073342996434648,0.04193257003565353,0.00403957345053655,0.0019166187319341178,0.0021229547186024326,0.02175,0.010042857142857143,565610858.2799987,0.018730000000000004,36.61538461538463,-36.419068736141895,63.58093126385811,72.52233864359395,0.056338028169031336,0.07311,0.08418,0.064,0.07112,65402785.7,27984.0,31277842.5,-2.7219258651347173,76.3346613545817,0.06844929657108881,0.0430107034289112,0.0033999138704690277,0.0013858800522835095,0.002014033818185518,0.020180000000000003,0.00882,622758472.9799987,0.01643,38.66250731136673,-36.19733924611973,63.80266075388027,75.77207147074617,0.06868333333333333,0.06853794928376317,0.06065571428571429,0.06310889703422919,0.05573,0.057481689176608314,71029.0,27332984.966666657,116722.0,19556090.557142857
2021-01-09,0.07102,0.08031,0.06957,0.07261,41511631.2,22305.0,20926010.4,0.07159,0.06623428571428572,0.057142000000000005,0.07119948732094078,0.06697125458175392,0.06009077050511474,80.2168021680217,0.07327865666800917,0.04100534333199084,0.004619938381352558,0.002457282661817806,0.0021626557195347515,0.01074,0.010382142857142857,607122489.4799987,0.020559999999999995,44.32518386006756,-32.23739203120649,67.7626079687935,65.04873332884397,2.2388059701492455,0.071,0.08195,0.0602,0.07104,57147614.7,27050.0,28030710.2,0.056338028169031336,75.7158292814695,0.07073342996434648,0.04193257003565353,0.00403957345053655,0.0019166187319341178,0.0021229547186024326,0.02175,0.010042857142857143,565610858.2799987,0.018730000000000004,36.61538461538463,-36.419068736141895,63.58093126385811,72.52233864359395,0.07175666666666668,0.06978897464188158,0.06318571428571429,0.06509167277567189,0.056333,0.05877295687407419,82098.0,31302006.06666666,136659.0,22378504.057142857
2021-01-10,0.07257,0.0784,0.06232,0.0699,43265182.7,18828.0,21339697.5,0.07118333333333333,0.06811857142857143,0.0579925,0.0705497436604704,0.06770344093631545,0.061024982837960956,72.79151943462901,0.07495735888070565,0.04102764111929436,0.004805809043600409,0.002926987938174327,0.001878821105426082,0.016079999999999997,0.010844999999999999,563857306.7799987,0.01838,31.564088085827223,-41.77881802223523,58.22118197776477,63.18824040347213,-3.6792062835882486,0.07102,0.08031,0.06957,0.07261,41511631.2,22305.0,20926010.4,2.2388059701492455,80.2168021680217,0.07327865666800917,0.04100534333199084,0.004619938381352558,0.002457282661817806,0.0021626557195347515,0.01074,0.010382142857142857,607122489.4799987,0.020559999999999995,44.32518386006756,-32.23739203120649,67.7626079687935,65.04873332884397,0.07159,0.07119948732094078,0.06623428571428572,0.06697125458175392,0.057142000000000005,0.06009077050511474,77339.0,26744854.366666656,151583.0,24399355.42857143
2021-01-11,0.0699,0.07011,0.05203,0.06049,36811360.5,17244.0,15760506.4,0.06766666666666667,0.06858428571428572,0.058321500000000005,0.0655198718302352,0.06590008070223659,0.06097403209148848,56.49641577060932,0.07520803437381532,0.04143496562618469,0.004146011881047004,0.003170792726748863,0.0009752191542981414,0.018080000000000006,0.01177714285714286,527045946.27999866,0.00716,10.605229475223998,-69.30953774136923,30.690462258630774,52.224750735063026,-13.462088698140201,0.07257,0.0784,0.06232,0.0699,43265182.7,18828.0,21339697.5,-3.6792062835882486,72.79151943462901,0.07495735888070565,0.04102764111929436,0.004805809043600409,0.002926987938174327,0.001878821105426082,0.016079999999999997,0.010844999999999999,563857306.7799987,0.01838,31.564088085827223,-41.77881802223523,58.22118197776477,63.18824040347213,0.07118333333333333,0.0705497436604704,0.06811857142857143,0.06770344093631545,0.0579925,0.061024982837960956,68183.0,23432139.366666656,159909.0,25642608.099999998
2021-01-12,0.06057,0.06422,0.05626,0.05881,23596409.6,10675.0,11034683.0,0.06306666666666666,0.06815428571428571,0.058737,0.0621649359151176,0.06412756052667745,0.060767933797061004,57.396449704142015,0.07521726839332238,0.04225673160667762,0.0034478116895188676,0.003226196519302864,0.0002216151702160037,0.007960000000000002,0.011689285714285716,503449536.67999864,0.007539999999999998,12.425922385777088,-74.22469280280866,25.77530719719133,38.22898381119563,-2.9057289087006732,0.0699,0.07011,0.05203,0.06049,36811360.5,17244.0,15760506.4,-13.462088698140201,56.49641577060932,0.07520803437381532,0.04143496562618469,0.004146011881047004,0.003170792726748863,0.0009752191542981414,0.018080000000000006,0.01177714285714286,527045946.27999866,0.00716,10.605229475223998,-69.30953774136923,30.690462258630774,52.224750735063026,0.06766666666666667,0.0655198718302352,0.06858428571428572,0.06590008070223659,0.058321500000000005,0.06097403209148848,58377.0,19342071.433333322,156456.0,24007982.771428574
2021-01-13,0.05857,0.06757,0.056,0.06604,25784672.5,13888.0,13331840.0,0.06178,0.06714428571428571,0.0594745,0.0641024679575588,0.06460567039500809,0.06127003534019805,63.73993321547831,0.07587151060688369,0.04307748939311632,0.003438249582885494,0.00326860713201939,0.00016964245086610423,0.011570000000000004,0.012266428571428572,529234209.17999864,0.009329999999999998,26.8780019212296,-53.07197191339965,46.92802808660034,34.46459918080749,12.753969609014861,0.06057,0.06422,0.05626,0.05881,23596409.6,10675.0,11034683.0,-2.9057289087006732,57.396449704142015,0.07521726839332238,0.04225673160667762,0.0034478116895188676,0.003226196519302864,0.0002216151702160037,0.007960000000000002,0.011689285714285716,503449536.67999864,0.007539999999999998,12.425922385777088,-74.22469280280866,25.77530719719133,38.22898381119563,0.06306666666666666,0.0621649359151176,0.06815428571428571,0.06412756052667745,0.058737,0.060767933797061004,46747.0,16044962.299999991,151150.0,23280987.92857143
2021-01-14,0.06609,0.079,0.06455,0.07696,36101520.7,18062.0,19890740.2,0.06727,0.06797857142857143,0.0607225,0.0705312339787794,0.06769425279625607,0.06276431768875061,70.7504078303426,0.07846818160960922,0.04297681839039077,0.00426268668358145,0.003467423042331802,0.000795263641249648,0.014450000000000005,0.012977857142857143,565335729.8799987,0.019729999999999998,49.37888198757763,-21.12346401404331,78.87653598595669,50.5266237565828,16.447268875775467,0.05857,0.06757,0.056,0.06604,25784672.5,13888.0,13331840.0,12.753969609014861,63.73993321547831,0.07587151060688369,0.04307748939311632,0.003438249582885494,0.00326860713201939,0.00016964245086610423,0.011570000000000004,0.012266428571428572,529234209.17999864,0.009329999999999998,26.8780019212296,-53.07197191339965,46.92802808660034,34.46459918080749,0.06178,0.0641024679575588,0.06714428571428571,0.06460567039500809,0.0594745,0.06127003534019805,41807.0,13375676.466666656,137974.0,20243041.42857143
2021-01-15,0.0768,0.09149,0.06577,0.08851,92144736.8,40934.0,46505175.7,0.07717,0.07047428571428571,0.06263250000000001,0.0795206169893897,0.07289818959719205,0.06521628743267913,74.76069819819821,0.08359151652474082,0.04167348347525919,0.005781403082319531,0.003930219050329348,0.0018511840319901827,0.025720000000000007,0.01448857142857143,657480466.6799986,0.026690000000000005,65.96662291393211,-7.18245360327789,92.81754639672211,72.87403682309305,15.24739583333335,0.06609,0.079,0.06455,0.07696,36101520.7,18062.0,19890740.2,16.447268875775467,70.7504078303426,0.07846818160960922,0.04297681839039077,0.00426268668358145,0.003467423042331802,0.000795263641249648,0.014450000000000005,0.012977857142857143,565335729.8799987,0.019729999999999998,49.37888198757763,-21.12346401404331,78.87653598595669,50.5266237565828,0.06727,0.0705312339787794,0.06797857142857143,0.06769425279625607,0.0607225,0.06276431768875061,42625.0,14752421.066666657,128052.0,18616312.52857143
2021-01-16,0.08851,0.09277,0.08045,0.08459,65600310.1,34675.0,30899775.1,0.08335333333333333,0.0721857142857143,0.0642055,0.08205530849469485,0.07582114219789404,0.06706140291528112,72.85322359396434,0.08681862844112648,0.04159237155887351,0.00659268911458076,0.00446271306317963,0.0021299760514011303,0.012320000000000011,0.015000714285714287,591880156.5799986,0.011480000000000004,64.98927247903256,-19.125555295768077,80.87444470423193,84.18950902897025,-4.428878092870869,0.0768,0.09149,0.06577,0.08851,92144736.8,40934.0,46505175.7,15.24739583333335,74.76069819819821,0.08359151652474082,0.04167348347525919,0.005781403082319531,0.003930219050329348,0.0018511840319901827,0.025720000000000007,0.01448857142857143,657480466.6799986,0.026690000000000005,65.96662291393211,-7.18245360327789,92.81754639672211,72.87403682309305,0.07717,0.0795206169893897,0.07047428571428571,0.07289818959719205,0.06263250000000001,0.06521628743267913,72884.0,26575918.633333325,141936.0,21255521.885714285
2021-01-17,0.08459,0.104,0.07508,0.09487,75755943.3,40291.0,41073379.9,0.08932333333333332,0.07575285714285715,0.0662145,0.08846265424734742,0.08058335664842053,0.0697098407328734,74.54334962696167,0.09216171238450213,0.04026728761549786,0.007973238694106446,0.005164818189364993,0.0028084205047414533,0.02892,0.016459285714285714,667636099.8799986,0.023749999999999993,67.2897196261682,-17.236171417783652,82.76382858221635,85.48527322772348,12.15273673010994,0.08851,0.09277,0.08045,0.08459,65600310.1,34675.0,30899775.1,-4.428878092870869,72.85322359396434,0.08681862844112648,0.04159237155887351,0.00659268911458076,0.00446271306317963,0.0021299760514011303,0.012320000000000011,0.015000714285714287,591880156.5799986,0.011480000000000004,64.98927247903256,-19.125555295768077,80.87444470423193,84.18950902897025,0.08335333333333333,0.08205530849469485,0.0721857142857143,0.07582114219789404,0.0642055,0.06706140291528112,93671.0,32431896.99999999,154306.0,22680345.414285716
2021-01-18,0.09495,0.10051,0.09065,0.0968,34696586.0,24756.0,16784384.2,0.09208666666666666,0.08094,0.068439,0.09263132712367371,0.0846375174863154,0.07228985590117117,74.99684144030323,0.09687598251813975,0.040002017481860254,0.00911796285249146,0.005955447121990287,0.003162515730501173,0.009860000000000008,0.015996428571428575,702332685.8799986,0.02575999999999999,69.14205836099947,-13.854146623051758,86.14585337694824,83.26137555446552,1.9483938915218435,0.08459,0.104,0.07508,0.09487,75755943.3,40291.0,41073379.9,12.15273673010994,74.54334962696167,0.09216171238450213,0.04026728761549786,0.007973238694106446,0.005164818189364993,0.0028084205047414533,0.02892,0.016459285714285714,667636099.8799986,0.023749999999999993,67.2897196261682,-17.236171417783652,82.76382858221635,85.48527322772348,0.08932333333333332,0.08846265424734742,0.07575285714285715,0.08058335664842053,0.0662145,0.0697098407328734,115900.0,39492776.89999999,175769.0,25499442.900000002
2021-01-19,0.09683,0.10462,0.089,0.09115,50886785.7,30081.0,24842327.4,0.09427333333333333,0.08556,0.070394,0.09189066356183685,0.08626563811473655,0.07408606010105961,68.283256451814,0.09945616234212695,0.041331837657873044,0.009460205850058148,0.006656398867603859,0.0028038069824542888,0.015620000000000009,0.016517857142857147,651445900.1799985,0.01854,47.4441928178583,-25.61323445521964,74.38676554478036,81.09881583464833,-5.8659506351337445,0.09495,0.10051,0.09065,0.0968,34696586.0,24756.0,16784384.2,1.9483938915218435,74.99684144030323,0.09687598251813975,0.040002017481860254,0.00911796285249146,0.005955447121990287,0.003162515730501173,0.009860000000000008,0.015996428571428575,702332685.8799986,0.02575999999999999,69.14205836099947,-13.854146623051758,86.14585337694824,83.26137555446552,0.09208666666666666,0.09263132712367371,0.08094,0.0846375174863154,0.068439,0.07228985590117117,99722.0,29585846.39999999,183281.0,25645711.157142855
2021-01-20,0.09129,0.09999,0.08153,0.092,43323249.7,28035.0,20323673.0,0.09331666666666666,0.08926857142857143,0.07241800000000001,0.09194533178091843,0.08769922858605242,0.07579214961524441,63.537336964311315,0.10158378355756034,0.043252216442439685,0.009688342604846203,0.007262787615052329,0.0024255549897938744,0.01845999999999999,0.016550714285714287,694769149.8799986,0.022099999999999995,25.83777868964574,-23.996957596501247,76.00304240349875,78.84522044174246,0.7777412641034093,0.09683,0.10462,0.089,0.09115,50886785.7,30081.0,24842327.4,-5.8659506351337445,68.283256451814,0.09945616234212695,0.041331837657873044,0.009460205850058148,0.006656398867603859,0.0028038069824542888,0.015620000000000009,0.016517857142857147,651445900.1799985,0.01854,47.4441928178583,-25.61323445521964,74.38676554478036,81.09881583464833,0.09427333333333333,0.09189066356183685,0.08556,0.08626563811473655,0.070394,0.07408606010105961,95128.0,27566697.166666657,202687.0,27618231.785714287
2021-01-21,0.09212,0.09264,0.07833,0.08064,37288405.2,21900.0,17138517.8,0.08793,0.08979428571428572,0.0737835,0.08629266589045922,0.08593442143953932,0.0762538496518878,56.0146575688653,0.1017176769729848,0.04584932302701521,0.008850462938599299,0.007580322679761723,0.0012701402588375758,0.014310000000000003,0.016131428571428574,657480744.6799985,0.02015,13.38582677165354,-45.5980224377258,54.4019775622742,68.26392850351777,-12.462006079027347,0.09129,0.09999,0.08153,0.092,43323249.7,28035.0,20323673.0,0.7777412641034093,63.537336964311315,0.10158378355756034,0.043252216442439685,0.009688342604846203,0.007262787615052329,0.0024255549897938744,0.01845999999999999,0.016550714285714287,694769149.8799986,0.022099999999999995,25.83777868964574,-23.996957596501247,76.00304240349875,78.84522044174246,0.09331666666666666,0.09194533178091843,0.08926857142857143,0.08769922858605242,0.07241800000000001,0.07579214961524441,82872.0,20650128.199999988,216834.0,28617065.07142857
2021-01-22,0.08064,0.09619,0.07381,0.08955,39731055.3,25301.0,19815928.0,0.08739666666666666,0.08994285714285713,0.0756975,0.08792133294522961,0.08683831607965449,0.07752014968504135,60.520632033647836,0.10235307540178298,0.04904192459821702,0.008803913764889038,0.007825040896787186,0.0009788728681018512,0.022379999999999997,0.016176428571428574,697211799.9799985,0.030740000000000003,26.055743243243246,-28.655637953983643,71.34436204601636,67.24979400392978,11.049107142857144,0.09212,0.09264,0.07833,0.08064,37288405.2,21900.0,17138517.8,-12.462006079027347,56.0146575688653,0.1017176769729848,0.04584932302701521,0.008850462938599299,0.007580322679761723,0.0012701402588375758,0.014310000000000003,0.016131428571428574,657480744.6799985,0.02015,13.38582677165354,-45.5980224377258,54.4019775622742,68.26392850351777,0.08793,0.08629266589045922,0.08979428571428572,0.08593442143953932,0.0737835,0.0762538496518878,80016.0,20768172.733333323,220672.0,28223890.442857143
2021-01-23,0.08958,0.09371,0.08467,0.08933,28187605.0,17935.0,13249019.7,0.08650666666666668,0.09062,0.0773285,0.0886256664726148,0.08746123705974088,0.07864489733408503,59.651350727314714,0.10306843520214577,0.05158856479785422,0.008649564255402226,0.007989945568510196,0.0006596186868920301,0.009040000000000006,0.016055000000000003,669024194.9799985,0.023290000000000005,23.027131249139266,-29.073968435063698,70.92603156493631,65.5574570577423,-0.27908015181960283,0.08064,0.09619,0.07381,0.08955,39731055.3,25301.0,19815928.0,11.049107142857144,60.520632033647836,0.10235307540178298,0.04904192459821702,0.008803913764889038,0.007825040896787186,0.0009788728681018512,0.022379999999999997,0.016176428571428574,697211799.9799985,0.030740000000000003,26.055743243243246,-28.655637953983643,71.34436204601636,67.24979400392978,0.08739666666666666,0.08792133294522961,0.08994285714285713,0.08683831607965449,0.0756975,0.07752014968504135,75236.0,19092706.266666654,205039.0,24411140.771428566
2021-01-24,0.08947,0.09378,0.08279,0.08779,39291168.4,23031.0,19580596.3,0.08889000000000001,0.08960857142857144,0.07885650000000001,0.0882078332363074,0.08754342779480567,0.0795158594927436,60.46811000585137,0.10316107117498963,0.05455192882501039,0.008307215616853839,0.008053399578178924,0.0002538160386749144,0.01099,0.015691428571428575,629733026.5799985,0.010830000000000006,25.593705293276116,-32.00228180262407,67.99771819737593,70.08937060277621,-1.877724376886093,0.08958,0.09371,0.08467,0.08933,28187605.0,17935.0,13249019.7,-0.27908015181960283,59.651350727314714,0.10306843520214577,0.05158856479785422,0.008649564255402226,0.007989945568510196,0.0006596186868920301,0.009040000000000006,0.016055000000000003,669024194.9799985,0.023290000000000005,23.027131249139266,-29.073968435063698,70.92603156493631,65.5574570577423,0.08650666666666668,0.0886256664726148,0.09062,0.08746123705974088,0.0773285,0.07864489733408503,65136.0,16734488.49999999,188299.0,21889604.285714287
2021-01-25,0.08769,0.0912,0.08075,0.08253,30208663.8,19010.0,13497982.6,0.08655,0.08757000000000001,0.079892,0.08536891661815371,0.08629007084610425,0.0798029204934347,63.55473554735548,0.1028688300685742,0.05691516993142581,0.007524723485605331,0.007947664359664207,-0.00042294087405887575,0.010450000000000001,0.015146428571428576,599524362.7799985,-0.005979999999999999,36.43577450818319,-45.43397778691896,54.56602221308104,64.49659065846443,-5.884365378036262,0.08947,0.09378,0.08279,0.08779,39291168.4,23031.0,19580596.3,-1.877724376886093,60.46811000585137,0.10316107117498963,0.05455192882501039,0.008307215616853839,0.008053399578178924,0.0002538160386749144,0.01099,0.015691428571428575,629733026.5799985,0.010830000000000006,25.593705293276116,-32.00228180262407,67.99771819737593,70.08937060277621,0.08889000000000001,0.0882078332363074,0.08960857142857144,0.08754342779480567,0.07885650000000001,0.0795158594927436,66267.0,17548514.666666657,171039.0,18819206.62857143
2021-01-26,0.08251,0.0995,0.08,0.09518,44370329.0,29385.0,22025018.2,0.08850000000000001,0.0881457142857143,0.0809955,0.09027445830907685,0.08851255313457819,0.08126740425596472,69.70846428958491,0.10470897871215257,0.05728202128784742,0.007835024824534798,0.007925136452638325,-9.011162810352788e-05,0.019500000000000003,0.01597071428571429,643894691.7799985,0.010590000000000002,61.843223941506544,-19.415878239407657,80.58412176059234,67.71595405701645,15.355714458853473,0.08769,0.0912,0.08075,0.08253,30208663.8,19010.0,13497982.6,-5.884365378036262,63.55473554735548,0.1028688300685742,0.05691516993142581,0.007524723485605331,0.007947664359664207,-0.00042294087405887575,0.010450000000000001,0.015146428571428576,599524362.7799985,-0.005979999999999999,36.43577450818319,-45.43397778691896,54.56602221308104,64.49659065846443,0.08655,0.08536891661815371,0.08757000000000001,0.08629007084610425,0.079892,0.0798029204934347,59976.0,15442532.866666658,165293.0,18349720.685714286
2021-01-27,0.09536,0.10456,0.08211,0.09,61527466.9,43360.0,30576029.4,0.08923666666666667,0.08786000000000001,0.0819395,0.09013722915453842,0.08888441485093365,0.08209908004111094,63.278652183551316,0.10550037700539375,0.05837862299460626,0.007575631003758326,0.007855235362862326,-0.0002796043591039993,0.022449999999999998,0.016747857142857144,582367224.8799986,-0.004869999999999999,36.28104179285281,-36.486149238832056,63.513850761167944,66.22133157828044,-5.62080536912752,0.08251,0.0995,0.08,0.09518,44370329.0,29385.0,22025018.2,15.355714458853473,69.70846428958491,0.10470897871215257,0.05728202128784742,0.007835024824534798,0.007925136452638325,-9.011162810352788e-05,0.019500000000000003,0.01597071428571429,643894691.7799985,0.010590000000000002,61.843223941506544,-19.415878239407657,80.58412176059234,67.71595405701645,0.08850000000000001,0.09027445830907685,0.0881457142857143,0.08851255313457819,0.0809955,0.08126740425596472,71426.0,18367865.699999988,164597.0,17947247.942857143
2021-01-28,0.08997,0.09642,0.08741,0.08857,31531639.8,23561.0,13227359.6,0.09125,0.08899285714285714,0.082816,0.0893536145772692,0.08880581113820023,0.0827153581324337,57.19063545150502,0.10597038019264166,0.059661619807358346,0.0071719961754718314,0.007718587525384227,-0.0005465913499123959,0.009010000000000004,0.01635928571428572,550835585.0799986,-0.008230000000000001,15.085758835758822,-41.31274131274132,58.68725868725867,67.595077069673,-1.556074246971211,0.09536,0.10456,0.08211,0.09,61527466.9,43360.0,30576029.4,-5.62080536912752,63.278652183551316,0.10550037700539375,0.05837862299460626,0.007575631003758326,0.007855235362862326,-0.0002796043591039993,0.022449999999999998,0.016747857142857144,582367224.8799986,-0.004869999999999999,36.28104179285281,-36.486149238832056,63.513850761167944,66.22133157828044,0.08923666666666667,0.09013722915453842,0.08786000000000001,0.08888441485093365,0.0819395,0.08209908004111094,91755.0,22033010.06666666,179922.0,19411870.285714287
2021-01-29,0.08886,0.1155,0.08818,0.11164,69174021.4,39754.0,36299032.4,0.09673666666666665,0.09214857142857144,0.0847675,0.10049680728863461,0.09451435835365017,0.08547008592934478,62.536585365853654,0.1107111181180028,0.05882388188199719,0.008614367792336014,0.007897743578774586,0.000716624213561428,0.02732000000000001,0.01647357142857143,620009606.4799986,0.020490000000000008,26.13264037961811,-9.258815063564409,90.74118493643559,70.98076479495408,25.63583164528473,0.08997,0.09642,0.08741,0.08857,31531639.8,23561.0,13227359.6,-1.556074246971211,57.19063545150502,0.10597038019264166,0.059661619807358346,0.0071719961754718314,0.007718587525384227,-0.0005465913499123959,0.009010000000000004,0.01635928571428572,550835585.0799986,-0.008230000000000001,15.085758835758822,-41.31274131274132,58.68725868725867,67.595077069673,0.09125,0.0893536145772692,0.08899285714285714,0.08880581113820023,0.082816,0.0827153581324337,96306.0,21942802.399999987,181583.0,18853133.4
2021-01-30,0.11163,0.1197,0.102,0.10452,48664332.2,33797.0,23835443.5,0.10157666666666666,0.09431857142857143,0.0864985,0.1025084036443173,0.09701576876523763,0.08728436345988339,60.440020953378735,0.11288143010741533,0.06011556989258468,0.009078284383413793,0.008133851739702427,0.0009444326437113657,0.017700000000000007,0.016857857142857147,571345274.2799985,0.012520000000000003,23.560704575008874,-33.07910220091523,66.92089779908477,72.11644714092635,-6.369255576457935,0.08886,0.1155,0.08818,0.11164,69174021.4,39754.0,36299032.4,25.63583164528473,62.536585365853654,0.1107111181180028,0.05882388188199719,0.008614367792336014,0.007897743578774586,0.000716624213561428,0.02732000000000001,0.01647357142857143,620009606.4799986,0.020490000000000008,26.13264037961811,-9.258815063564409,90.74118493643559,70.98076479495408,0.09673666666666665,0.10049680728863461,0.09214857142857144,0.09451435835365017,0.0847675,0.08547008592934478,106675.0,26700807.13333332,196036.0,21207862.599999998
2021-01-31,0.10454,0.10565,0.09508,0.09803,33902982.2,22811.0,16152267.2,0.10473,0.09578142857142857,0.0883755,0.10026920182215865,0.09726932657392821,0.08830775741608496,51.72376172812569,0.11218328773515579,0.0645677122648442,0.00882057476806547,0.008271196345375036,0.0005493784226904344,0.010569999999999996,0.01554714285714286,537442292.0799985,0.017390000000000003,3.330873827342695,-47.22161691000217,52.77838308999784,70.1468219418394,-6.2272814233786,0.11163,0.1197,0.102,0.10452,48664332.2,33797.0,23835443.5,-6.369255576457935,60.440020953378735,0.11288143010741533,0.06011556989258468,0.009078284383413793,0.008133851739702427,0.0009444326437113657,0.017700000000000007,0.016857857142857147,571345274.2799985,0.012520000000000003,23.560704575008874,-33.07910220091523,66.92089779908477,72.11644714092635,0.10157666666666666,0.1025084036443173,0.09431857142857143,0.09701576876523763,0.0864985,0.08728436345988339,97112.0,24453945.166666657,211898.0,22720208.85714286
2021-02-01,0.0981,0.11513,0.095,0.10884,48472490.3,31044.0,23544039.6,0.10379666666666666,0.09953999999999999,0.090877,0.10455460091107932,0.10016199493044615,0.09026320909074353,55.987666600358075,0.11196267994984976,0.06979132005015024,0.009380482337031135,0.008493053543706256,0.0008874287933248789,0.020129999999999995,0.016280714285714287,585914782.3799984,0.01929,12.438016528925623,-23.665286554804958,76.33471344519505,65.34466477809256,10.9480122324159,0.10454,0.10565,0.09508,0.09803,33902982.2,22811.0,16152267.2,-6.2272814233786,51.72376172812569,0.11218328773515579,0.0645677122648442,0.00882057476806547,0.008271196345375036,0.0005493784226904344,0.010569999999999996,0.01554714285714286,537442292.0799985,0.017390000000000003,3.330873827342695,-47.22161691000217,52.77838308999784,70.1468219418394,0.10473,0.10026920182215865,0.09578142857142857,0.09726932657392821,0.0883755,0.08830775741608496,96362.0,25428914.366666656,211678.0,22230447.557142854
2021-02-02,0.10887,0.11268,0.105,0.1101,29307259.8,22122.0,13898994.3,0.10565666666666668,0.10167142857142857,0.09308000000000001,0.10732730045553966,0.10264649619783461,0.0921524272725775,59.85439417576703,0.11236981733017981,0.07379018266982021,0.009812769095200458,0.008756996654005096,0.0010557724411953615,0.007680000000000006,0.01571357142857143,615222042.1799984,0.020769999999999997,20.789906747120135,-20.91959032468947,79.08040967531052,69.39783540350113,1.1297878203361889,0.0981,0.11513,0.095,0.10884,48472490.3,31044.0,23544039.6,10.9480122324159,55.987666600358075,0.11196267994984976,0.06979132005015024,0.009380482337031135,0.008493053543706256,0.0008874287933248789,0.020129999999999995,0.016280714285714287,585914782.3799984,0.01929,12.438016528925623,-23.665286554804958,76.33471344519505,65.34466477809256,0.10379666666666666,0.10455460091107932,0.09953999999999999,0.10016199493044615,0.090877,0.09026320909074353,87652.0,21177250.09999999,223712.0,23665598.557142857
2021-02-03,0.10993,0.16,0.10983,0.15841,134649000.8,87715.0,69344164.1,0.12578333333333333,0.1114442857142857,0.0971525,0.13286865022776984,0.11658737214837596,0.09846267229423679,73.12164891024302,0.13100639777761144,0.06329860222238856,0.01389341804709722,0.009784280932623521,0.0041091371144736984,0.050170000000000006,0.01797857142857143,749871042.9799984,0.07061999999999999,72.18478260869566,-1.84476157326837,98.15523842673163,84.52345384907908,44.10079141271718,0.10887,0.11268,0.105,0.1101,29307259.8,22122.0,13898994.3,1.1297878203361889,59.85439417576703,0.11236981733017981,0.07379018266982021,0.009812769095200458,0.008756996654005096,0.0010557724411953615,0.007680000000000006,0.01571357142857143,615222042.1799984,0.020769999999999997,20.789906747120135,-20.91959032468947,79.08040967531052,69.39783540350113,0.10565666666666668,0.10732730045553966,0.10167142857142857,0.10264649619783461,0.09308000000000001,0.0921524272725775,75977.0,17865100.366666656,216449.0,22504738.0
2021-02-04,0.15819,0.1585,0.13,0.14849,76147102.3,59336.0,36709869.2,0.139,0.12000428571428572,0.10015149999999999,0.14067932511388492,0.12456302911128198,0.10322717969478566,73.86227755503975,0.14073896618820972,0.059564033811790255,0.01614083910004087,0.01105559256610699,0.005085246533933878,0.028499999999999998,0.018992142857142857,673723940.6799984,0.06596,84.13938492063492,-13.354217426615609,86.6457825733844,87.96047689180887,-6.131866742524803,0.10993,0.16,0.10983,0.15841,134649000.8,87715.0,69344164.1,44.10079141271718,73.12164891024302,0.13100639777761144,0.06329860222238856,0.01389341804709722,0.009784280932623521,0.0041091371144736984,0.050170000000000006,0.01797857142857143,749871042.9799984,0.07061999999999999,72.18478260869566,-1.84476157326837,98.15523842673163,84.52345384907908,0.12578333333333333,0.13286865022776984,0.1114442857142857,0.11658737214837596,0.0971525,0.09846267229423679,140881.0,35595732.66666665,260804.0,28043042.957142856
2021-02-05,0.14843,0.1888,0.14702,0.17848,98621473.0,79227.0,50934766.1,0.16179333333333334,0.12955285714285714,0.104846,0.15957966255694245,0.1380422718334615,0.11039411496194892,77.23736600306279,0.15771585705733726,0.05197614294266273,0.020110062556335295,0.012866486564152652,0.007243575992182644,0.041779999999999984,0.020377857142857142,772345413.6799984,0.0833,99.3076493579006,-9.485294117647056,90.51470588235294,91.771908960823,20.245233443373976,0.15819,0.1585,0.13,0.14849,76147102.3,59336.0,36709869.2,-6.131866742524803,73.86227755503975,0.14073896618820972,0.059564033811790255,0.01614083910004087,0.01105559256610699,0.005085246533933878,0.028499999999999998,0.018992142857142857,673723940.6799984,0.06596,84.13938492063492,-13.354217426615609,86.6457825733844,87.96047689180887,0.139,0.14067932511388492,0.12000428571428572,0.12456302911128198,0.10015149999999999,0.10322717969478566,169173.0,39984342.533333324,296579.0,31397687.185714286
2021-02-06,0.17912,0.18025,0.15085,0.17,66797149.1,57880.0,32104563.0,0.16565666666666667,0.13890714285714287,0.1086025,0.16478983127847124,0.14603170387509612,0.11607086591795379,73.51757914990381,0.16867368719968054,0.04853131280031947,0.02231421127501229,0.01475603150632458,0.007558179768687711,0.02939999999999998,0.021832142857142856,705548264.5799984,0.08000000000000002,90.30560841822457,-17.27941176470587,82.72058823529413,86.62702556367715,-5.0915587315765904,0.14843,0.1888,0.14702,0.17848,98621473.0,79227.0,50934766.1,20.245233443373976,77.23736600306279,0.15771585705733726,0.05197614294266273,0.020110062556335295,0.012866486564152652,0.007243575992182644,0.041779999999999984,0.020377857142857142,772345413.6799984,0.0833,99.3076493579006,-9.485294117647056,90.51470588235294,91.771908960823,0.16179333333333334,0.15957966255694245,0.12955285714285714,0.1380422718334615,0.104846,0.11039411496194892,226278.0,52329599.79999998,336052.0,33488506.285714287
2021-02-07,0.17,0.18844,0.15273,0.18214,68659964.4,58089.0,37622822.6,0.17687333333333333,0.15092285714285714,0.1128695,0.1734649156392356,0.15505877790632208,0.12236316440195819,75.90467299983527,0.1809946478337371,0.04474435216626292,0.024755248461724902,0.016755874897404648,0.007999373564320254,0.03570999999999999,0.023597857142857143,774208228.9799984,0.09357,107.47237726392527,-6.1213235294117645,93.87867647058825,89.03799019607845,7.141176470588226,0.17912,0.18025,0.15085,0.17,66797149.1,57880.0,32104563.0,-5.0915587315765904,73.51757914990381,0.16867368719968054,0.04853131280031947,0.02231421127501229,0.01475603150632458,0.007558179768687711,0.02939999999999998,0.021832142857142856,705548264.5799984,0.08000000000000002,90.30560841822457,-17.27941176470587,82.72058823529413,86.62702556367715,0.16565666666666667,0.16478983127847124,0.13890714285714287,0.14603170387509612,0.1086025,0.11607086591795379,196443.0,39916399.433333315,360135.0,34669809.071428575
2021-02-08,0.18219,0.2295,0.17812,0.21432,136022792.85,119880.0,70529420.54,0.18882000000000002,0.16599142857142857,0.119028,0.1938924578196178,0.16987408342974158,0.13112095826843836,81.52418313160791,0.19995271448659518,0.038103285513404805,0.028952696417562693,0.01919523920143626,0.009757457216126433,0.05138000000000001,0.026521428571428567,910231021.8299984,0.10268000000000001,159.68738640494365,-10.153846153846152,89.84615384615383,88.81513951734541,17.635435534332302,0.17,0.18844,0.15273,0.18214,68659964.4,58089.0,37622822.6,7.141176470588226,75.90467299983527,0.1809946478337371,0.04474435216626292,0.024755248461724902,0.016755874897404648,0.007999373564320254,0.03570999999999999,0.023597857142857143,774208228.9799984,0.09357,107.47237726392527,-6.1213235294117645,93.87867647058825,89.03799019607845,0.17687333333333333,0.1734649156392356,0.15092285714285714,0.15505877790632208,0.1128695,0.12236316440195819,195196.0,40220717.23333332,395413.0,37737031.27142857
2021-02-09,0.21376,0.2748,0.206,0.25112,104719827.72,86521.0,53380904.95,0.21586000000000002,0.18613714285714286,0.12698399999999999,0.22250622890980892,0.19018556257230618,0.142549438433349,83.43768762329532,0.2259881675677826,0.027979832432217383,0.03484696252065428,0.022325583865279865,0.012521378655374414,0.0688,0.030042857142857145,1014950849.5499984,0.1466,163.83694053372557,-12.28916913176604,87.71083086823396,90.47855372832537,17.477544910179642,0.18219,0.2295,0.17812,0.21432,136022792.85,119880.0,70529420.54,17.635435534332302,81.52418313160791,0.19995271448659518,0.038103285513404805,0.028952696417562693,0.01919523920143626,0.009757457216126433,0.05138000000000001,0.026521428571428567,910231021.8299984,0.10268000000000001,159.68738640494365,-10.153846153846152,89.84615384615383,88.81513951734541,0.18882000000000002,0.1938924578196178,0.16599142857142857,0.16987408342974158,0.119028,0.13112095826843836,235849.0,46752268.71333333,484249.0,44449228.54857142
2021-02-10,0.25194,0.27622,0.2064,0.23952,79231285.82,81806.0,39534457.02,0.23498666666666668,0.19772428571428574,0.134928,0.23101311445490447,0.20251917192922964,0.15178473001112527,81.20200333889818,0.24332601116839395,0.02652998883160604,0.0381425047664308,0.025488968045510055,0.012653536720920747,0.06982000000000002,0.03342642857142857,935719563.7299984,0.14149,166.13333333333333,-19.437529791854246,80.56247020814575,86.0398183075112,-4.92974517742319,0.21376,0.2748,0.206,0.25112,104719827.72,86521.0,53380904.95,17.477544910179642,83.43768762329532,0.2259881675677826,0.027979832432217383,0.03484696252065428,0.022325583865279865,0.012521378655374414,0.0688,0.030042857142857145,1014950849.5499984,0.1466,163.83694053372557,-12.28916913176604,87.71083086823396,90.47855372832537,0.21586000000000002,0.22250622890980892,0.18613714285714286,0.19018556257230618,0.12698399999999999,0.142549438433349,264490.0,53844382.69666666,548648.0,50089501.49857143
2021-02-11,0.23922,0.25863,0.21957,0.23532,63208848.6,70356.0,30520297.2,0.24198666666666668,0.21012857142857144,0.14221650000000002,0.23316655722745222,0.21071937894692222,0.15974047001006575,80.27396129884062,0.2571719220739963,0.02726107792600377,0.03995476715538471,0.028382127867484987,0.01157263928789972,0.03906000000000004,0.03557285714285714,872510715.1299983,0.12647999999999998,165.68815626058483,-21.750691342267608,78.24930865773237,82.17420324470403,-1.6302984700275844,0.25194,0.27622,0.2064,0.23952,79231285.82,81806.0,39534457.02,-4.92974517742319,81.20200333889818,0.24332601116839395,0.02652998883160604,0.0381425047664308,0.025488968045510055,0.012653536720920747,0.06982000000000002,0.03342642857142857,935719563.7299984,0.14149,166.13333333333333,-19.437529791854246,80.56247020814575,86.0398183075112,0.23498666666666668,0.23101311445490447,0.19772428571428574,0.20251917192922964,0.134928,0.15178473001112527,288207.0,54481594.16999999,542739.0,45830971.915714286
2021-02-12,0.23499,0.27,0.223,0.25158,66513092.1,72884.0,34410947.7,0.24214000000000002,0.22057142857142858,0.15032900000000002,0.24237327861372612,0.22093453421019169,0.168487091913869,79.70368483613518,0.2722583999173728,0.028399600082627235,0.04221639988570036,0.031148982271128063,0.011067417614572299,0.047000000000000014,0.03697857142857143,939023807.2299984,0.14148000000000002,125.34933715514155,-13.596733252400393,86.4032667475996,81.73834853782591,7.059874888293127,0.23922,0.25863,0.21957,0.23532,63208848.6,70356.0,30520297.2,-1.6302984700275844,80.27396129884062,0.2571719220739963,0.02726107792600377,0.03995476715538471,0.028382127867484987,0.01157263928789972,0.03906000000000004,0.03557285714285714,872510715.1299983,0.12647999999999998,165.68815626058483,-21.750691342267608,78.24930865773237,82.17420324470403,0.24198666666666668,0.23316655722745222,0.21012857142857144,0.21071937894692222,0.14221650000000002,0.15974047001006575,238683.0,41145219.72333332,553759.0,44946747.34428572
2021-02-13,0.25165,0.2866,0.22624,0.26402,80192696.84,76644.0,42593195.74,0.2503066666666667,0.23400285714285718,0.15914050000000002,0.25319663930686304,0.23170590065764374,0.17758546411254814,83.10777150448357,0.28734992119500424,0.03093107880499582,0.04449960045918752,0.03381910590873996,0.010680494550447561,0.060360000000000025,0.04002571428571428,1019216504.0699984,0.10560999999999998,152.60237275162643,-11.784968684759939,88.21503131524007,84.28920224019069,4.915557321676929,0.23499,0.27,0.223,0.25158,66513092.1,72884.0,34410947.7,7.059874888293127,79.70368483613518,0.2722583999173728,0.028399600082627235,0.04221639988570036,0.031148982271128063,0.011067417614572299,0.047000000000000014,0.03697857142857143,939023807.2299984,0.14148000000000002,125.34933715514155,-13.596733252400393,86.4032667475996,81.73834853782591,0.24214000000000002,0.24237327861372612,0.22057142857142858,0.22093453421019169,0.15032900000000002,0.168487091913869,225046.0,34821900.639999986,547416.0,42586201.858571425
2021-02-14,0.26445,0.2873,0.23478,0.24813,61947369.3,65358.0,29798014.7,0.2545766666666667,0.24343,0.1674205,0.2506633196534315,0.2358119254932328,0.1843039913399245,79.98641521495925,0.2961860224327091,0.03865497756729089,0.044513736515803565,0.03595803203015268,0.008555704485650885,0.05252000000000001,0.043022142857142856,957269134.7699984,0.09963999999999998,153.11639294093644,-20.369214768590748,79.63078523140925,84.74969443141632,-6.171298922291559,0.25165,0.2866,0.22624,0.26402,80192696.84,76644.0,42593195.74,4.915557321676929,83.10777150448357,0.28734992119500424,0.03093107880499582,0.04449960045918752,0.03381910590873996,0.010680494550447561,0.060360000000000025,0.04002571428571428,1019216504.0699984,0.10560999999999998,152.60237275162643,-11.784968684759939,88.21503131524007,84.28920224019069,0.2503066666666667,0.25319663930686304,0.23400285714285718,0.23170590065764374,0.15914050000000002,0.17758546411254814,219884.0,35841480.213333316,566180.0,44084577.96428572
2021-02-15,0.24868,0.27734,0.1888,0.2394,69962419.9,73599.0,33987039.9,0.25051666666666667,0.24701285714285717,0.1746315,0.24503165982671576,0.2367089441199246,0.18955123025993167,76.3013698630137,0.30251306284954527,0.04674993715045472,0.04332112246881267,0.03743065011788468,0.005890472350927996,0.08853999999999998,0.04790857142857143,887306714.8699985,0.06092,119.95589856670338,-26.275370268787707,73.72462973121229,80.52348209262055,-3.731703393919901,0.26445,0.2873,0.23478,0.24813,61947369.3,65358.0,29798014.7,-6.171298922291559,79.98641521495925,0.2961860224327091,0.03865497756729089,0.044513736515803565,0.03595803203015268,0.008555704485650885,0.05252000000000001,0.043022142857142856,957269134.7699984,0.09963999999999998,153.11639294093644,-20.369214768590748,79.63078523140925,84.74969443141632,0.2545766666666667,0.2506633196534315,0.24343,0.2358119254932328,0.1674205,0.1843039913399245,214886.0,35600719.37999999,573449.0,42966748.264285706
2021-02-16,0.2394,0.25796,0.21609,0.22679,38789254.4,43111.0,18596022.2,0.2381066666666667,0.24353714285714284,0.181471,0.23591082991335788,0.23422920808994346,0.19309777975898582,72.47929108071664,0.30484675483051804,0.058095245169481974,0.0408871243126937,0.03812194495684648,0.0027651793558472193,0.04187000000000002,0.05035071428571429,848517460.4699985,0.05678999999999998,105.98546775658492,-34.09590353299149,65.9040964670085,73.08650380987669,-5.267335004177114,0.24868,0.27734,0.1888,0.2394,69962419.9,73599.0,33987039.9,-3.731703393919901,76.3013698630137,0.30251306284954527,0.04674993715045472,0.04332112246881267,0.03743065011788468,0.005890472350927996,0.08853999999999998,0.04790857142857143,887306714.8699985,0.06092,119.95589856670338,-26.275370268787707,73.72462973121229,80.52348209262055,0.25051666666666667,0.24503165982671576,0.24701285714285717,0.2367089441199246,0.1746315,0.18955123025993167,215601.0,35459416.77999998,527168.0,37746408.17285715
2021-02-17,0.22655,0.24891,0.20943,0.23594,29811102.4,39961.0,14301192.9,0.23404333333333338,0.24302571428571426,0.1888395,0.23592541495667896,0.2346569060674576,0.19717799121051097,67.58927356050638,0.3063154733508811,0.07136352664911888,0.03924411009564671,0.03834637798460653,0.0008977321110401823,0.03947999999999999,0.049587142857142864,878328562.8699985,0.053800000000000014,48.942617259011435,-32.6509853782581,67.3490146217419,68.99258027332091,4.1447804016773375,0.2394,0.25796,0.21609,0.22679,38789254.4,43111.0,18596022.2,-5.267335004177114,72.47929108071664,0.30484675483051804,0.058095245169481974,0.0408871243126937,0.03812194495684648,0.0027651793558472193,0.04187000000000002,0.05035071428571429,848517460.4699985,0.05678999999999998,105.98546775658492,-34.09590353299149,65.9040964670085,73.08650380987669,0.2381066666666667,0.23591082991335788,0.24353714285714284,0.23422920808994346,0.181471,0.19309777975898582,182068.0,27460358.93333331,483758.0,32777139.20857143
2021-02-18,0.23602,0.326,0.23602,0.30729,159232400.72,100732.0,112476063.52,0.25667333333333336,0.25330714285714284,0.198622,0.2716077074783395,0.2528151795505932,0.2076648491904623,78.17401178056917,0.3214909353228411,0.0757530646771589,0.04320135981054557,0.03931737434979434,0.0038839854607512284,0.08998,0.05397857142857143,1037560963.5899985,0.09297,106.94322850023568,-10.45368197563974,89.54631802436026,74.26647637103689,30.19659350902466,0.22655,0.24891,0.20943,0.23594,29811102.4,39961.0,14301192.9,4.1447804016773375,67.58927356050638,0.3063154733508811,0.07136352664911888,0.03924411009564671,0.03834637798460653,0.0008977321110401823,0.03947999999999999,0.049587142857142864,878328562.8699985,0.053800000000000014,48.942617259011435,-32.6509853782581,67.3490146217419,68.99258027332091,0.23404333333333338,0.23592541495667896,0.24302571428571426,0.2346569060674576,0.1888395,0.19717799121051097,156671.0,22294751.666666646,441913.0,29172387.191428572
2021-02-19,0.30705,0.31742,0.27,0.29228,74207457.4,51984.0,50897948.5,0.2785033333333334,0.25912142857142856,0.20800999999999997,0.28194385373916975,0.2626813846629449,0.21572343498184682,71.32363963423774,0.3292870870015397,0.08673291299846027,0.04461206702523218,0.040376312884881915,0.004235754140350267,0.04741999999999996,0.054381428571428574,963353506.1899985,0.041159999999999974,63.76064545047064,-19.252069654581803,80.7479303454182,79.21442099717346,-4.810291483471749,0.23602,0.326,0.23602,0.30729,159232400.72,100732.0,112476063.52,30.19659350902466,78.17401178056917,0.3214909353228411,0.0757530646771589,0.04320135981054557,0.03931737434979434,0.0038839854607512284,0.08998,0.05397857142857143,1037560963.5899985,0.09297,106.94322850023568,-10.45368197563974,89.54631802436026,74.26647637103689,0.25667333333333336,0.2716077074783395,0.25330714285714284,0.2528151795505932,0.198622,0.2076648491904623,183804.0,48457759.539999984,472289.0,40880353.80857142
2021-02-20,0.29148,0.31922,0.263,0.2884,91116545.0,59505.0,59426452.4,0.29599000000000003,0.2626042857142857,0.2175285,0.28517192686958487,0.26911103849720863,0.22264501260262332,72.57474069554605,0.3321615907079768,0.1028954092920232,0.04489940667177886,0.041280931642261307,0.003618475029517551,0.05621999999999999,0.056297142857142865,872236961.1899985,0.04887999999999998,69.64705882352939,-21.700236624920656,78.29976337507935,82.86467058161928,-1.0566762728146106,0.30705,0.31742,0.27,0.29228,74207457.4,51984.0,50897948.5,-4.810291483471749,71.32363963423774,0.3292870870015397,0.08673291299846027,0.04461206702523218,0.040376312884881915,0.004235754140350267,0.04741999999999996,0.054381428571428574,963353506.1899985,0.041159999999999974,63.76064545047064,-19.252069654581803,80.7479303454182,79.21442099717346,0.2785033333333334,0.28194385373916975,0.25912142857142856,0.2626813846629449,0.20800999999999997,0.21572343498184682,192677.0,59225068.30666665,451389.0,43235639.63714286
2021-02-21,0.2895,0.31772,0.2716,0.29609,68143953.6,58253.0,45180363.4,0.29225666666666666,0.2694557142857143,0.22689100000000004,0.29063096343479244,0.27585577887290647,0.2296397733071354,72.10132278210946,0.33452012165101275,0.1192618783489873,0.04522630346982226,0.042070006007773504,0.0031562974620487558,0.046119999999999994,0.057040714285714285,940380914.7899985,0.06077000000000002,62.56176567475569,-20.225858804436022,79.77414119556397,79.60727830535386,2.2763385146804973,0.29148,0.31922,0.263,0.2884,91116545.0,59505.0,59426452.4,-1.0566762728146106,72.57474069554605,0.3321615907079768,0.1028954092920232,0.04489940667177886,0.041280931642261307,0.003618475029517551,0.05621999999999999,0.056297142857142865,872236961.1899985,0.04887999999999998,69.64705882352939,-21.700236624920656,78.29976337507935,82.86467058161928,0.29599000000000003,0.28517192686958487,0.2626042857142857,0.26911103849720863,0.2175285,0.22264501260262332,212221.0,74266821.47333331,434250.0,45640390.58857143
2021-02-22,0.2957,0.29937,0.2201,0.27521,87646447.4,70449.0,52489718.8,0.2865666666666667,0.2745714285714286,0.2351465,0.28292048171739625,0.27569433415467987,0.23397979489693202,62.35141385046047,0.3295762618728783,0.1407167381271217,0.043301378699402454,0.042316280546099296,0.0009850981533031586,0.07927000000000003,0.05903285714285715,852734467.3899986,0.023629999999999984,28.410787607316166,-37.018950437317784,62.98104956268222,73.68498471110853,-6.929320257017249,0.2895,0.31772,0.2716,0.29609,68143953.6,58253.0,45180363.4,2.2763385146804973,72.10132278210946,0.33452012165101275,0.1192618783489873,0.04522630346982226,0.042070006007773504,0.0031562974620487558,0.046119999999999994,0.057040714285714285,940380914.7899985,0.06077000000000002,62.56176567475569,-20.225858804436022,79.77414119556397,79.60727830535386,0.29225666666666666,0.29063096343479244,0.2694557142857143,0.27585577887290647,0.22689100000000004,0.2296397733071354,169742.0,51834921.433333315,427145.0,47837868.974285714
2021-02-23,0.27477,0.27673,0.17392,0.22399,89899332.4,63564.0,45951554.0,0.2650966666666667,0.27417142857142857,0.2384255,0.25345524085869814,0.2627682506160099,0.233028385859129,44.80088919550803,0.3259368164351366,0.15091418356486344,0.03721385782571848,0.041295796002023134,-0.004081938176304652,0.10280999999999998,0.06146214285714286,762835134.9899986,-0.04002999999999998,-10.80359987257089,-67.07653866386113,32.92346133613887,58.55955069812836,-18.480911307639122,0.2957,0.29937,0.2201,0.27521,87646447.4,70449.0,52489718.8,-6.929320257017249,62.35141385046047,0.3295762618728783,0.1407167381271217,0.043301378699402454,0.042316280546099296,0.0009850981533031586,0.07927000000000003,0.05903285714285715,852734467.3899986,0.023629999999999984,28.410787607316166,-37.018950437317784,62.98104956268222,73.68498471110853,0.2865666666666667,0.28292048171739625,0.2745714285714286,0.27569433415467987,0.2351465,0.23397979489693202,188207.0,52365511.533333324,423995.0,50481108.81714285
2021-02-24,0.22342,0.2759,0.20747,0.23287,60216533.9,52343.0,33655560.0,0.24402333333333334,0.27373285714285717,0.24264449999999999,0.24316262042934905,0.2552936879620074,0.2330133014915929,48.71218869824548,0.31937103434524233,0.16591796565475764,0.03272871916028841,0.039582380633676195,-0.006853661473387784,0.06842999999999999,0.06136285714285714,823051668.8899986,-0.015259999999999996,-2.776386105544426,-61.23750657548659,38.76249342451341,44.88900144111151,4.229701906722759,0.27477,0.27673,0.17392,0.22399,89899332.4,63564.0,45951554.0,-18.480911307639122,44.80088919550803,0.3259368164351366,0.15091418356486344,0.03721385782571848,0.041295796002023134,-0.004081938176304652,0.10280999999999998,0.06146214285714286,762835134.9899986,-0.04002999999999998,-10.80359987257089,-67.07653866386113,32.92346133613887,58.55955069812836,0.2650966666666667,0.25345524085869814,0.27417142857142857,0.2627682506160099,0.2384255,0.233028385859129,192266.0,47873878.73333331,444448.0,54389041.93142857
2021-02-25,0.23287,0.264,0.22313,0.22555,44581365.4,38597.0,23224046.6,0.22747000000000003,0.2620557142857143,0.244998,0.2343563102146745,0.24785776597150558,0.23230251087334597,48.1305728827829,0.31612046624105916,0.17387553375894083,0.028257813149933947,0.03731746713692775,-0.0090596539869938,0.04087000000000002,0.06149214285714286,778470303.4899986,-0.013850000000000001,-4.151793302736695,-66.05076275644397,33.94923724355603,35.21173066806944,-3.1433847210890167,0.22342,0.2759,0.20747,0.23287,60216533.9,52343.0,33655560.0,4.229701906722759,48.71218869824548,0.31937103434524233,0.16591796565475764,0.03272871916028841,0.039582380633676195,-0.006853661473387784,0.06842999999999999,0.06136285714285714,823051668.8899986,-0.015259999999999996,-2.776386105544426,-61.23750657548659,38.76249342451341,44.88900144111151,0.24402333333333334,0.24316262042934905,0.27373285714285717,0.2552936879620074,0.24264449999999999,0.2330133014915929,186356.0,44032277.59999999,456830.0,57153951.517142855
2021-02-26,0.22658,0.24323,0.2,0.22514,51731654.1,39267.0,29194377.1,0.22785333333333335,0.25246428571428575,0.24775500000000003,0.22974815510733726,0.2421783244786292,0.23162036698064636,44.614193758657215,0.3104069943816642,0.18510300561833587,0.024400233647235314,0.03473402043898926,-0.010333786791753945,0.04322999999999999,0.06122285714285714,726738649.3899986,-0.0016499999999999848,-10.509579457826545,-66.32035770647028,33.679642293529724,35.46379098719973,-0.6355371171330201,0.23287,0.264,0.22313,0.22555,44581365.4,38597.0,23224046.6,-3.1433847210890167,48.1305728827829,0.31612046624105916,0.17387553375894083,0.028257813149933947,0.03731746713692775,-0.0090596539869938,0.04087000000000002,0.06149214285714286,778470303.4899986,-0.013850000000000001,-4.151793302736695,-66.05076275644397,33.94923724355603,35.21173066806944,0.22747000000000003,0.2343563102146745,0.2620557142857143,0.24785776597150558,0.244998,0.23230251087334597,154504.0,34277053.533333324,394695.0,44403663.38571429
2021-02-27,0.22502,0.29248,0.22479,0.27529,81679395.2,62209.0,51161708.9,0.24199333333333337,0.2505914285714286,0.2524125,0.25251907755366865,0.2504562433589719,0.23577937964915624,51.989970688985416,0.30797478515440146,0.1968502148455985,0.02510041798389892,0.03280729994797119,-0.007706881964072272,0.06769000000000003,0.06174642857142858,808418044.5899986,0.03934999999999997,4.268616013938331,-33.344292477643364,66.65570752235664,44.761529019814134,22.340236423429022,0.22658,0.24323,0.2,0.22514,51731654.1,39267.0,29194377.1,-0.6355371171330201,44.614193758657215,0.3104069943816642,0.18510300561833587,0.024400233647235314,0.03473402043898926,-0.010333786791753945,0.04322999999999999,0.06122285714285714,726738649.3899986,-0.0016499999999999848,-10.509579457826545,-66.32035770647028,33.679642293529724,35.46379098719973,0.22785333333333335,0.22974815510733726,0.25246428571428575,0.2421783244786292,0.24775500000000003,0.23162036698064636,130207.0,28691327.899999987,381978.0,41303153.18571429
2021-02-28,0.27612,0.27818,0.22036,0.24682,60326795.2,46292.0,31928839.2,0.24908333333333332,0.24355285714285713,0.2540375,0.24966953877683434,0.24954718251922892,0.23683086730161756,49.77852916314455,0.30673618823894333,0.20133881176105672,0.02309183969514364,0.030864207897405682,-0.007772368202262042,0.05781999999999998,0.062125,748091249.3899986,-0.060469999999999996,-0.5279490589610192,-52.0647027880063,47.93529721199369,49.42354900929336,-10.611328407938565,0.22502,0.29248,0.22479,0.27529,81679395.2,62209.0,51161708.9,22.340236423429022,51.989970688985416,0.30797478515440146,0.1968502148455985,0.02510041798389892,0.03280729994797119,-0.007706881964072272,0.06769000000000003,0.06174642857142858,808418044.5899986,0.03934999999999997,4.268616013938331,-33.344292477643364,66.65570752235664,44.761529019814134,0.24199333333333337,0.25251907755366865,0.2505914285714286,0.2504562433589719,0.2524125,0.23577937964915624,140073.0,34526710.86666665,384682.0,40122475.54285715
2021-03-01,0.24589,0.288,0.24309,0.27925,49801055.0,41309.0,31565004.1,0.26711999999999997,0.24412999999999999,0.255444,0.2644597693884172,0.25697288688942166,0.2408707847014635,56.23728282986383,0.30930359188384937,0.2015844081161506,0.02384202092537646,0.02945977050299984,-0.005617749577623378,0.04490999999999998,0.059008571428571424,797892304.3899986,-0.013029999999999986,16.64578111946533,-30.740399789584433,69.25960021041556,61.28353498158864,13.567042173329538,0.27612,0.27818,0.22036,0.24682,60326795.2,46292.0,31928839.2,-10.611328407938565,49.77852916314455,0.30673618823894333,0.20133881176105672,0.02309183969514364,0.030864207897405682,-0.007772368202262042,0.05781999999999998,0.062125,748091249.3899986,-0.060469999999999996,-0.5279490589610192,-52.0647027880063,47.93529721199369,49.42354900929336,0.24908333333333332,0.24966953877683434,0.24355285714285713,0.24954718251922892,0.2540375,0.23683086730161756,147768.0,37428308.39999998,372721.0,38229400.65714286
2021-03-02,0.27925,0.31607,0.27,0.31185,59353616.5,56574.0,30181511.8,0.27930666666666665,0.2566814285714286,0.2590605,0.2881548846942086,0.27069216516706623,0.2476307099679908,62.52946028753241,0.3179011338206952,0.2002198661793049,0.026758635610882264,0.028919543524576326,-0.0021609079136940615,0.04607,0.059308571428571426,857245920.8899986,0.023450000000000026,37.50606287755194,-9.304313519200418,90.69568648079958,69.29686130106961,11.674127126230982,0.24589,0.288,0.24309,0.27925,49801055.0,41309.0,31565004.1,13.567042173329538,56.23728282986383,0.30930359188384937,0.2015844081161506,0.02384202092537646,0.02945977050299984,-0.005617749577623378,0.04490999999999998,0.059008571428571424,797892304.3899986,-0.013029999999999986,16.64578111946533,-30.740399789584433,69.25960021041556,61.28353498158864,0.26711999999999997,0.2644597693884172,0.24412999999999999,0.25697288688942166,0.255444,0.2408707847014635,149810.0,38218517.39999998,343581.0,35240155.7
2021-03-03,0.31182,0.37,0.30128,0.36388,76500148.46,69600.0,38020475.46,0.31832666666666665,0.27539714285714284,0.2654885,0.3260174423471043,0.2939891238752997,0.25870207092342024,66.73205691567273,0.339533548101957,0.19144345189804302,0.03288933218088386,0.029713501255837833,0.0031758309250460234,0.06872,0.06139714285714286,933746069.3499986,0.06778999999999996,54.225650589132826,-3.1211750305997623,96.87882496940023,85.61137055353846,16.69552947213136,0.27925,0.31607,0.27,0.31185,59353616.5,56574.0,30181511.8,11.674127126230982,62.52946028753241,0.3179011338206952,0.2002198661793049,0.026758635610882264,0.028919543524576326,-0.0021609079136940615,0.04607,0.059308571428571426,857245920.8899986,0.023450000000000026,37.50606287755194,-9.304313519200418,90.69568648079958,69.29686130106961,0.27930666666666665,0.2881548846942086,0.2566814285714286,0.27069216516706623,0.2590605,0.2476307099679908,144175.0,31225118.366666656,336591.0,32987292.528571427
2021-03-04,0.36193,0.37289,0.3151,0.32349,79345108.7,71906.0,38524094.2,0.33307333333333333,0.28938857142857144,0.269084,0.32475372117355217,0.3013643429064748,0.2648723498830945,52.30532786885245,0.34715933970130236,0.19100866029869762,0.03409578297298327,0.030589957599266922,0.0035058253737163467,0.05779000000000001,0.05909785714285714,854400960.6499985,0.04827999999999999,5.271893000097627,-24.8278634970096,75.17213650299041,87.58221598439674,-10.620838283646004,0.31182,0.37,0.30128,0.36388,76500148.46,69600.0,38020475.46,16.69552947213136,66.73205691567273,0.339533548101957,0.19144345189804302,0.03288933218088386,0.029713501255837833,0.0031758309250460234,0.06872,0.06139714285714286,933746069.3499986,0.06778999999999996,54.225650589132826,-3.1211750305997623,96.87882496940023,85.61137055353846,0.31832666666666665,0.3260174423471043,0.27539714285714284,0.2939891238752997,0.2654885,0.25870207092342024,167483.0,33255663.78666665,353848.0,33610851.88
2021-03-05,0.32256,0.4,0.30145,0.3737,108326867.87,98148.0,55054341.57,0.35369,0.3106114285714286,0.27456800000000003,0.3492268605867761,0.3194482571798561,0.27523688798946644,60.531353476821195,0.36549565420347896,0.18364034579652108,0.038657808146588424,0.03220352770873122,0.006454280437857202,0.09855000000000003,0.06275,962727828.5199986,0.14970999999999998,27.856849596277545,-11.633050247699948,88.36694975230004,86.80597040823024,15.85441468253967,0.36193,0.37289,0.3151,0.32349,79345108.7,71906.0,38524094.2,-10.620838283646004,52.30532786885245,0.34715933970130236,0.19100866029869762,0.03409578297298327,0.030589957599266922,0.0035058253737163467,0.05779000000000001,0.05909785714285714,854400960.6499985,0.04827999999999999,5.271893000097627,-24.8278634970096,75.17213650299041,87.58221598439674,0.33307333333333333,0.32475372117355217,0.28938857142857144,0.3013643429064748,0.269084,0.2648723498830945,198080.0,35575360.48666666,387157.0,35796572.96571429
2021-03-06,0.37432,0.4,0.34857,0.3831,51387455.7,50395.0,25050997.9,0.3600966666666667,0.3260128571428571,0.28131649999999997,0.36616343029338805,0.3353611928848921,0.28550956532380295,62.07661701693532,0.38333983484886813,0.1792931651511318,0.04254135712138918,0.03427109359126282,0.00827026353012636,0.05143000000000003,0.06240785714285715,1014115284.2199986,0.15023,32.83633841886269,-7.475230007077151,92.52476999292286,85.35461874940445,2.3455866638170577,0.32256,0.4,0.30145,0.3737,108326867.87,98148.0,55054341.57,15.85441468253967,60.531353476821195,0.36549565420347896,0.18364034579652108,0.038657808146588424,0.03220352770873122,0.006454280437857202,0.09855000000000003,0.06275,962727828.5199986,0.14970999999999998,27.856849596277545,-11.633050247699948,88.36694975230004,86.80597040823024,0.35369,0.3492268605867761,0.3106114285714286,0.3194482571798561,0.27456800000000003,0.27523688798946644,239654.0,43866303.74333332,446038.0,39490853.60428572
2021-03-07,0.3831,0.38799,0.3525,0.37246,34463937.2,43449.0,16661716.5,0.37642,0.3439614285714286,0.2879695,0.36931171514669403,0.34463589466366906,0.2937905591024884,59.666354454092094,0.39567915894721967,0.1802598410527803,0.04425044697775565,0.03626696426856139,0.007983482709194266,0.03549000000000002,0.06164857142857144,979651347.0199986,0.14691,25.792833260157376,-12.181528662420385,87.81847133757962,89.57006369426752,-2.7773427303576046,0.37432,0.4,0.34857,0.3831,51387455.7,50395.0,25050997.9,2.3455866638170577,62.07661701693532,0.38333983484886813,0.1792931651511318,0.04254135712138918,0.03427109359126282,0.00827026353012636,0.05143000000000003,0.06240785714285715,1014115284.2199986,0.15023,32.83633841886269,-7.475230007077151,92.52476999292286,85.35461874940445,0.3600966666666667,0.36616343029338805,0.3260128571428571,0.3353611928848921,0.28131649999999997,0.28550956532380295,220449.0,39543144.55666665,434224.0,35760752.03285714
2021-03-08,0.37298,0.449,0.36826,0.44438,77063876.48,99323.0,40920874.98,0.39998,0.3675514285714286,0.29884900000000003,0.406845857573347,0.36957192099775177,0.3081324106165372,68.96227049566211,0.423208879619383,0.17448912038061706,0.05082240687117384,0.03917805278908388,0.011644354082089962,0.08074000000000003,0.06175357142857144,1056715223.4999986,0.21924,61.46942334944223,-1.6795114148611359,98.32048858513889,92.88790997188046,19.14311759343665,0.3831,0.38799,0.3525,0.37246,34463937.2,43449.0,16661716.5,-2.7773427303576046,59.666354454092094,0.39567915894721967,0.1802598410527803,0.04425044697775565,0.03626696426856139,0.007983482709194266,0.03549000000000002,0.06164857142857144,979651347.0199986,0.14691,25.792833260157376,-12.181528662420385,87.81847133757962,89.57006369426752,0.37642,0.36931171514669403,0.3439614285714286,0.34463589466366906,0.2879695,0.2937905591024884,191992.0,32255685.32333332,431381.0,33579734.504285716
2021-03-09,0.44255,0.485,0.4249,0.42838,75236630.6,103307.0,37135647.52,0.41507333333333335,0.38419857142857144,0.30847100000000005,0.4176129287866735,0.38427394074831384,0.3195845619863908,74.87404162102958,0.4417926398749559,0.1751493601250442,0.05411585229341115,0.04216561268994934,0.01195023960346181,0.06009999999999999,0.058702857142857154,981478592.8999985,0.15309,91.24960935756062,-19.866666666666667,80.13333333333334,88.75743108535062,-3.201898090611234,0.37298,0.449,0.36826,0.44438,77063876.48,99323.0,40920874.98,19.14311759343665,68.96227049566211,0.423208879619383,0.17448912038061706,0.05082240687117384,0.03917805278908388,0.011644354082089962,0.08074000000000003,0.06175357142857144,1056715223.4999986,0.21924,61.46942334944223,-1.6795114148611359,98.32048858513889,92.88790997188046,0.39998,0.406845857573347,0.3675514285714286,0.36957192099775177,0.29884900000000003,0.3081324106165372,193167.0,27544529.793333318,489395.0,34916287.48714285
2021-03-10,0.42873,0.495,0.39342,0.454,72647525.84,95458.0,37604837.64,0.4422533333333334,0.39707285714285717,0.3158065,0.43580646439333676,0.4017054555612354,0.3323860322734012,75.85771416543886,0.4641522818781939,0.1674607181218061,0.05812324284025333,0.04535713872001014,0.01276610412024319,0.10158,0.0610707142857143,1054126118.7399986,0.20718,94.95856057027527,-13.898305084745758,86.10169491525424,88.18517227790885,5.89415249690948,0.44255,0.485,0.4249,0.42838,75236630.6,103307.0,37135647.52,-3.201898090611234,74.87404162102958,0.4417926398749559,0.1751493601250442,0.05411585229341115,0.04216561268994934,0.01195023960346181,0.06009999999999999,0.058702857142857154,981478592.8999985,0.15309,91.24960935756062,-19.866666666666667,80.13333333333334,88.75743108535062,0.41507333333333335,0.4176129287866735,0.38419857142857144,0.38427394074831384,0.30847100000000005,0.3195845619863908,246079.0,31572746.333333317,536128.0,35909735.44714286
2021-03-11,0.45536,0.472,0.413,0.44166,54542949.2,85363.0,26385196.4,0.4413466666666667,0.41395428571428566,0.3232755,0.4387332321966684,0.4116940916709265,0.3427930768187915,74.97746237951043,0.4813565087431858,0.16519449125681418,0.05961617568646588,0.04820894611330129,0.01140722957316459,0.059,0.062365714285714295,999583169.5399985,0.16241,95.81467523830636,-18.08135593220339,81.9186440677966,82.71789077212807,-3.0086085734364,0.42873,0.495,0.39342,0.454,72647525.84,95458.0,37604837.64,5.89415249690948,75.85771416543886,0.4641522818781939,0.1674607181218061,0.05812324284025333,0.04535713872001014,0.01276610412024319,0.10158,0.0610707142857143,1054126118.7399986,0.20718,94.95856057027527,-13.898305084745758,86.10169491525424,88.18517227790885,0.4422533333333334,0.43580646439333676,0.39707285714285717,0.4017054555612354,0.3158065,0.3323860322734012,298088.0,38553786.713333316,561986.0,35850358.61571429
2021-03-12,0.44171,0.54414,0.43144,0.5255,85176414.97,123079.0,43343518.67,0.47372,0.43563999999999997,0.3351305,0.48211661609833417,0.4401455687531949,0.3601937361693828,79.10239516316565,0.5161034568020709,0.15415754319792907,0.06679455696841058,0.05192606828432315,0.014868488684087432,0.11269999999999997,0.06732785714285715,1084759584.5099986,0.21364999999999995,133.4103224660211,-5.756995490765332,94.24300450923467,87.4211144974285,18.969459600190163,0.45536,0.472,0.413,0.44166,54542949.2,85363.0,26385196.4,-3.0086085734364,74.97746237951043,0.4813565087431858,0.16519449125681418,0.05961617568646588,0.04820894611330129,0.01140722957316459,0.059,0.062365714285714295,999583169.5399985,0.16241,95.81467523830636,-18.08135593220339,81.9186440677966,82.71789077212807,0.4413466666666667,0.4387332321966684,0.41395428571428566,0.4116940916709265,0.3232755,0.3427930768187915,284128.0,33708560.51999999,575443.0,34116230.358571425
2021-03-13,0.52568,0.64506,0.5,0.62092,90164384.51,155337.0,45728016.7,0.5293599999999999,0.4696142857142857,0.35137199999999996,0.5515183080491671,0.4853391765648961,0.3850248089151559,80.78779996793216,0.5716321351607971,0.13111186483920279,0.0792693051868184,0.057394715664822196,0.02187458952199621,0.14505999999999997,0.07285428571428572,1174923969.0199986,0.25704000000000005,125.55123687747466,-5.684012243936882,94.31598775606311,90.15921211103148,18.117485922994973,0.44171,0.54414,0.43144,0.5255,85176414.97,123079.0,43343518.67,18.969459600190163,79.10239516316565,0.5161034568020709,0.15415754319792907,0.06679455696841058,0.05192606828432315,0.014868488684087432,0.11269999999999997,0.06732785714285715,1084759584.5099986,0.21364999999999995,133.4103224660211,-5.756995490765332,94.24300450923467,87.4211144974285,0.47372,0.48211661609833417,0.43563999999999997,0.4401455687531949,0.3351305,0.3601937361693828,303900.0,35777850.903333314,600374.0,32443255.65857143
2021-03-14,0.62096,0.755,0.60837,0.68704,102482032.8,205552.0,51371736.8,0.6111533333333333,0.5145542857142857,0.3719635,0.6192791540245836,0.5357643824236721,0.4137881604470458,86.7486977427541,0.6350769085902883,0.10885009140971175,0.0934141443301656,0.06459860139789088,0.028815542932274715,0.14663000000000004,0.07919785714285714,1277406001.8199985,0.36355,178.3566971882343,-13.27577113164424,86.72422886835575,91.76107371121786,10.64158721978872,0.52568,0.64506,0.5,0.62092,90164384.51,155337.0,45728016.7,18.117485922994973,80.78779996793216,0.5716321351607971,0.13111186483920279,0.0792693051868184,0.057394715664822196,0.02187458952199621,0.14505999999999997,0.07285428571428572,1174923969.0199986,0.25704000000000005,125.55123687747466,-5.684012243936882,94.31598775606311,90.15921211103148,0.5293599999999999,0.5515183080491671,0.4696142857142857,0.4853391765648961,0.35137199999999996,0.3850248089151559,363779.0,38485577.25666665,705316.0,35397115.48714285
2021-03-15,0.6873,0.7398,0.57882,0.6461,66671779.2,140324.0,31084522.3,0.6513533333333333,0.5433714285714286,0.393069,0.6326895770122918,0.5633482868177541,0.43591309754732716,80.19490674436598,0.6733628246986731,0.11277517530132691,0.10016586566093427,0.07171205425049956,0.02845381141043471,0.16098,0.08748857142857143,1210734222.6199985,0.27240000000000003,131.36974037600714,-22.45360824742268,77.54639175257732,86.1955361256654,-5.994471118870946,0.62096,0.755,0.60837,0.68704,102482032.8,205552.0,51371736.8,10.64158721978872,86.7486977427541,0.6350769085902883,0.10885009140971175,0.0934141443301656,0.06459860139789088,0.028815542932274715,0.14663000000000004,0.07919785714285714,1277406001.8199985,0.36355,178.3566971882343,-13.27577113164424,86.72422886835575,91.76107371121786,0.6111533333333333,0.6192791540245836,0.5145542857142857,0.5357643824236721,0.3719635,0.4137881604470458,483968.0,46814424.05666665,867419.0,40355689.815714285
2021-03-16,0.64796,0.66636,0.56264,0.61549,64934663.4,125531.0,31222805.7,0.6495433333333333,0.5701014285714285,0.4122,0.6240897885061458,0.5763837151133155,0.453015659685677,75.07432119970932,0.698618707930595,0.12578129206940497,0.10187236111198178,0.07774411562279601,0.024128245489185768,0.10371999999999992,0.09160642857142856,1145799559.2199984,0.23238999999999999,97.36732403399068,-30.748038437803054,69.25196156219695,77.84086072771002,-5.011111797024507,0.6873,0.7398,0.57882,0.6461,66671779.2,140324.0,31084522.3,-5.994471118870946,80.19490674436598,0.6733628246986731,0.11277517530132691,0.10016586566093427,0.07171205425049956,0.02845381141043471,0.16098,0.08748857142857143,1210734222.6199985,0.27240000000000003,131.36974037600714,-22.45360824742268,77.54639175257732,86.1955361256654,0.6513533333333333,0.6326895770122918,0.5433714285714286,0.5633482868177541,0.393069,0.43591309754732716,501213.0,42728091.93333332,908420.0,38950496.57571429
2021-03-17,0.6155,0.68191,0.59246,0.658,45906442.8,101486.0,22933189.4,0.6398633333333333,0.5992442857142858,0.43382250000000006,0.6410448942530729,0.5967877863349866,0.4725379778108506,74.67615276193034,0.7261446833147369,0.14150031668526314,0.10543953149542945,0.08328319879732271,0.02215633269810674,0.08945000000000003,0.09308714285714285,1191706002.0199983,0.28554,80.82884467406839,-21.386837173409763,78.61316282659024,75.13717204712152,6.904955320877332,0.64796,0.66636,0.56264,0.61549,64934663.4,125531.0,31222805.7,-5.011111797024507,75.07432119970932,0.698618707930595,0.12578129206940497,0.10187236111198178,0.07774411562279601,0.024128245489185768,0.10371999999999992,0.09160642857142856,1145799559.2199984,0.23238999999999999,97.36732403399068,-30.748038437803054,69.25196156219695,77.84086072771002,0.6495433333333333,0.6240897885061458,0.5701014285714285,0.5763837151133155,0.4122,0.453015659685677,471407.0,37893021.59999999,930644.0,38105804.88714285
2021-03-18,0.6594,0.66798,0.58149,0.59455,48942130.1,115453.0,23165469.4,0.6226799999999999,0.6210857142857142,0.45229300000000006,0.6177974471265364,0.59622833975124,0.4841581704002934,71.89428451423217,0.7356413946700691,0.1689446053299311,0.10197119454234227,0.08702079794632664,0.01495039659601563,0.08649000000000007,0.09513714285714288,1142763871.9199984,0.15017000000000003,83.79238925469103,-35.37647447910924,64.62352552089075,70.82954996989265,-9.834698210494382,0.6155,0.68191,0.59246,0.658,45906442.8,101486.0,22933189.4,6.904955320877332,74.67615276193034,0.7261446833147369,0.14150031668526314,0.10543953149542945,0.08328319879732271,0.02215633269810674,0.08945000000000003,0.09308714285714285,1191706002.0199983,0.28554,80.82884467406839,-21.386837173409763,78.61316282659024,75.13717204712152,0.6398633333333333,0.6410448942530729,0.5992442857142858,0.5967877863349866,0.43382250000000006,0.4725379778108506,367341.0,28413505.799999982,936672.0,36009855.138571426
2021-03-19,0.59478,0.6512,0.56911,0.6038,53050428.9,111482.0,25545362.0,0.6187833333333334,0.6322714285714286,0.46871850000000004,0.6107987235632681,0.59812125481343,0.49555263036217023,69.90277825831228,0.7469037293384844,0.19053327066151565,0.09882966337348648,0.08938257103175862,0.009447092341727858,0.08209,0.09396142857142856,1195814300.8199985,0.17542000000000002,61.57345464276158,-37.201978200428115,62.79802179957188,68.67823671568429,1.5165271192709957,0.6594,0.66798,0.58149,0.59455,48942130.1,115453.0,23165469.4,-9.834698210494382,71.89428451423217,0.7356413946700691,0.1689446053299311,0.10197119454234227,0.08702079794632664,0.01495039659601563,0.08649000000000007,0.09513714285714288,1142763871.9199984,0.15017000000000003,83.79238925469103,-35.37647447910924,64.62352552089075,70.82954996989265,0.6226799999999999,0.6177974471265364,0.6210857142857142,0.59622833975124,0.45229300000000006,0.4841581704002934,342470.0,25773821.499999985,966762.0,35549894.138571426
2021-03-20,0.60368,0.64069,0.5844,0.58633,37603032.9,90391.0,18431711.5,0.5948933333333334,0.6273299999999999,0.48569400000000007,0.5985643617816341,0.5951734411100725,0.5041980941372016,67.33659768310784,0.7478384046724105,0.2235495953275896,0.09384846757596721,0.09027575034060034,0.003572717235366868,0.05628999999999995,0.09430857142857144,1158211267.9199984,0.13233,53.04881232054295,-41.9055900621118,58.0944099378882,61.838652419450284,-2.8740392260800385,0.59478,0.6512,0.56911,0.6038,53050428.9,111482.0,25545362.0,1.5165271192709957,69.90277825831228,0.7469037293384844,0.19053327066151565,0.09882966337348648,0.08938257103175862,0.009447092341727858,0.08209,0.09396142857142856,1195814300.8199985,0.17542000000000002,61.57345464276158,-37.201978200428115,62.79802179957188,68.67823671568429,0.6187833333333334,0.6107987235632681,0.6322714285714286,0.59812125481343,0.46871850000000004,0.49555263036217023,328421.0,23881340.26666665,955165.0,33007300.32857143
2021-03-21,0.58443,0.65,0.52729,0.64182,50206465.1,105007.0,25846156.5,0.61065,0.62087,0.5038225,0.6201921808908171,0.6068350808325544,0.517304942314611,71.34457510539161,0.7558049032181191,0.2518400967818808,0.09330287579641827,0.09088117543176392,0.0024217003646543472,0.12270999999999999,0.10053857142857144,1208417733.0199983,0.20015999999999995,72.3191752134457,-29.265139370119474,70.73486062988053,63.875764122446874,9.819824444330363,0.60368,0.64069,0.5844,0.58633,37603032.9,90391.0,18431711.5,-2.8740392260800385,67.33659768310784,0.7478384046724105,0.2235495953275896,0.09384846757596721,0.09027575034060034,0.003572717235366868,0.05628999999999995,0.09430857142857144,1158211267.9199984,0.13233,53.04881232054295,-41.9055900621118,58.0944099378882,61.838652419450284,0.5948933333333334,0.5985643617816341,0.6273299999999999,0.5951734411100725,0.48569400000000007,0.5041980941372016,317326.0,22380847.633333314,890219.0,29107828.157142855
2021-03-22,0.63973,0.77939,0.595,0.67196,112597872.1,232031.0,56484774.8,0.6333699999999999,0.6245642857142857,0.521828,0.6460760904454086,0.6231163106244159,0.5320339954275052,69.31262729124236,0.7674355998824136,0.2762204001175863,0.09421646769795206,0.09154823388500155,0.0026682338129505045,0.18439000000000005,0.10794214285714286,1321015605.1199982,0.14646000000000003,51.212925874251766,-27.833769463947977,72.16623053605203,66.99850036794027,5.038062932799772,0.58443,0.65,0.52729,0.64182,50206465.1,105007.0,25846156.5,9.819824444330363,71.34457510539161,0.7558049032181191,0.2518400967818808,0.09330287579641827,0.09088117543176392,0.0024217003646543472,0.12270999999999999,0.10053857142857144,1208417733.0199983,0.20015999999999995,72.3191752134457,-29.265139370119474,70.73486062988053,63.875764122446874,0.61065,0.6201921808908171,0.62087,0.6068350808325544,0.5038225,0.517304942314611,306880.0,23274409.999999985,789674.0,25461316.685714286
2021-03-23,0.67203,0.71524,0.59638,0.62812,56920141.2,119690.0,27592270.9,0.6473,0.6263685714285714,0.53504,0.6370980452227043,0.6243672329683119,0.5411850434820286,66.18533644496304,0.773188106062283,0.29689189393771687,0.09036134491199765,0.09131085609040077,-0.0009495111784031118,0.11885999999999997,0.1121392857142857,1264095463.9199982,0.007199999999999984,46.626826649236676,-39.19216519418608,60.80783480581392,67.9029753239155,-6.533934496971862,0.63973,0.77939,0.595,0.67196,112597872.1,232031.0,56484774.8,5.038062932799772,69.31262729124236,0.7674355998824136,0.2762204001175863,0.09421646769795206,0.09154823388500155,0.0026682338129505045,0.18439000000000005,0.10794214285714286,1321015605.1199982,0.14646000000000003,51.212925874251766,-27.833769463947977,72.16623053605203,66.99850036794027,0.6333699999999999,0.6460760904454086,0.6245642857142857,0.6231163106244159,0.521828,0.5320339954275052,427429.0,33587547.59999999,881381.0,29089924.185714286
2021-03-24,0.62991,0.73,0.58388,0.61858,46760082.9,120020.0,22360600.9,0.6395533333333333,0.6207371428571429,0.5497945000000001,0.6278390226113522,0.6229204247262339,0.5485559917218353,63.6930910543131,0.7685303876987684,0.33105861230123174,0.0855501650094751,0.09015871787421564,-0.004608552864740545,0.14612000000000003,0.11532071428571429,1217335381.019998,-0.06845999999999997,36.25110132158591,-43.89039002156172,56.10960997843828,63.02789177343475,-1.7986696512200078,0.67203,0.71524,0.59638,0.62812,56920141.2,119690.0,27592270.9,-6.533934496971862,66.18533644496304,0.773188106062283,0.29689189393771687,0.09036134491199765,0.09131085609040077,-0.0009495111784031118,0.11885999999999997,0.1121392857142857,1264095463.9199982,0.007199999999999984,46.626826649236676,-39.19216519418608,60.80783480581392,67.9029753239155,0.6473,0.6370980452227043,0.6263685714285714,0.6243672329683119,0.53504,0.5411850434820286,456728.0,36641067.39999998,875540.0,28571276.35714286
2021-03-25,0.61994,0.64355,0.55746,0.60863,42943400.4,85154.0,21160489.9,0.6184433333333333,0.6227485714285714,0.561541,0.6182345113056761,0.6193478185446755,0.5542773258435653,63.94740798904055,0.7651703503712844,0.35791164962871547,0.08001205921679233,0.088129386142731,-0.008117326925938667,0.08609,0.11725571428571428,1174391980.619998,-0.03747,37.80509894488973,-49.07601666906165,50.92398333093835,55.94714270506353,-1.8243701003322967,0.62991,0.73,0.58388,0.61858,46760082.9,120020.0,22360600.9,-1.7986696512200078,63.6930910543131,0.7685303876987684,0.33105861230123174,0.0855501650094751,0.09015871787421564,-0.004608552864740545,0.14612000000000003,0.11532071428571429,1217335381.019998,-0.06845999999999997,36.25110132158591,-43.89039002156172,56.10960997843828,63.02789177343475,0.6395533333333333,0.6278390226113522,0.6207371428571429,0.6229204247262339,0.5497945000000001,0.5485559917218353,471741.0,35479215.53333332,894074.0,28489478.0
2021-03-26,0.60661,0.74,0.60301,0.69757,48742885.3,110639.0,25673697.9,0.6415933333333333,0.6361442857142857,0.5772645,0.657902255652838,0.6389033639085067,0.5679242471917971,64.25199198237448,0.7712131979888719,0.38331580201112797,0.08185619787817433,0.08687474848981967,-0.005018550611645342,0.13698999999999995,0.11899071428571428,1223134865.919998,0.08208000000000004,32.74405328258803,-29.285228533591035,70.71477146640896,59.24945492526188,14.99480720726662,0.61994,0.64355,0.55746,0.60863,42943400.4,85154.0,21160489.9,-1.8243701003322967,63.94740798904055,0.7651703503712844,0.35791164962871547,0.08001205921679233,0.088129386142731,-0.008117326925938667,0.08609,0.11725571428571428,1174391980.619998,-0.03747,37.80509894488973,-49.07601666906165,50.92398333093835,55.94714270506353,0.6184433333333333,0.6182345113056761,0.6227485714285714,0.6193478185446755,0.561541,0.5542773258435653,324864.0,23704453.899999987,863775.0,28203052.35714286
2021-03-27,0.70033,0.81736,0.66665,0.78885,57976438.9,119107.0,29949113.3,0.69835,0.6650757142857142,0.598084,0.723376127826419,0.67639002293138,0.5889647950782927,64.0051373575968,0.7888337516753565,0.4073342483246433,0.0896497971384802,0.08742975821955178,0.002220038918928427,0.15071,0.11939428571428572,1281111304.819998,0.13085000000000002,27.045352058236173,-9.828662047092058,90.17133795290793,70.6033642500851,12.639755543815065,0.60661,0.74,0.60301,0.69757,48742885.3,110639.0,25673697.9,14.99480720726662,64.25199198237448,0.7712131979888719,0.38331580201112797,0.08185619787817433,0.08687474848981967,-0.005018550611645342,0.13698999999999995,0.11899071428571428,1223134865.919998,0.08208000000000004,32.74405328258803,-29.285228533591035,70.71477146640896,59.24945492526188,0.6415933333333333,0.657902255652838,0.6361442857142857,0.6389033639085067,0.5772645,0.5679242471917971,315813.0,23064929.56666665,862932.0,28221386.057142854
2021-03-28,0.7889,0.865,0.75,0.77916,66572003.1,147040.0,31796750.17,0.7551933333333333,0.6846957142857143,0.614823,0.7512680639132094,0.702082517198535,0.6070786241184554,58.48094273614435,0.8075271297020128,0.4221188702979872,0.09396125186221294,0.08873605694808401,0.005225194914128928,0.11499999999999999,0.11713499999999999,1214539301.7199981,0.18460999999999994,13.408244061481135,-25.418258268928973,74.58174173107103,78.48928371679598,-1.2346304981620082,0.70033,0.81736,0.66665,0.78885,57976438.9,119107.0,29949113.3,12.639755543815065,64.0051373575968,0.7888337516753565,0.4073342483246433,0.0896497971384802,0.08742975821955178,0.002220038918928427,0.15071,0.11939428571428572,1281111304.819998,0.13085000000000002,27.045352058236173,-9.828662047092058,90.17133795290793,70.6033642500851,0.69835,0.723376127826419,0.6650757142857142,0.67639002293138,0.598084,0.5889647950782927,314900.0,25594433.699999984,891648.0,29866729.17142857
2021-03-29,0.77915,0.8475,0.751,0.82,44625550.4,109884.0,21748018.8,0.7960033333333333,0.7058442857142858,0.6344040000000001,0.7856340319566046,0.7315618878989012,0.6273568503928882,66.01289134438305,0.8269268546815584,0.4418811453184418,0.09952628047069623,0.09089410165260646,0.008632178818089767,0.09650000000000003,0.11252928571428573,1259164852.1199982,0.21619999999999995,26.915338182943806,-13.325042195966969,86.67495780403304,83.80934582933735,5.242892896104722,0.7889,0.865,0.75,0.77916,66572003.1,147040.0,31796750.17,-1.2346304981620082,58.48094273614435,0.8075271297020128,0.4221188702979872,0.09396125186221294,0.08873605694808401,0.005225194914128928,0.11499999999999999,0.11713499999999999,1214539301.7199981,0.18460999999999994,13.408244061481135,-25.418258268928973,74.58174173107103,78.48928371679598,0.7551933333333333,0.7512680639132094,0.6846957142857143,0.702082517198535,0.614823,0.6070786241184554,376786.0,29139853.789999988,933681.0,30716813.98142857
2021-03-30,0.81991,0.84,0.76611,0.80995,45797845.0,107037.0,22450477.1,0.8030366666666665,0.73182,0.6522015,0.7977920159783023,0.7511589159241758,0.6447466741649941,68.61074955975805,0.840263505595018,0.46413949440498203,0.10195043359163669,0.09310536804041251,0.008845065551224177,0.07389000000000001,0.11039857142857144,1213367007.1199982,0.22361999999999993,31.594339469365874,-16.300968286399588,83.69903171360042,81.65191041623486,-1.214767474478916,0.77915,0.8475,0.751,0.82,44625550.4,109884.0,21748018.8,5.242892896104722,66.01289134438305,0.8269268546815584,0.4418811453184418,0.09952628047069623,0.09089410165260646,0.008632178818089767,0.09650000000000003,0.11252928571428573,1259164852.1199982,0.21619999999999995,26.915338182943806,-13.325042195966969,86.67495780403304,83.80934582933735,0.7960033333333333,0.7856340319566046,0.7058442857142858,0.7315618878989012,0.6344040000000001,0.6273568503928882,376031.0,27831294.089999985,811534.0,25754420.267142855
2021-03-31,0.80701,0.87871,0.71776,0.72674,84830667.6,204039.0,40995585.6,0.7855633333333332,0.7472714285714286,0.6664555,0.7622660079891512,0.7450541869431319,0.6525555623397565,56.10327804808752,0.828780381962717,0.504130618037283,0.09605003579645754,0.09369430159162152,0.0023557342048360214,0.16095000000000004,0.1155057142857143,1128536339.5199983,0.0849200000000001,10.446808510638306,-43.24455068009787,56.75544931990212,75.7098129458452,-9.94659297902132,0.81991,0.84,0.76611,0.80995,45797845.0,107037.0,22450477.1,-1.214767474478916,68.61074955975805,0.840263505595018,0.46413949440498203,0.10195043359163669,0.09310536804041251,0.008845065551224177,0.07389000000000001,0.11039857142857144,1213367007.1199982,0.22361999999999993,31.594339469365874,-16.300968286399588,83.69903171360042,81.65191041623486,0.8030366666666665,0.7977920159783023,0.73182,0.7511589159241758,0.6522015,0.6447466741649941,363961.0,25331748.689999986,798881.0,25019878.295714285
2021-04-01,0.72681,0.76329,0.68312,0.70796,53147751.3,128150.0,25540933.0,0.7482166666666666,0.7614614285714286,0.6755785000000001,0.7351130039945757,0.7357806402073489,0.6578321754502559,60.93698767527533,0.824503831099707,0.5266531689002931,0.08883451005041743,0.0927223432833807,-0.003887833232963281,0.08017000000000007,0.11505428571428573,1075388588.2199984,0.03600000000000003,19.074930619796483,-48.588583461385234,51.41141653861477,63.955299190705794,-2.5935251303641835,0.80701,0.87871,0.71776,0.72674,84830667.6,204039.0,40995585.6,-9.94659297902132,56.10327804808752,0.828780381962717,0.504130618037283,0.09605003579645754,0.09369430159162152,0.0023557342048360214,0.16095000000000004,0.1155057142857143,1128536339.5199983,0.0849200000000001,10.446808510638306,-43.24455068009787,56.75544931990212,75.7098129458452,0.7855633333333332,0.7622660079891512,0.7472714285714286,0.7450541869431319,0.6664555,0.6525555623397565,420960.0,28398027.166666657,882900.0,27682018.967142858
2021-04-02,0.70801,0.75662,0.68325,0.69364,37347872.0,94032.0,17892559.2,0.7094466666666667,0.7609,0.6792144999999999,0.7143765019972879,0.7252454801555117,0.6612424444549934,58.58005118997594,0.8260573009417569,0.532371699058243,0.081026625092119,0.09038319964512836,-0.009356574553009367,0.07336999999999994,0.11443142857142856,1038040716.2199984,0.06552000000000002,14.87909903941702,-52.663479597063336,47.336520402936664,51.8344620871512,-2.029632349825566,0.72681,0.76329,0.68312,0.70796,53147751.3,128150.0,25540933.0,-2.5935251303641835,60.93698767527533,0.824503831099707,0.5266531689002931,0.08883451005041743,0.0927223432833807,-0.003887833232963281,0.08017000000000007,0.11505428571428573,1075388588.2199984,0.03600000000000003,19.074930619796483,-48.588583461385234,51.41141653861477,63.955299190705794,0.7482166666666666,0.7351130039945757,0.7614614285714286,0.7357806402073489,0.6755785000000001,0.6578321754502559,439226.0,29662331.899999987,925896.0,28307796.552857142
2021-04-03,0.69351,0.72,0.6313,0.63403,40445261.8,90346.0,18818423.8,0.6785433333333334,0.7387828571428571,0.676564,0.674203250998644,0.7024416101166338,0.6586507830783274,54.21616461603733,0.8247198471624407,0.5284081528375594,0.06923074228898363,0.08615270817389942,-0.01692196588491579,0.0887,0.11674642857142857,997595454.4199984,0.015449999999999964,8.135350399945418,-69.6260884411815,30.373911558818495,43.040616166789995,-8.576660754711538,0.70801,0.75662,0.68325,0.69364,37347872.0,94032.0,17892559.2,-2.029632349825566,58.58005118997594,0.8260573009417569,0.532371699058243,0.081026625092119,0.09038319964512836,-0.009356574553009367,0.07336999999999994,0.11443142857142856,1038040716.2199984,0.06552000000000002,14.87909903941702,-52.663479597063336,47.336520402936664,51.8344620871512,0.7094466666666667,0.7143765019972879,0.7609,0.7252454801555117,0.6792144999999999,0.6612424444549934,426221.0,28143025.93333332,909289.0,27196205.310000002
2021-04-04,0.63277,0.74,0.61143,0.72304,42784169.7,99611.0,22224336.2,0.68357,0.7307657142857142,0.680411,0.698621625499322,0.7075912075874753,0.66478308945182,56.77736982643525,0.829230361770887,0.5315916382291129,0.06630051226044176,0.08218226899120788,-0.015881756730766125,0.12856999999999996,0.11716499999999999,1040379624.1199985,0.11441000000000001,12.654638372129279,-48.457587548638124,51.54241245136188,43.08428147103903,14.265846990217607,0.69351,0.72,0.6313,0.63403,40445261.8,90346.0,18818423.8,-8.576660754711538,54.21616461603733,0.8247198471624407,0.5284081528375594,0.06923074228898363,0.08615270817389942,-0.01692196588491579,0.0887,0.11674642857142857,997595454.4199984,0.015449999999999964,8.135350399945418,-69.6260884411815,30.373911558818495,43.040616166789995,0.6785433333333334,0.674203250998644,0.7387828571428571,0.7024416101166338,0.676564,0.6586507830783274,312528.0,20750638.666666653,880528.0,25606106.810000002
2021-04-05,0.723,0.7296,0.66,0.68135,40056829.9,92153.0,19435149.5,0.6794733333333333,0.7109585714285714,0.683704,0.689985812749661,0.7010309056906066,0.6663608904564086,50.7687269750307,0.8293556970685435,0.5380523029314564,0.05992348859408625,0.07773051291178357,-0.017807024317697318,0.0696,0.10896571428571429,1000322794.2199985,-0.016220000000000012,1.3974046074171076,-61.435019455252906,38.564980544747094,40.1604348516425,-5.760719225449511,0.63277,0.74,0.61143,0.72304,42784169.7,99611.0,22224336.2,14.265846990217607,56.77736982643525,0.829230361770887,0.5315916382291129,0.06630051226044176,0.08218226899120788,-0.015881756730766125,0.12856999999999996,0.11716499999999999,1040379624.1199985,0.11441000000000001,12.654638372129279,-48.457587548638124,51.54241245136188,43.08428147103903,0.68357,0.698621625499322,0.7307657142857142,0.7075912075874753,0.680411,0.66478308945182,283989.0,19645106.399999987,833099.0,24238619.099999998
2021-04-06,0.6819,0.7475,0.63473,0.66701,64837832.6,143064.0,30967746.5,0.6904666666666666,0.6905385714285714,0.6841545,0.6784979063748304,0.6925256792679549,0.666422710412941,53.34537634408602,0.8295269183605659,0.5387820816394341,0.053100424598006124,0.07280449524902809,-0.019704070651021963,0.11277000000000004,0.10853071428571429,935484961.6199985,-0.12184000000000006,6.191492071578675,-65.8988326848249,34.101167315175104,41.402853437094706,-2.1836046341105675,0.723,0.7296,0.66,0.68135,40056829.9,92153.0,19435149.5,-5.760719225449511,50.7687269750307,0.8293556970685435,0.5380523029314564,0.05992348859408625,0.07773051291178357,-0.017807024317697318,0.0696,0.10896571428571429,1000322794.2199985,-0.016220000000000012,1.3974046074171076,-61.435019455252906,38.564980544747094,40.1604348516425,0.6794733333333333,0.689985812749661,0.7109585714285714,0.7010309056906066,0.683704,0.6663608904564086,282110.0,20159303.166666653,815368.0,23908209.2
2021-04-07,0.66706,0.6816,0.5555,0.59566,54135169.3,102560.0,26206281.3,0.6480066666666666,0.6718128571428571,0.68421,0.6370789531874153,0.6683092594509662,0.6596834046593275,48.21789568625011,0.8294391572870792,0.5389808427129208,0.04145784825238208,0.06653516584969889,-0.02507731759731681,0.1261,0.1071007142857143,881349792.3199985,-0.1835,-3.705260435190283,-87.57464187370441,12.42535812629559,28.363835328739274,-10.70368482595269,0.6819,0.7475,0.63473,0.66701,64837832.6,143064.0,30967746.5,-2.1836046341105675,53.34537634408602,0.8295269183605659,0.5387820816394341,0.053100424598006124,0.07280449524902809,-0.019704070651021963,0.11277000000000004,0.10853071428571429,935484961.6199985,-0.12184000000000006,6.191492071578675,-65.8988326848249,34.101167315175104,41.402853437094706,0.6904666666666666,0.6784979063748304,0.6905385714285714,0.6925256792679549,0.6841545,0.666422710412941,334828.0,24209077.399999987,851395.0,25124961.971428573
2021-04-08,0.59557,0.65678,0.5868,0.6066,35094330.1,73039.0,17264301.9,0.62309,0.6573328571428572,0.68435,0.6218394765937076,0.6528819445882246,0.6546278423108202,49.84240354009783,0.8292578223161898,0.5394421776838102,0.03273642406988597,0.05977541749373631,-0.02703899342385034,0.06998000000000004,0.10595,916444122.4199985,-0.21339999999999992,-0.33353597423722015,-84.1898456112125,15.810154388787486,20.77889327675274,1.852007320717965,0.66706,0.6816,0.5555,0.59566,54135169.3,102560.0,26206281.3,-10.70368482595269,48.21789568625011,0.8294391572870792,0.5389808427129208,0.04145784825238208,0.06653516584969889,-0.02507731759731681,0.1261,0.1071007142857143,881349792.3199985,-0.1835,-3.705260435190283,-87.57464187370441,12.42535812629559,28.363835328739274,0.6480066666666666,0.6370789531874153,0.6718128571428571,0.6683092594509662,0.68421,0.6596834046593275,337777.0,25536392.43333332,749916.0,23012204.214285713
2021-04-09,0.60665,0.7692,0.6009,0.68365,137422710.3,207897.0,72525853.2,0.6286366666666666,0.6559057142857142,0.6892159999999999,0.6527447382968539,0.6605739584411684,0.6573918573288373,48.899012908124526,0.8266058227135566,0.5518261772864432,0.031676773510153744,0.0541556886970198,-0.02247891518686606,0.1683,0.10818642857142859,1053866832.7199986,-0.12629999999999997,-1.9954986596327329,-60.35085548095665,39.64914451904335,22.62821901137549,12.692656391659105,0.59557,0.65678,0.5868,0.6066,35094330.1,73039.0,17264301.9,1.852007320717965,49.84240354009783,0.8292578223161898,0.5394421776838102,0.03273642406988597,0.05977541749373631,-0.02703899342385034,0.06998000000000004,0.10595,916444122.4199985,-0.21339999999999992,-0.33353597423722015,-84.1898456112125,15.810154388787486,20.77889327675274,0.62309,0.6218394765937076,0.6573328571428572,0.6528819445882246,0.68435,0.6546278423108202,318663.0,24812776.56666665,694805.0,21829828.34285714
2021-04-10,0.68211,0.7,0.63076,0.65528,49609062.7,87858.0,23204865.3,0.6485099999999999,0.6589414285714286,0.689889,0.654012369148427,0.6592504688308762,0.6571907280594242,38.26789635485287,0.8264305215660728,0.5533474784339272,0.02822244018261244,0.048969038994138334,-0.020746598811525893,0.06923999999999997,0.10236714285714285,1004257770.0199986,-0.07146000000000008,-16.932243138746284,-69.12843043222672,30.871569567773268,28.776956158534713,-3.9333831786662006,0.60665,0.7692,0.6009,0.68365,137422710.3,207897.0,72525853.2,12.692656391659105,48.899012908124526,0.8266058227135566,0.5518261772864432,0.031676773510153744,0.0541556886970198,-0.02247891518686606,0.1683,0.10818642857142859,1053866832.7199986,-0.12629999999999997,-1.9954986596327329,-60.35085548095665,39.64914451904335,22.62821901137549,0.6286366666666666,0.6527447382968539,0.6559057142857142,0.6605739584411684,0.6892159999999999,0.6573918573288373,383496.0,38665478.79999998,808670.0,29634584.62857143
2021-04-11,0.65572,0.65771,0.61539,0.63278,37097171.8,67930.0,17847806.4,0.6572366666666666,0.6460471428571429,0.6879299999999999,0.6433961845742135,0.6526328516231572,0.6548658968156695,37.42569494553827,0.8266612995458616,0.5491987004541382,0.02339955862761456,0.04385514292083358,-0.020455584293219024,0.042320000000000024,0.0971757142857143,967160598.2199986,-0.07518000000000002,-18.78689871143282,-76.0898487051762,23.9101512948238,31.476955127213486,-3.4984444580003604,0.68211,0.7,0.63076,0.65528,49609062.7,87858.0,23204865.3,-3.9333831786662006,38.26789635485287,0.8264305215660728,0.5533474784339272,0.02822244018261244,0.048969038994138334,-0.020746598811525893,0.06923999999999997,0.10236714285714285,1004257770.0199986,-0.07146000000000008,-16.932243138746284,-69.12843043222672,30.871569567773268,28.776956158534713,0.6485099999999999,0.654012369148427,0.6589414285714286,0.6592504688308762,0.689889,0.6571907280594242,368794.0,37665006.79999998,806182.0,30261219.12857143
2021-04-12,0.63142,0.67,0.59999,0.60938,45074512.1,82157.0,21795854.2,0.63248,0.6357657142857143,0.686993,0.6263880922871068,0.6418196387173679,0.6505339066427486,31.348517587049713,0.8276647575515106,0.5463212424484893,0.017487619419253142,0.038581638220517495,-0.021094018801264353,0.07001000000000002,0.09528357142857143,922086086.1199986,-0.08426,-25.685365853658524,-83.32972370904365,16.670276290956355,23.817332384517822,-3.49054512052199,0.65572,0.65771,0.61539,0.63278,37097171.8,67930.0,17847806.4,-3.4984444580003604,37.42569494553827,0.8266612995458616,0.5491987004541382,0.02339955862761456,0.04385514292083358,-0.020455584293219024,0.042320000000000024,0.0971757142857143,967160598.2199986,-0.07518000000000002,-18.78689871143282,-76.0898487051762,23.9101512948238,31.476955127213486,0.6572366666666666,0.6433961845742135,0.6460471428571429,0.6526328516231572,0.6879299999999999,0.6548658968156695,363685.0,37859508.29999998,774501.0,29636000.585714284
2021-04-13,0.609,0.64394,0.57118,0.60803,43340953.1,80793.0,21423260.5,0.61673,0.62734,0.6864655,0.6172090461435533,0.6333722290380259,0.6464859155339153,31.83911354151678,0.8282918079262778,0.5446391920737221,0.012548776798237737,0.03337506593606154,-0.020826289137823806,0.07275999999999994,0.09520285714285714,878745133.0199986,-0.026000000000000023,-24.929933946539904,-83.74740880542063,16.252591194579367,18.94433959345319,-0.15927750410509464,0.63142,0.67,0.59999,0.60938,45074512.1,82157.0,21795854.2,-3.49054512052199,31.348517587049713,0.8276647575515106,0.5463212424484893,0.017487619419253142,0.038581638220517495,-0.021094018801264353,0.07001000000000002,0.09528357142857143,922086086.1199986,-0.08426,-25.685365853658524,-83.32972370904365,16.670276290956355,23.817332384517822,0.63248,0.6263880922871068,0.6357657142857143,0.6418196387173679,0.686993,0.6505339066427486,237945.0,20949508.633333318,764505.0,29973244.114285715
2021-04-14,0.60717,0.61782,0.57081,0.59596,39281475.0,67768.0,19191912.9,0.6044566666666666,0.6273828571428571,0.685832,0.6065845230717767,0.6240191717785195,0.6416739235783043,36.511407236272134,0.8292266976337448,0.5424373023662552,0.007573458200026417,0.028214744388854518,-0.0206412861888281,0.047009999999999996,0.08706428571428572,839463658.0199986,-0.12707999999999997,-17.99543165368632,-81.0669162377164,18.933083762283598,17.285317082606454,-1.846270402029076,0.609,0.64394,0.57118,0.60803,43340953.1,80793.0,21423260.5,-0.15927750410509464,31.83911354151678,0.8282918079262778,0.5446391920737221,0.012548776798237737,0.03337506593606154,-0.020826289137823806,0.07275999999999994,0.09520285714285714,878745133.0199986,-0.026000000000000023,-24.929933946539904,-83.74740880542063,16.252591194579367,18.94433959345319,0.61673,0.6172090461435533,0.62734,0.6333722290380259,0.6864655,0.6464859155339153,230880.0,20355640.36666665,702234.0,28609746.114285715
2021-04-15,0.59605,0.66328,0.58426,0.6501,49436681.7,88837.0,25487718.7,0.61803,0.6335971428571429,0.6834585000000001,0.6283422615358883,0.6305393788338897,0.6424764070470372,44.43803591340792,0.8276046333471931,0.539312366652807,0.007907969746156818,0.024153389460314978,-0.01624541971415816,0.07901999999999998,0.08698214285714286,888900339.7199986,-0.03125,-8.1727781230578,-55.7323350491343,44.26766495086571,26.484446635909574,9.068031205435794,0.60717,0.61782,0.57081,0.59596,39281475.0,67768.0,19191912.9,-1.846270402029076,36.511407236272134,0.8292266976337448,0.5424373023662552,0.007573458200026417,0.028214744388854518,-0.0206412861888281,0.047009999999999996,0.08706428571428572,839463658.0199986,-0.12707999999999997,-17.99543165368632,-81.0669162377164,18.933083762283598,17.285317082606454,0.6044566666666666,0.6065845230717767,0.6273828571428571,0.6240191717785195,0.685832,0.6416739235783043,230718.0,20803675.866666652,667442.0,27607693.485714283
2021-04-16,0.65007,0.66109,0.5887,0.60559,41679060.1,80521.0,20640072.2,0.6172166666666666,0.6224457142857143,0.6742955,0.6169661307679442,0.6243020341254172,0.6389634158997004,42.00025439281885,0.8134455027384286,0.5351454972615715,0.0045292768578412135,0.020228566939820225,-0.01569929008197901,0.07238999999999995,0.08691214285714285,847221279.6199986,-0.06142000000000003,-12.693904619110786,-76.56059897051944,23.439401029480564,28.880049914209973,-6.842340055686321,0.59605,0.66328,0.58426,0.6501,49436681.7,88837.0,25487718.7,9.068031205435794,44.43803591340792,0.8276046333471931,0.539312366652807,0.007907969746156818,0.024153389460314978,-0.01624541971415816,0.07901999999999998,0.08698214285714286,888900339.7199986,-0.03125,-8.1727781230578,-55.7323350491343,44.26766495086571,26.484446635909574,0.61803,0.6283422615358883,0.6335971428571429,0.6305393788338897,0.6834585000000001,0.6424764070470372,237398.0,22034297.36666665,683240.0,28782467.314285718
2021-04-17,0.60519,0.69,0.60519,0.63834,48114491.2,93958.0,25321655.7,0.6313433333333333,0.6200257142857143,0.6672545,0.627653065383972,0.6278115255940628,0.6389040429568718,50.41167593176305,0.7980638482052951,0.5364451517947049,0.0044430727218920385,0.017071468096234586,-0.012628395374342547,0.08480999999999994,0.08663428571428569,895335770.8199986,0.04268000000000005,0.6797785593741779,-61.23537669630321,38.76462330369678,35.49056309468103,5.477618599117635,0.65007,0.66109,0.5887,0.60559,41679060.1,80521.0,20640072.2,-6.842340055686321,42.00025439281885,0.8134455027384286,0.5351454972615715,0.0045292768578412135,0.020228566939820225,-0.01569929008197901,0.07238999999999995,0.08691214285714285,847221279.6199986,-0.06142000000000003,-12.693904619110786,-76.56059897051944,23.439401029480564,28.880049914209973,0.6172166666666666,0.6169661307679442,0.6224457142857143,0.6243020341254172,0.6742955,0.6389634158997004,237126.0,21773234.599999983,555864.0,21370212.885714285
2021-04-18,0.63834,0.64607,0.46754,0.54358,48187615.2,71661.0,22988108.9,0.5958366666666666,0.6072828571428571,0.6534335,0.585616532691986,0.6067536441955471,0.6298255626752649,33.04485847095725,0.7743261882600279,0.5325408117399721,-0.0032343017176338362,0.013010314133460902,-0.01624461585109474,0.17853000000000002,0.09020285714285714,847148155.6199986,-0.06302000000000008,-24.82020358486392,-74.79281310084203,25.207186899157975,29.137070410778453,-14.84475357959709,0.60519,0.69,0.60519,0.63834,48114491.2,93958.0,25321655.7,5.477618599117635,50.41167593176305,0.7980638482052951,0.5364451517947049,0.0044430727218920385,0.017071468096234586,-0.012628395374342547,0.08480999999999994,0.08663428571428569,895335770.8199986,0.04268000000000005,0.6797785593741779,-61.23537669630321,38.76462330369678,35.49056309468103,0.6313433333333333,0.627653065383972,0.6200257142857143,0.6278115255940628,0.6672545,0.6389040429568718,263316.0,23816482.199999984,561964.0,21672611.514285713
2021-04-19,0.54325,0.578,0.4621,0.47802,46085537.0,65366.0,22559422.1,0.5533133333333333,0.5885171428571428,0.6368370000000001,0.5318182663459929,0.5745702331466603,0.6153678900395254,31.61872389665335,0.7583927527011219,0.5152812472988783,-0.014442338082303663,0.007519783690307989,-0.021962121772611653,0.11589999999999995,0.09350999999999998,801062618.6199986,-0.20562999999999998,-29.842224994496224,-94.81602084011723,5.183979159882771,23.051929787579187,-12.007363092498851,0.63834,0.64607,0.46754,0.54358,48187615.2,71661.0,22988108.9,-14.84475357959709,33.04485847095725,0.7743261882600279,0.5325408117399721,-0.0032343017176338362,0.013010314133460902,-0.01624461585109474,0.17853000000000002,0.09020285714285714,847148155.6199986,-0.06302000000000008,-24.82020358486392,-74.79281310084203,25.207186899157975,29.137070410778453,0.5958366666666666,0.585616532691986,0.6072828571428571,0.6067536441955471,0.6534335,0.6298255626752649,246140.0,22983278.93333332,565695.0,22406940.442857143
2021-04-20,0.47842,0.54847,0.4111,0.53494,57790593.6,75542.0,29849435.5,0.5188466666666666,0.5780757142857142,0.6272469999999999,0.5333791331729965,0.5646626748599952,0.607708090988142,38.914163882686715,0.7492013849322768,0.5052926150677229,-0.018518351324340654,0.0023121566873782603,-0.020830508011718915,0.13737,0.09526714285714284,858853212.2199986,-0.12034,-19.800302844035322,-65.41748115051664,34.58251884948337,21.657894969508053,11.813887379290154,0.54325,0.578,0.4621,0.47802,46085537.0,65366.0,22559422.1,-12.007363092498851,31.61872389665335,0.7583927527011219,0.5152812472988783,-0.014442338082303663,0.007519783690307989,-0.021962121772611653,0.11589999999999995,0.09350999999999998,801062618.6199986,-0.20562999999999998,-29.842224994496224,-94.81602084011723,5.183979159882771,23.051929787579187,0.5533133333333333,0.5318182663459929,0.5885171428571428,0.5745702331466603,0.6368370000000001,0.6153678900395254,230985.0,23623062.23333332,548904.0,22516021.57142857
2021-04-21,0.53456,0.5644,0.46561,0.46711,43596510.3,56687.0,21669930.2,0.49335666666666667,0.5596685714285714,0.6152044999999999,0.5002445665864983,0.5402745061449964,0.594317796608319,39.145486785442884,0.7504430621547481,0.47996593784525177,-0.026911713820815808,-0.003532617414260553,-0.023379096406555257,0.09878999999999999,0.09331642857142855,815256701.9199986,-0.16566999999999998,-21.58110331397105,-84.359117564926,15.640882435074005,18.469126814813396,-12.617853935947323,0.47842,0.54847,0.4111,0.53494,57790593.6,75542.0,29849435.5,11.813887379290154,38.914163882686715,0.7492013849322768,0.5052926150677229,-0.018518351324340654,0.0023121566873782603,-0.020830508011718915,0.13737,0.09526714285714284,858853212.2199986,-0.12034,-19.800302844035322,-65.41748115051664,34.58251884948337,21.657894969508053,0.5188466666666666,0.5333791331729965,0.5780757142857142,0.5646626748599952,0.6272469999999999,0.607708090988142,212569.0,25132322.166666653,543653.0,23719760.85714286
2021-04-22,0.46607,0.49403,0.39534,0.40685,50840826.8,62028.0,24789528.4,0.46963333333333335,0.5249185714285715,0.600865,0.4535472832932491,0.5069183796087473,0.57646372074086,34.430292920947196,0.7598234660085426,0.44190653399145746,-0.03798808940841536,-0.010423711813091515,-0.027564377595323847,0.09869,0.09536714285714284,764415875.1199987,-0.20253000000000004,-32.92944279591165,-96.92130744128819,3.078692558711808,17.767364614423077,-12.706245842899136,0.53456,0.5644,0.46561,0.46711,43596510.3,56687.0,21669930.2,-12.617853935947323,39.145486785442884,0.7504430621547481,0.47996593784525177,-0.026911713820815808,-0.003532617414260553,-0.023379096406555257,0.09878999999999999,0.09331642857142855,815256701.9199986,-0.16566999999999998,-21.58110331397105,-84.359117564926,15.640882435074005,18.469126814813396,0.49335666666666667,0.5002445665864983,0.5596685714285714,0.5402745061449964,0.6152044999999999,0.594317796608319,197595.0,24692929.26666665,532572.0,24073763.32857143
2021-04-23,0.40722,0.4186,0.33953,0.41488,52855716.9,54646.0,26121925.7,0.42961333333333335,0.4976742857142857,0.5899075,0.43421364164662457,0.4839087847065605,0.5610747949560163,26.524587300200892,0.7682691597785154,0.41154584022148466,-0.04559267894960117,-0.017457505240393446,-0.028135173709207727,0.07907000000000003,0.08899357142857141,817271592.0199987,-0.19314999999999993,-39.313976449937826,-79.09673481843149,20.903265181568518,13.20761339178479,1.881047099847748,0.46607,0.49403,0.39534,0.40685,50840826.8,62028.0,24789528.4,-12.706245842899136,34.430292920947196,0.7598234660085426,0.44190653399145746,-0.03798808940841536,-0.010423711813091515,-0.027564377595323847,0.09869,0.09536714285714284,764415875.1199987,-0.20253000000000004,-32.92944279591165,-96.92130744128819,3.078692558711808,17.767364614423077,0.46963333333333335,0.4535472832932491,0.5249185714285715,0.5069183796087473,0.600865,0.57646372074086,194257.0,25436298.033333316,505763.0,23974021.85714286
2021-04-24,0.41416,0.41455,0.35234,0.36899,41934203.1,43516.0,21327002.9,0.3969066666666666,0.45919571428571426,0.5722050000000001,0.4016018208233123,0.45517908852992034,0.5427810049602052,25.736901876366588,0.7646539800331221,0.379756019966878,-0.05469185675024979,-0.024904375542364715,-0.029787481207885075,0.06220999999999999,0.08849142857142855,775337388.9199986,-0.22697000000000006,-43.689720424856546,-91.59414500527862,8.405854994721372,10.795937578333913,-10.906412980490629,0.40722,0.4186,0.33953,0.41488,52855716.9,54646.0,26121925.7,1.881047099847748,26.524587300200892,0.7682691597785154,0.41154584022148466,-0.04559267894960117,-0.017457505240393446,-0.028135173709207727,0.07907000000000003,0.08899357142857141,817271592.0199987,-0.19314999999999993,-39.313976449937826,-79.09673481843149,20.903265181568518,13.20761339178479,0.42961333333333335,0.43421364164662457,0.4976742857142857,0.4839087847065605,0.5899075,0.5610747949560163,173361.0,24193794.76666665,479888.0,24757143.785714287
2021-04-25,0.36822,0.41259,0.33349,0.35865,38881871.9,38788.0,18760919.6,0.38084,0.43277714285714286,0.5560700000000001,0.38012591041165616,0.43104681639744025,0.525244718773519,26.278534466347068,0.7635157390563401,0.34862426094366006,-0.062022416488646814,-0.032327983731621136,-0.029694432757025678,0.0791,0.09111857142857141,736455517.0199987,-0.29145,-43.321533550365054,-92.9426944545735,7.057305545426501,12.122141907238811,-2.5989897343979056,0.41416,0.41455,0.35234,0.36899,41934203.1,43516.0,21327002.9,-10.906412980490629,25.736901876366588,0.7646539800331221,0.379756019966878,-0.05469185675024979,-0.024904375542364715,-0.029787481207885075,0.06220999999999999,0.08849142857142855,775337388.9199986,-0.22697000000000006,-43.689720424856546,-91.59414500527862,8.405854994721372,10.795937578333913,0.3969066666666666,0.4016018208233123,0.45919571428571426,0.45517908852992034,0.5722050000000001,0.5427810049602052,160190.0,24079485.666666653,429446.0,24186479.099999998
2021-04-26,0.35871,0.4775,0.35103,0.45942,86613261.1,63845.0,58855392.5,0.3956866666666666,0.43012,0.5456905,0.4197729552058281,0.4381401122980802,0.5189756979379457,38.55581672212216,0.7505211607882396,0.34085983921176033,-0.05902029187925828,-0.03766644536114857,-0.02135384651810971,0.12646999999999997,0.09515142857142855,823068778.1199987,-0.14616999999999997,-24.608618595949984,-64.6770076575692,35.322992342430794,16.928717627526236,28.07560424855734,0.36822,0.41259,0.33349,0.35865,38881871.9,38788.0,18760919.6,-2.5989897343979056,26.278534466347068,0.7635157390563401,0.34862426094366006,-0.062022416488646814,-0.032327983731621136,-0.029694432757025678,0.0791,0.09111857142857141,736455517.0199987,-0.29145,-43.321533550365054,-92.9426944545735,7.057305545426501,12.122141907238811,0.38084,0.38012591041165616,0.43277714285714286,0.43104681639744025,0.5560700000000001,0.525244718773519,136950.0,22069949.399999987,396573.0,23582594.914285716
2021-04-27,0.45831,0.64983,0.451,0.6231,123636060.0,159170.0,77153827.9,0.48038999999999993,0.4427142857142857,0.5470625,0.521436477602914,0.48438008422356016,0.5288922981343318,50.92170126359311,0.7536624083787425,0.34046259162125747,-0.04293851001287963,-0.038720858291494784,-0.0042176517213848436,0.19883,0.10415642857142855,946704838.1199987,-0.015240000000000031,2.4784961268358607,-18.76525202659111,81.2347479734089,41.20501528708874,35.956012306081035,0.35871,0.4775,0.35103,0.45942,86613261.1,63845.0,58855392.5,28.07560424855734,38.55581672212216,0.7505211607882396,0.34085983921176033,-0.05902029187925828,-0.03766644536114857,-0.02135384651810971,0.12646999999999997,0.09515142857142855,823068778.1199987,-0.14616999999999997,-24.608618595949984,-64.6770076575692,35.322992342430794,16.928717627526236,0.3956866666666666,0.4197729552058281,0.43012,0.4381401122980802,0.5456905,0.5189756979379457,146149.0,32981104.999999985,395052.0,28767733.542857144
2021-04-28,0.62213,0.64901,0.52911,0.58004,87491896.6,156989.0,44324572.0,0.5541866666666665,0.4588471428571429,0.5457345,0.550738238801457,0.5082950631676701,0.533763507835824,49.06187389510902,0.7510605616652132,0.34040843833478684,-0.033284481370983277,-0.037633582907392486,0.00434910153640921,0.1199,0.10936285714285714,859212941.5199987,0.03646000000000005,-2.6713202228337507,-30.843454601553944,69.15654539844606,61.904761904761926,-6.765467024576852,0.45831,0.64983,0.451,0.6231,123636060.0,159170.0,77153827.9,35.956012306081035,50.92170126359311,0.7536624083787425,0.34046259162125747,-0.04293851001287963,-0.038720858291494784,-0.0042176517213848436,0.19883,0.10415642857142855,946704838.1199987,-0.015240000000000031,2.4784961268358607,-18.76525202659111,81.2347479734089,41.20501528708874,0.48038999999999993,0.521436477602914,0.4427142857142857,0.48438008422356016,0.5470625,0.5288922981343318,261803.0,51590046.66666666,478680.0,35525503.885714285
2021-04-29,0.57988,0.635,0.548,0.56209,57770470.3,101990.0,28857313.7,0.58841,0.4810242857142857,0.5396565,0.5564141194007285,0.5217437973757526,0.536461268994317,44.58273319299282,0.7347339397676864,0.34457906023231355,-0.02677338221997061,-0.03546154276990811,0.008688160549937499,0.08699999999999997,0.10993285714285714,801442471.2199987,0.08406999999999998,-13.537917243501008,-35.8783764831281,64.12162351687189,71.50430562957563,-3.067876112299092,0.62213,0.64901,0.52911,0.58004,87491896.6,156989.0,44324572.0,-6.765467024576852,49.06187389510902,0.7510605616652132,0.34040843833478684,-0.033284481370983277,-0.037633582907392486,0.00434910153640921,0.1199,0.10936285714285714,859212941.5199987,0.03646000000000005,-2.6713202228337507,-30.843454601553944,69.15654539844606,61.904761904761926,0.5541866666666665,0.550738238801457,0.4588471428571429,0.5082950631676701,0.5457345,0.533763507835824,380004.0,60111264.133333325,578982.0,38761881.28571428
2021-04-30,0.5621,0.622,0.55081,0.60008,46922660.0,86317.0,23823414.5,0.5807366666666666,0.5074814285714286,0.5368965,0.5782470597003642,0.5413278480318144,0.542520195756763,49.658099504833764,0.7265732828397049,0.34721971716029504,-0.018336442631912586,-0.032036522742309004,0.013700080110396418,0.07118999999999998,0.10984714285714284,848365131.2199987,0.06513999999999998,-0.9098565035750239,-25.222293904799308,74.77770609520068,69.35195833683956,6.756804838996603,0.57988,0.635,0.548,0.56209,57770470.3,101990.0,28857313.7,-3.067876112299092,44.58273319299282,0.7347339397676864,0.34457906023231355,-0.02677338221997061,-0.03546154276990811,0.008688160549937499,0.08699999999999997,0.10993285714285714,801442471.2199987,0.08406999999999998,-13.537917243501008,-35.8783764831281,64.12162351687189,71.50430562957563,0.58841,0.5564141194007285,0.4810242857142857,0.5217437973757526,0.5396565,0.536461268994317,418149.0,50111904.533333324,618944.0,39342993.47142857
2021-05-01,0.59883,0.69999,0.59546,0.6741,68772093.1,147230.0,36894559.8,0.6120899999999999,0.5510685714285714,0.5389625,0.626173529850182,0.5745208860238609,0.5550516056846904,52.11083040162445,0.7338648382836148,0.34406016171638526,-0.005612613124096111,-0.026751740818666426,0.021139127694570315,0.10453000000000001,0.11125571428571426,917137224.3199987,0.20699,5.602030266002456,-7.064120054570251,92.93587994542975,77.27840318583412,12.569510545563862,0.5621,0.622,0.55081,0.60008,46922660.0,86317.0,23823414.5,6.756804838996603,49.658099504833764,0.7265732828397049,0.34721971716029504,-0.018336442631912586,-0.032036522742309004,0.013700080110396418,0.07118999999999998,0.10984714285714284,848365131.2199987,0.06513999999999998,-0.9098565035750239,-25.222293904799308,74.77770609520068,69.35195833683956,0.5807366666666666,0.5782470597003642,0.5074814285714286,0.5413278480318144,0.5368965,0.542520195756763,345296.0,32335100.06666665,650615.0,39014634.72857142
2021-05-02,0.67441,0.69,0.618,0.63506,39676022.1,94719.0,18642951.7,0.6364133333333333,0.5905557142857143,0.5402465000000001,0.630616764925091,0.5896556645178956,0.5626714527623389,55.78006924962722,0.7374271593777167,0.3430658406222834,0.001305858577174357,-0.02114022093949827,0.022446079516672626,0.07199999999999995,0.10364642857142857,877461202.2199987,0.22820999999999997,16.829169579454728,-17.71623465211461,82.28376534788538,83.33245046283861,-5.8347296155157835,0.59883,0.69999,0.59546,0.6741,68772093.1,147230.0,36894559.8,12.569510545563862,52.11083040162445,0.7338648382836148,0.34406016171638526,-0.005612613124096111,-0.026751740818666426,0.021139127694570315,0.10453000000000001,0.11125571428571426,917137224.3199987,0.20699,5.602030266002456,-7.064120054570251,92.93587994542975,77.27840318583412,0.6120899999999999,0.626173529850182,0.5510685714285714,0.5745208860238609,0.5389625,0.5550516056846904,335537.0,29858429.333333317,754329.0,41238571.428571425
2021-05-03,0.63522,0.6968,0.62601,0.63211,39115925.0,91186.0,18769027.4,0.6470899999999999,0.6152257142857144,0.5414505000000001,0.6313633824625455,0.6002692483884218,0.5692846477373542,60.57250284741948,0.7406575155681735,0.3422434844318266,0.0064761043992275225,-0.015616955871753109,0.02209306027098063,0.07079000000000002,0.10042428571428572,838345277.2199987,0.21722999999999992,32.23505292665578,-18.5211459754434,81.4788540245566,85.56616643929057,-0.48959415635528747,0.67441,0.69,0.618,0.63506,39676022.1,94719.0,18642951.7,-5.8347296155157835,55.78006924962722,0.7374271593777167,0.3430658406222834,0.001305858577174357,-0.02114022093949827,0.022446079516672626,0.07199999999999995,0.10364642857142857,877461202.2199987,0.22820999999999997,16.829169579454728,-17.71623465211461,82.28376534788538,83.33245046283861,0.6364133333333333,0.630616764925091,0.5905557142857143,0.5896556645178956,0.5402465000000001,0.5626714527623389,328266.0,26453641.999999985,810260.0,41221718.871428564
2021-05-04,0.63306,0.63514,0.53089,0.54757,63252856.6,114460.0,31866846.2,0.6049133333333332,0.6044357142857143,0.5390309999999999,0.5894666912312727,0.5870944362913163,0.5672165860480823,50.834930918225695,0.736619301155923,0.34144269884407685,0.0037091334119560004,-0.011751738015011289,0.015460871426967289,0.10425000000000006,0.09805857142857144,775092420.6199987,0.17858000000000002,2.361012449994404,-41.58799454297408,58.41200545702592,74.05820827648931,-13.504249202287296,0.63522,0.6968,0.62601,0.63211,39115925.0,91186.0,18769027.4,-0.48959415635528747,60.57250284741948,0.7406575155681735,0.3422434844318266,0.0064761043992275225,-0.015616955871753109,0.02209306027098063,0.07079000000000002,0.10042428571428572,838345277.2199987,0.21722999999999992,32.23505292665578,-18.5211459754434,81.4788540245566,85.56616643929057,0.6470899999999999,0.6313633824625455,0.6152257142857144,0.6002692483884218,0.5414505000000001,0.5692846477373542,333135.0,24768846.299999982,837601.0,35495095.28571428
2021-05-05,0.54719,0.61879,0.5351,0.59101,42946281.1,91862.0,21655883.7,0.5902299999999999,0.6060028571428572,0.5360765,0.5902383456156364,0.5880733272184873,0.5694826254720745,58.463577244658175,0.7283681161814751,0.3437848838185248,0.004964308468515921,-0.008408528718305847,0.013372837186821768,0.08368999999999993,0.09697999999999998,818038701.7199987,0.23236,26.524801438633293,-29.735334242837645,70.26466575716236,70.0518417462483,8.00818728412436,0.63306,0.63514,0.53089,0.54757,63252856.6,114460.0,31866846.2,-13.504249202287296,50.834930918225695,0.736619301155923,0.34144269884407685,0.0037091334119560004,-0.011751738015011289,0.015460871426967289,0.10425000000000006,0.09805857142857144,775092420.6199987,0.17858000000000002,2.361012449994404,-41.58799454297408,58.41200545702592,74.05820827648931,0.6049133333333332,0.5894666912312727,0.6044357142857143,0.5870944362913163,0.5390309999999999,0.5672165860480823,300365.0,23092941.76666665,792891.0,29025526.471428573
2021-05-06,0.59006,0.61647,0.547,0.56206,35789970.2,79656.0,17542518.6,0.5668799999999999,0.6059985714285715,0.5339,0.5761491728078182,0.5815699954138654,0.5687757087604484,61.07614358096053,0.7238499016499921,0.343950098350008,0.00358173270407125,-0.006010476433830428,0.009592209137901677,0.06946999999999992,0.09489285714285713,782248731.5199987,0.10264000000000001,38.14919503502521,-37.6343792633015,62.3656207366985,63.68076398362894,-4.745280141002614,0.54719,0.61879,0.5351,0.59101,42946281.1,91862.0,21655883.7,8.00818728412436,58.463577244658175,0.7283681161814751,0.3437848838185248,0.004964308468515921,-0.008408528718305847,0.013372837186821768,0.08368999999999993,0.09697999999999998,818038701.7199987,0.23236,26.524801438633293,-29.735334242837645,70.26466575716236,70.0518417462483,0.5902299999999999,0.5902383456156364,0.6060028571428572,0.5880733272184873,0.5360765,0.5694826254720745,297508.0,24097252.43333332,727764.0,25787142.42857143
2021-05-07,0.56321,0.60634,0.53785,0.57068,33070281.6,72315.0,17065506.6,0.5745833333333333,0.6017985714285714,0.530517,0.5734145864039091,0.578847496560399,0.5689570698308818,61.10889281843591,0.7149653926796458,0.34606860732035427,0.003145335934730542,-0.0041793139601182345,0.007324649894848777,0.06848999999999994,0.09413714285714284,815319013.1199987,-0.05242000000000002,37.55302738141148,-35.2824010914052,64.71759890859481,65.78262846748522,1.3263258819978296,0.59006,0.61647,0.547,0.56206,35789970.2,79656.0,17542518.6,-4.745280141002614,61.07614358096053,0.7238499016499921,0.343950098350008,0.00358173270407125,-0.006010476433830428,0.009592209137901677,0.06946999999999992,0.09489285714285713,782248731.5199987,0.10264000000000001,38.14919503502521,-37.6343792633015,62.3656207366985,63.68076398362894,0.5668799999999999,0.5761491728078182,0.6059985714285715,0.5815699954138654,0.5339,0.5687757087604484,285978.0,23688416.166666653,705430.0,24170743.12857143
2021-05-08,0.57054,0.58328,0.54104,0.55482,23132168.2,50806.0,11225255.8,0.5625199999999998,0.5847585714285713,0.531079,0.5641172932019545,0.5728406224202992,0.5676106822279406,63.842910564502915,0.7157633237755185,0.3463946762244814,0.0015024001646234408,-0.0030429711351698994,0.004545371299793341,0.042240000000000055,0.09271071428571427,792186844.9199986,-0.02522000000000002,50.361798422721485,-39.60982264665758,60.39017735334242,62.491132332878585,-2.755284467346736,0.56321,0.60634,0.53785,0.57068,33070281.6,72315.0,17065506.6,1.3263258819978296,61.10889281843591,0.7149653926796458,0.34606860732035427,0.003145335934730542,-0.0041793139601182345,0.007324649894848777,0.06848999999999994,0.09413714285714284,815319013.1199987,-0.05242000000000002,37.55302738141148,-35.2824010914052,64.71759890859481,65.78262846748522,0.5745833333333333,0.5734145864039091,0.6017985714285714,0.578847496560399,0.530517,0.5689570698308818,243833.0,18754636.299999986,691428.0,23205327.714285713
2021-05-09,0.5548,0.55723,0.51036,0.53163,26959336.4,55944.0,13184318.2,0.5523766666666666,0.5699828571428571,0.5337594999999999,0.5478736466009773,0.5625379668152244,0.5641839505871844,62.643627751951584,0.7167497309126725,0.3507692690873274,-0.0016518361243734736,-0.002764744133010614,0.0011129080086371406,0.04686999999999997,0.09040857142857141,765227508.5199987,-0.03045999999999993,48.230865746549554,-48.2462173314993,51.753782668500705,58.95385297681266,-4.176279740446993,0.57054,0.58328,0.54104,0.55482,23132168.2,50806.0,11225255.8,-2.755284467346736,63.842910564502915,0.7157633237755185,0.3463946762244814,0.0015024001646234408,-0.0030429711351698994,0.004545371299793341,0.042240000000000055,0.09271071428571427,792186844.9199986,-0.02522000000000002,50.361798422721485,-39.60982264665758,60.39017735334242,62.491132332878585,0.5625199999999998,0.5641172932019545,0.5847585714285713,0.5728406224202992,0.531079,0.5676106822279406,202777.0,15277760.333333319,595004.0,19538284.285714287
2021-05-10,0.53118,0.578,0.4455,0.48978,38813602.6,78881.0,18637295.7,0.5254099999999999,0.54965,0.5315015000000001,0.5188268233004887,0.5443484751114183,0.5570978600550716,52.428256070640174,0.7155418837005105,0.3474611162994896,-0.007442741067327008,-0.003700343519873893,-0.0037423975474531147,0.13249999999999995,0.09083928571428569,726413905.9199986,-0.11029999999999995,6.608332245004567,-82.6004951078628,17.39950489213721,43.181154971326784,-7.7939681463910535,0.5548,0.55723,0.51036,0.53163,26959336.4,55944.0,13184318.2,-4.176279740446993,62.643627751951584,0.7167497309126725,0.3507692690873274,-0.0016518361243734736,-0.002764744133010614,0.0011129080086371406,0.04686999999999997,0.09040857142857141,765227508.5199987,-0.03045999999999993,48.230865746549554,-48.2462173314993,51.753782668500705,58.95385297681266,0.5523766666666666,0.5478736466009773,0.5699828571428571,0.5625379668152244,0.5337594999999999,0.5641839505871844,179065.0,13825026.866666652,556229.0,18758479.5
2021-05-11,0.49006,0.57149,0.46395,0.54404,31514596.1,60947.0,15443178.8,0.5218166666666666,0.5491457142857142,0.535348,0.5314334116502444,0.5442713563335637,0.555854254335541,42.33498797797254,0.7169210306428839,0.35377496935711616,-0.007566524244087436,-0.004473579664716601,-0.0030929445793708345,0.10754000000000008,0.08431857142857142,757928502.0199987,-0.13006000000000006,-12.68817204301076,-61.27942158827461,38.7205784117254,35.957955324121116,11.014977757825568,0.53118,0.578,0.4455,0.48978,38813602.6,78881.0,18637295.7,-7.7939681463910535,52.428256070640174,0.7155418837005105,0.3474611162994896,-0.007442741067327008,-0.003700343519873893,-0.0037423975474531147,0.13249999999999995,0.09083928571428569,726413905.9199986,-0.11029999999999995,6.608332245004567,-82.6004951078628,17.39950489213721,43.181154971326784,0.5254099999999999,0.5188268233004887,0.54965,0.5443484751114183,0.5315015000000001,0.5570978600550716,185631.0,14348956.566666653,543924.0,18739660.685714286
2021-05-12,0.54466,0.55421,0.43877,0.4454,24319436.7,47904.0,11587344.1,0.49307333333333325,0.5283442857142857,0.5372755,0.4884167058251222,0.5195535172501728,0.5453348015416799,38.21634867845266,0.7138548321010778,0.3606961678989223,-0.015445995117685074,-0.006668062755310296,-0.008777932362374778,0.11543999999999999,0.08399999999999998,733609065.3199986,-0.18965999999999994,-23.21219226260257,-97.46190950156955,2.538090498430451,19.55272460076436,-18.22421327066427,0.49006,0.57149,0.46395,0.54404,31514596.1,60947.0,15443178.8,11.014977757825568,42.33498797797254,0.7169210306428839,0.35377496935711616,-0.007566524244087436,-0.004473579664716601,-0.0030929445793708345,0.10754000000000008,0.08431857142857142,757928502.0199987,-0.13006000000000006,-12.68817204301076,-61.27942158827461,38.7205784117254,35.957955324121116,0.5218166666666666,0.5314334116502444,0.5491457142857142,0.5442713563335637,0.535348,0.555854254335541,195772.0,15754930.899999985,490411.0,16393422.485714287
2021-05-13,0.44538,0.48948,0.41184,0.44661,34151224.0,46424.0,16940673.8,0.4786833333333333,0.5118514285714285,0.5388620000000001,0.46751335291256113,0.5013176379376296,0.5359324394900914,39.588141950375075,0.711333491050732,0.36639050894926817,-0.021346822780843544,-0.009603814760416947,-0.011743008020426597,0.07764000000000004,0.08333142857142857,767760289.3199986,-0.18549999999999994,-20.544752619687234,-87.93336803748048,12.066631962519528,17.775100290891803,0.2761686649602606,0.54466,0.55421,0.43877,0.4454,24319436.7,47904.0,11587344.1,-18.22421327066427,38.21634867845266,0.7138548321010778,0.3606961678989223,-0.015445995117685074,-0.006668062755310296,-0.008777932362374778,0.11543999999999999,0.08399999999999998,733609065.3199986,-0.18965999999999994,-23.21219226260257,-97.46190950156955,2.538090498430451,19.55272460076436,0.49307333333333325,0.4884167058251222,0.5283442857142857,0.5195535172501728,0.5372755,0.5453348015416799,187732.0,15222606.199999982,446453.0,14955059.685714286
2021-05-14,0.44691,0.50432,0.44409,0.47341,32459023.2,37431.0,18831457.4,0.45513999999999993,0.4979557142857143,0.544083,0.47046167645628056,0.4943407284532222,0.529977921443416,38.34403813239598,0.7004750602507468,0.3876909397492531,-0.023588817983821286,-0.012400815405097815,-0.011188002578723471,0.060230000000000006,0.08254857142857143,800219312.5199987,-0.07416,-21.108852153046254,-78.632656602464,21.36734339753601,11.990688619495339,5.92960551341434,0.44538,0.48948,0.41184,0.44661,34151224.0,46424.0,16940673.8,0.2761686649602606,39.588141950375075,0.711333491050732,0.36639050894926817,-0.021346822780843544,-0.009603814760416947,-0.011743008020426597,0.07764000000000004,0.08333142857142857,767760289.3199986,-0.18549999999999994,-20.544752619687234,-87.93336803748048,12.066631962519528,17.775100290891803,0.4786833333333333,0.46751335291256113,0.5118514285714285,0.5013176379376296,0.5388620000000001,0.5359324394900914,155275.0,14657065.566666653,413221.0,14869081.857142856
2021-05-15,0.47249,0.53776,0.43047,0.47902,54751662.4,54882.0,30787018.3,0.46634666666666663,0.4871271428571428,0.5501015,0.4747408382281403,0.49051054633991664,0.5251247860678526,29.46353377126495,0.6841094440339642,0.4160935559660358,-0.02462902712593984,-0.01484645774926622,-0.009782569376673619,0.10729,0.08274571428571428,854970974.9199986,-0.11199000000000003,-28.93932650941997,-76.42476137001684,23.57523862998316,19.00307133001291,1.3820398315308218,0.44691,0.50432,0.44409,0.47341,32459023.2,37431.0,18831457.4,5.92960551341434,38.34403813239598,0.7004750602507468,0.3876909397492531,-0.023588817983821286,-0.012400815405097815,-0.011188002578723471,0.060230000000000006,0.08254857142857143,800219312.5199987,-0.07416,-21.108852153046254,-78.632656602464,21.36734339753601,11.990688619495339,0.45513999999999993,0.47046167645628056,0.4979557142857143,0.4943407284532222,0.544083,0.529977921443416,131759.0,15786491.76666665,378337.0,15121360.542857142
2021-05-16,0.47939,0.57651,0.43301,0.4634,70761652.2,85905.0,35719131.8,0.4719433333333332,0.47738,0.5503005,0.4690704191140701,0.4837329097549375,0.5192462350137714,30.991717234353544,0.6837521168543947,0.41684888314560514,-0.026409373010779835,-0.017159040801568944,-0.009250332209210892,0.14349999999999996,0.08785285714285714,784209322.7199986,-0.09866000000000003,-27.030516801562054,-81.9062324536777,18.09376754632229,21.01211652461383,-3.3354888504140687,0.47249,0.53776,0.43047,0.47902,54751662.4,54882.0,30787018.3,1.3820398315308218,29.46353377126495,0.6841094440339642,0.4160935559660358,-0.02462902712593984,-0.01484645774926622,-0.009782569376673619,0.10729,0.08274571428571428,854970974.9199986,-0.11199000000000003,-28.93932650941997,-76.42476137001684,23.57523862998316,19.00307133001291,0.46634666666666663,0.4747408382281403,0.4871271428571428,0.49051054633991664,0.5501015,0.5251247860678526,138737.0,22186383.166666653,382413.0,17915898.042857144
2021-05-17,0.46327,0.47018,0.40923,0.43345,29348155.1,39189.0,14611513.0,0.4586233333333332,0.46933285714285716,0.540818,0.45126020955703505,0.4711621823162031,0.5110751650124599,29.24311447318928,0.6793442678643318,0.40229173213566827,-0.02989244317114409,-0.019705721275483975,-0.010186721895660115,0.060950000000000004,0.08714999999999999,754861167.6199986,-0.13722999999999996,-31.428074227586965,-89.27891638263024,10.721083617369755,17.463363264558414,-6.436851080363505,0.47939,0.57651,0.43301,0.4634,70761652.2,85905.0,35719131.8,-3.3354888504140687,30.991717234353544,0.6837521168543947,0.41684888314560514,-0.026409373010779835,-0.017159040801568944,-0.009250332209210892,0.14349999999999996,0.08785285714285714,784209322.7199986,-0.09866000000000003,-27.030516801562054,-81.9062324536777,18.09376754632229,21.01211652461383,0.4719433333333332,0.4690704191140701,0.47738,0.4837329097549375,0.5503005,0.5192462350137714,178218.0,28445869.166666653,412374.0,21135157.128571425
2021-05-18,0.43346,0.548,0.42687,0.50894,69577263.7,67224.0,39705530.5,0.46859666666666655,0.46431857142857147,0.537263,0.4801001047785175,0.4806066367371523,0.5108718159636542,45.88596136232933,0.6751991666401091,0.39932683335989094,-0.026258695368909346,-0.021016316094169048,-0.005242379274740298,0.12113000000000002,0.08835571428571427,824438431.3199986,-0.04588000000000003,-7.054805778256668,-52.41935483870969,47.58064516129031,25.465165441660798,17.41337147603007,0.46327,0.47018,0.40923,0.43345,29348155.1,39189.0,14611513.0,-6.436851080363505,29.24311447318928,0.6793442678643318,0.40229173213566827,-0.02989244317114409,-0.019705721275483975,-0.010186721895660115,0.060950000000000004,0.08714999999999999,754861167.6199986,-0.13722999999999996,-31.428074227586965,-89.27891638263024,10.721083617369755,17.463363264558414,0.4586233333333332,0.45126020955703505,0.46933285714285716,0.4711621823162031,0.540818,0.5110751650124599,179976.0,27039221.03333332,372682.0,20560045.314285714
2021-05-19,0.50893,0.51424,0.24789,0.32775,70577592.4,74412.0,33151377.6,0.42337999999999987,0.44751142857142856,0.5255460000000001,0.40392505238925874,0.44239247755286426,0.4934316430147347,28.32323298860416,0.6915573434805286,0.3595346565194716,-0.037566400704834746,-0.02432633301630219,-0.013240067688532555,0.26635000000000003,0.10140285714285714,753860838.9199986,-0.20388000000000006,-44.54408554846788,-78.33306202181345,21.666937978186553,26.65622225228222,-35.600180771422394,0.43346,0.548,0.42687,0.50894,69577263.7,67224.0,39705530.5,17.41337147603007,45.88596136232933,0.6751991666401091,0.39932683335989094,-0.026258695368909346,-0.021016316094169048,-0.005242379274740298,0.12113000000000002,0.08835571428571427,824438431.3199986,-0.04588000000000003,-7.054805778256668,-52.41935483870969,47.58064516129031,25.465165441660798,0.46859666666666655,0.4801001047785175,0.46431857142857147,0.4806066367371523,0.537263,0.5108718159636542,192318.0,30012058.43333332,378959.0,24026095.557142854
2021-05-20,0.32634,0.39927,0.28423,0.34948,48098558.4,51382.0,24017946.7,0.3953899999999999,0.4336357142857143,0.513016,0.3767025261946294,0.4191643581646482,0.47972196272761713,32.28559048031731,0.6926136734581447,0.3334183265418553,-0.04426415957822544,-0.02831389832868684,-0.0159502612495386,0.11504000000000003,0.10465785714285715,801959397.3199986,-0.14029999999999998,-37.82158488417606,-71.65852978100153,28.34147021899847,32.52968445282512,7.090764233621375,0.50893,0.51424,0.24789,0.32775,70577592.4,74412.0,33151377.6,-35.600180771422394,28.32323298860416,0.6915573434805286,0.3595346565194716,-0.037566400704834746,-0.02432633301630219,-0.013240067688532555,0.26635000000000003,0.10140285714285714,753860838.9199986,-0.20388000000000006,-44.54408554846788,-78.33306202181345,21.666937978186553,26.65622225228222,0.42337999999999987,0.40392505238925874,0.44751142857142856,0.44239247755286426,0.5255460000000001,0.4934316430147347,180825.0,29156140.366666656,405467.0,27106671.771428574
2021-05-21,0.34722,0.36337,0.25,0.29189,49673834.3,49296.0,23756657.8,0.32303999999999994,0.4077042857142857,0.4939055,0.3342962630973147,0.38734576862348613,0.461833204372606,28.521240697083158,0.6824496280722517,0.30536137192774826,-0.05360133066617284,-0.03337138479618404,-0.020229945869988802,0.11337000000000003,0.10786357142857143,752285563.0199987,-0.25215,-48.85224644284012,-86.88094457199082,13.119055428009178,21.042487875064744,-15.935141984908702,0.32634,0.39927,0.28423,0.34948,48098558.4,51382.0,24017946.7,7.090764233621375,32.28559048031731,0.6926136734581447,0.3334183265418553,-0.04426415957822544,-0.02831389832868684,-0.0159502612495386,0.11504000000000003,0.10465785714285715,801959397.3199986,-0.14029999999999998,-37.82158488417606,-71.65852978100153,28.34147021899847,32.52968445282512,0.3953899999999999,0.3767025261946294,0.4336357142857143,0.4191643581646482,0.513016,0.47972196272761713,193018.0,32291618.266666654,410425.0,28117710.757142853
2021-05-22,0.29086,0.29375,0.2452,0.24842,60844702.2,44449.0,30469922.9,0.29659666666666656,0.3747614285714286,0.4745735,0.29135813154865736,0.35261432646761465,0.44150813728950067,27.357375110848352,0.680650252413421,0.268496747586579,-0.06377362903232908,-0.03945183364341305,-0.02432179538891603,0.04855000000000001,0.10831428571428572,691440860.8199986,-0.19698000000000002,-55.22511805630654,-99.03245192307692,0.9675480769230771,14.142691241310251,-14.59121226707007,0.34722,0.36337,0.25,0.29189,49673834.3,49296.0,23756657.8,-15.935141984908702,28.521240697083158,0.6824496280722517,0.30536137192774826,-0.05360133066617284,-0.03337138479618404,-0.020229945869988802,0.11337000000000003,0.10786357142857143,752285563.0199987,-0.25215,-48.85224644284012,-86.88094457199082,13.119055428009178,21.042487875064744,0.32303999999999994,0.3342962630973147,0.4077042857142857,0.38734576862348613,0.4939055,0.461833204372606,175090.0,26975327.366666656,422290.0,28821310.814285714
2021-05-23,0.24847,0.2641,0.17141,0.21258,64196712.6,42919.0,33043669.3,0.25096333333333326,0.33893,0.453597,0.25196906577432865,0.31760574485071097,0.41970545754764343,26.85527747551687,0.6768475350356038,0.23034646496439615,-0.07387564480031672,-0.04633659587479379,-0.027539048925522933,0.09269,0.11158714285714287,627244148.2199986,-0.23403000000000002,-60.01354325376672,-89.87432056863179,10.125679431368207,8.07076097876683,-14.444399726325111,0.29086,0.29375,0.2452,0.24842,60844702.2,44449.0,30469922.9,-14.59121226707007,27.357375110848352,0.680650252413421,0.268496747586579,-0.06377362903232908,-0.03945183364341305,-0.02432179538891603,0.04855000000000001,0.10831428571428572,691440860.8199986,-0.19698000000000002,-55.22511805630654,-99.03245192307692,0.9675480769230771,14.142691241310251,0.29659666666666656,0.29135813154865736,0.3747614285714286,0.35261432646761465,0.4745735,0.44150813728950067,145127.0,26081509.13333332,411857.0,28776011.471428573
2021-05-24,0.21259,0.29999,0.20522,0.28716,70908900.5,51790.0,37926091.8,0.24938666666666662,0.3180314285714285,0.44057650000000004,0.2695645328871643,0.30999430863803323,0.40708208063834406,35.96775533948308,0.6710101819564342,0.21014281804356577,-0.07499904011939179,-0.05206908472371339,-0.0229299553956784,0.09476999999999997,0.10889214285714287,698153048.7199986,-0.18624999999999997,-41.36959451182163,-71.42680819550728,28.573191804492726,13.222139770928012,35.076908603415035,0.24847,0.2641,0.17141,0.21258,64196712.6,42919.0,33043669.3,-14.444399726325111,26.85527747551687,0.6768475350356038,0.23034646496439615,-0.07387564480031672,-0.04633659587479379,-0.027539048925522933,0.09269,0.11158714285714287,627244148.2199986,-0.23403000000000002,-60.01354325376672,-89.87432056863179,10.125679431368207,8.07076097876683,0.25096333333333326,0.25196906577432865,0.33893,0.31760574485071097,0.453597,0.41970545754764343,136664.0,29090083.333333317,368871.0,28393802.54285714
2021-05-25,0.28787,0.30147,0.24228,0.27909,62732163.8,48169.0,31494133.5,0.25960999999999995,0.2851957142857143,0.42498050000000004,0.2743272664435822,0.30226823147852494,0.3948923586727875,30.39701682475325,0.6547659541202776,0.19519504587972247,-0.07566826391502729,-0.056788920561976174,-0.018879343353051116,0.05919000000000002,0.10543857142857145,635420884.9199986,-0.19993,-48.7004632012352,-73.4189089113799,26.581091088620095,21.75998744149369,-3.0499878417341195,0.21259,0.29999,0.20522,0.28716,70908900.5,51790.0,37926091.8,35.076908603415035,35.96775533948308,0.6710101819564342,0.21014281804356577,-0.07499904011939179,-0.05206908472371339,-0.0229299553956784,0.09476999999999997,0.10889214285714287,698153048.7199986,-0.18624999999999997,-41.36959451182163,-71.42680819550728,28.573191804492726,13.222139770928012,0.24938666666666662,0.2695645328871643,0.3180314285714285,0.30999430863803323,0.44057650000000004,0.40708208063834406,139158.0,33813227.999999985,381472.0,31724456.65714286
2021-05-26,0.27851,0.34298,0.26578,0.33353,73093327.1,62814.0,35639449.2,0.2999266666666666,0.2860214285714286,0.413554,0.3039286332217911,0.31008367360889366,0.3890483245134744,41.14377998385028,0.6372867082315649,0.1898212917684351,-0.07098747613194939,-0.059628631675970815,-0.011358844455978574,0.07719999999999999,0.10270714285714287,708514212.0199987,-0.12986999999999999,-25.11674898967221,-59.98025178968156,40.01974821031844,31.724677034477097,19.75512548921045,0.28787,0.30147,0.24228,0.27909,62732163.8,48169.0,31494133.5,-3.0499878417341195,30.39701682475325,0.6547659541202776,0.19519504587972247,-0.07566826391502729,-0.056788920561976174,-0.018879343353051116,0.05919000000000002,0.10543857142857145,635420884.9199986,-0.19993,-48.7004632012352,-73.4189089113799,26.581091088620095,21.75998744149369,0.25960999999999995,0.2743272664435822,0.2851957142857143,0.30226823147852494,0.42498050000000004,0.3948923586727875,142878.0,34154631.533333324,362417.0,30551399.942857146
2021-05-27,0.33308,0.33616,0.29,0.29591,52178830.3,41936.0,26978783.1,0.3028433333333333,0.2783685714285714,0.3998155,0.29991931661089555,0.3065402552066703,0.3801780078931435,38.720059880239525,0.6165589310034719,0.18307206899652806,-0.06951224381037041,-0.061605354102850736,-0.007906889707519675,0.046160000000000034,0.10045857142857142,656335381.7199987,-0.13754,-33.743086809520605,-69.26684769192791,30.733152308072082,32.44466386900355,-11.15948120571634,0.27851,0.34298,0.26578,0.33353,73093327.1,62814.0,35639449.2,19.75512548921045,41.14377998385028,0.6372867082315649,0.1898212917684351,-0.07098747613194939,-0.059628631675970815,-0.011358844455978574,0.07719999999999999,0.10270714285714287,708514212.0199987,-0.12986999999999999,-25.11674898967221,-59.98025178968156,40.01974821031844,31.724677034477097,0.2999266666666666,0.3039286332217911,0.2860214285714286,0.31008367360889366,0.413554,0.3890483245134744,162773.0,35019891.499999985,350819.0,30906838.74285714
2021-05-28,0.29608,0.339,0.24367,0.31372,102859476.8,75257.0,54614030.4,0.3143866666666666,0.2814871428571429,0.3877605,0.3068196583054478,0.3083351914050027,0.37384867380808223,37.884098875586105,0.5948067573766622,0.18071424262333777,-0.06614353194804645,-0.06251298967188988,-0.0036305422761565703,0.09533000000000003,0.1029657142857143,759194858.5199987,-0.19521999999999995,-33.731860332481354,-64.87040236978524,35.12959763021477,35.29416604953511,5.9578492299378505,0.33308,0.33616,0.29,0.29591,52178830.3,41936.0,26978783.1,-11.15948120571634,38.720059880239525,0.6165589310034719,0.18307206899652806,-0.06951224381037041,-0.061605354102850736,-0.007906889707519675,0.046160000000000034,0.10045857142857142,656335381.7199987,-0.13754,-33.743086809520605,-69.26684769192791,30.733152308072082,32.44466386900355,0.3028433333333333,0.29991931661089555,0.2783685714285714,0.3065402552066703,0.3998155,0.3801780078931435,152919.0,31370788.599999983,341373.0,31329815.37142857
2021-05-29,0.31395,0.34778,0.26364,0.28186,146793122.8,97181.0,77848204.3,0.2971633333333333,0.2862642857142857,0.37527199999999994,0.2943398291527239,0.301716393553752,0.3650878477311221,35.614219420366,0.5758086250942936,0.17473537490570623,-0.0652919938000941,-0.06306879049753072,-0.00222320330256337,0.08413999999999999,0.10131214285714286,612401735.7199986,-0.045889999999999986,-41.15903302576093,-72.73512712910393,27.264872870896077,31.042540936394317,-10.221372830068484,0.29608,0.339,0.24367,0.31372,102859476.8,75257.0,54614030.4,5.9578492299378505,37.884098875586105,0.5948067573766622,0.18071424262333777,-0.06614353194804645,-0.06251298967188988,-0.0036305422761565703,0.09533000000000003,0.1029657142857143,759194858.5199987,-0.19521999999999995,-33.731860332481354,-64.87040236978524,35.12959763021477,35.29416604953511,0.3143866666666666,0.3068196583054478,0.2814871428571429,0.3083351914050027,0.3877605,0.37384867380808223,180007.0,39077420.89999998,367334.0,35738011.45714285
2021-05-30,0.28188,0.33,0.26185,0.30984,49787691.9,47026.0,24821679.4,0.30180666666666656,0.30015857142857144,0.366275,0.3020899145763619,0.303747295165314,0.3598261479472057,38.994008199306215,0.5612493842284465,0.1713006157715535,-0.06164874318503066,-0.06278478103503071,0.001136037850000049,0.06814999999999999,0.09593,662189427.6199986,-0.03964000000000001,-33.137678031937845,-63.24119068482966,36.75880931517034,33.05109327209374,9.919114516815661,0.31395,0.34778,0.26364,0.28186,146793122.8,97181.0,77848204.3,-10.221372830068484,35.614219420366,0.5758086250942936,0.17473537490570623,-0.0652919938000941,-0.06306879049753072,-0.00222320330256337,0.08413999999999999,0.10131214285714286,612401735.7199986,-0.045889999999999986,-41.15903302576093,-72.73512712910393,27.264872870896077,31.042540936394317,0.2971633333333333,0.2943398291527239,0.2862642857142857,0.301716393553752,0.37527199999999994,0.3650878477311221,214374.0,53147005.933333315,420066.0,42506337.37142857
2021-05-31,0.31158,0.338,0.28709,0.32775,49256574.4,44814.0,24987182.0,0.3064833333333332,0.30595714285714287,0.3554605,0.31491995728818095,0.3097479713739855,0.35677127671413844,42.29119869307739,0.5320456588774893,0.17887534112251063,-0.05666307682639088,-0.06156044019330274,0.004897363366911864,0.05091000000000001,0.09521285714285714,711446002.0199986,0.03586,-24.38574230014996,-58.485355426325725,41.51464457367428,35.17944225324691,5.189678413248592,0.28188,0.33,0.26185,0.30984,49787691.9,47026.0,24821679.4,9.919114516815661,38.994008199306215,0.5612493842284465,0.1713006157715535,-0.06164874318503066,-0.06278478103503071,0.001136037850000049,0.06814999999999999,0.09593,662189427.6199986,-0.03964000000000001,-33.137678031937845,-63.24119068482966,36.75880931517034,33.05109327209374,0.30180666666666656,0.3020899145763619,0.30015857142857144,0.303747295165314,0.366275,0.3598261479472057,219464.0,52427971.36666665,424173.0,41331767.385714285
2021-06-01,0.32699,0.33946,0.31,0.32699,88773693.3,37487.0,50162290.0,0.32152666666666657,0.3128,0.34954,0.3209549786440905,0.3140584785304892,0.3539349646461253,35.10681836784809,0.5213026400159878,0.1777773599840122,-0.05217182168128687,-0.05968271649089957,0.0075108948096127,0.029459999999999986,0.08866500000000001,622672308.7199986,0.07857,-35.75077612292215,-54.618907330163644,45.381092669836356,41.218182186227004,0.0,0.31158,0.338,0.28709,0.32775,49256574.4,44814.0,24987182.0,5.189678413248592,42.29119869307739,0.5320456588774893,0.17887534112251063,-0.05666307682639088,-0.06156044019330274,0.004897363366911864,0.05091000000000001,0.09521285714285714,711446002.0199986,0.03586,-24.38574230014996,-58.485355426325725,41.51464457367428,35.17944225324691,0.3064833333333332,0.31491995728818095,0.30595714285714287,0.3097479713739855,0.3554605,0.35677127671413844,189021.0,42552355.23333332,417197.0,39483351.699999996
2021-06-02,0.32663,0.35858,0.31223,0.35097,70188295.3,45317.0,42253032.3,0.3352366666666666,0.3152914285714286,0.344758,0.33596248932204525,0.3232863588978669,0.35365258706078,52.559298121858745,0.5103564559551672,0.17915954404483275,-0.04614554689032174,-0.056975282570784005,0.010829735680462263,0.04635,0.0729507142857143,692860604.0199986,0.13839,7.08466819221969,-21.1972263670675,78.8027736329325,55.23283695881438,7.451856841074007,0.32699,0.33946,0.31,0.32699,88773693.3,37487.0,50162290.0,0.0,35.10681836784809,0.5213026400159878,0.1777773599840122,-0.05217182168128687,-0.05968271649089957,0.0075108948096127,0.029459999999999986,0.08866500000000001,622672308.7199986,0.07857,-35.75077612292215,-54.618907330163644,45.381092669836356,41.218182186227004,0.32152666666666657,0.3209549786440905,0.3128,0.3140584785304892,0.34954,0.3539349646461253,129327.0,33323717.133333314,406515.0,42150231.199999996
2021-06-03,0.35117,0.4389,0.34718,0.40705,73672930.6,90357.0,36951248.3,0.36166999999999994,0.3311685714285714,0.34144,0.37150624466102267,0.3442272691734002,0.35873805495975336,55.898686448492796,0.49863066839853304,0.184249331601467,-0.036424613115174476,-0.0528651486796621,0.016440535564487622,0.09172000000000002,0.071285,766533534.6199986,0.11989,16.473045667849373,-11.906987177090727,88.09301282290927,70.75895970855937,15.912521001224492,0.32663,0.35858,0.31223,0.35097,70188295.3,45317.0,42253032.3,7.451856841074007,52.559298121858745,0.5103564559551672,0.17915954404483275,-0.04614554689032174,-0.056975282570784005,0.010829735680462263,0.04635,0.0729507142857143,692860604.0199986,0.13839,7.08466819221969,-21.1972263670675,78.8027736329325,55.23283695881438,0.3352366666666666,0.33596248932204525,0.3152914285714286,0.3232863588978669,0.344758,0.35365258706078,127618.0,39134168.09999999,389018.0,43095028.78571428
2021-06-04,0.40703,0.4103,0.33157,0.36599,46907788.6,54034.0,23741382.0,0.3746699999999999,0.33863571428571426,0.33578849999999993,0.36874812233051135,0.3496679518800502,0.3594287163921578,57.85856700462393,0.47972047344578644,0.19185652655421342,-0.03166884319886054,-0.04862588758350179,0.016957044384641247,0.07873000000000002,0.0688107142857143,719625746.0199986,0.08689999999999998,25.38627565178664,-27.25709372312985,72.74290627687016,79.87956424423732,-10.082794879984283,0.35117,0.4389,0.34718,0.40705,73672930.6,90357.0,36951248.3,15.912521001224492,55.898686448492796,0.49863066839853304,0.184249331601467,-0.036424613115174476,-0.0528651486796621,0.016440535564487622,0.09172000000000002,0.071285,766533534.6199986,0.11989,16.473045667849373,-11.906987177090727,88.09301282290927,70.75895970855937,0.36166999999999994,0.37150624466102267,0.3311685714285714,0.3442272691734002,0.34144,0.35873805495975336,173161.0,43122190.19999998,437439.0,44519666.67142857
2021-06-05,0.36503,0.43078,0.3362,0.35295,57386698.4,64434.0,29011395.7,0.37532999999999994,0.34879142857142853,0.330266,0.36084906116525567,0.35048846391003763,0.35881169578338085,61.850667755028,0.461497273294611,0.19903472670538902,-0.028622142059881173,-0.044625138478777665,0.016002996418896492,0.09458,0.07209857142857143,662239047.6199986,0.019419999999999993,42.077932533612426,-32.13204231933905,67.86795768066095,76.23462559348013,-3.3093170424348775,0.40703,0.4103,0.33157,0.36599,46907788.6,54034.0,23741382.0,-10.082794879984283,57.85856700462393,0.47972047344578644,0.19185652655421342,-0.03166884319886054,-0.04862588758350179,0.016957044384641247,0.07873000000000002,0.0688107142857143,719625746.0199986,0.08689999999999998,25.38627565178664,-27.25709372312985,72.74290627687016,79.87956424423732,0.3746699999999999,0.36874812233051135,0.33863571428571426,0.3496679518800502,0.33578849999999993,0.3594287163921578,189708.0,34315220.866666645,416216.0,40109288.32857143
2021-06-06,0.35389,0.37698,0.33505,0.35291,45623983.1,48894.0,20599035.0,0.35728333333333323,0.3549442857142857,0.326239,0.35687953058262784,0.35109384793252824,0.358249629518297,67.31485822866027,0.44879451006959903,0.20368348993040097,-0.025912138124100925,-0.04088253840784232,0.014970400283741393,0.04192999999999997,0.06847285714285714,616615064.5199986,0.056999999999999995,66.01279518298995,-36.798185552892846,63.201814447107154,67.93755946821277,-0.27692220746559126,0.36503,0.43078,0.3362,0.35295,57386698.4,64434.0,29011395.7,-3.3093170424348775,61.850667755028,0.461497273294611,0.19903472670538902,-0.028622142059881173,-0.044625138478777665,0.016002996418896492,0.09458,0.07209857142857143,662239047.6199986,0.019419999999999993,42.077932533612426,-32.13204231933905,67.86795768066095,76.23462559348013,0.37532999999999994,0.36084906116525567,0.34879142857142853,0.35048846391003763,0.330266,0.35881169578338085,208825.0,29901341.999999985,383469.0,33132601.385714285
2021-06-07,0.35304,0.37373,0.30115,0.30655,42025373.5,44215.0,20376132.8,0.33746999999999994,0.3519157142857143,0.3161195,0.33171476529131394,0.33995788594939613,0.35332585527845917,52.571549826264544,0.4035437140310444,0.2286952859689556,-0.02719185426416937,-0.03814440157910773,0.01095254731493836,0.07258000000000003,0.06688785714285715,574589691.0199986,-0.00717000000000001,6.752333194038163,-67.31258264672974,32.68741735327026,54.58572982701279,-13.1684794924088,0.35389,0.37698,0.33505,0.35291,45623983.1,48894.0,20599035.0,-0.27692220746559126,67.31485822866027,0.44879451006959903,0.20368348993040097,-0.025912138124100925,-0.04088253840784232,0.014970400283741393,0.04192999999999997,0.06847285714285714,616615064.5199986,0.056999999999999995,66.01279518298995,-36.798185552892846,63.201814447107154,67.93755946821277,0.35728333333333323,0.35687953058262784,0.3549442857142857,0.35109384793252824,0.326239,0.358249629518297,167362.0,24450604.23333332,385337.0,32529366.471428573
2021-06-08,0.30647,0.32463,0.26002,0.31507,58447850.1,53539.0,29198182.0,0.32484333333333326,0.35021285714285716,0.3154855,0.32339238264565695,0.3337359144620471,0.3496824404900345,54.76606792772745,0.4027383225994863,0.22823267740051364,-0.027204944068904835,-0.035956510077067155,0.00875156600816232,0.06461,0.067275,633037541.1199986,0.03321000000000002,12.891898670679701,-63.427751882395114,36.572248117604886,44.15382663932744,2.806147420628445,0.35304,0.37373,0.30115,0.30655,42025373.5,44215.0,20376132.8,-13.1684794924088,52.571549826264544,0.4035437140310444,0.2286952859689556,-0.02719185426416937,-0.03814440157910773,0.01095254731493836,0.07258000000000003,0.06688785714285715,574589691.0199986,-0.00717000000000001,6.752333194038163,-67.31258264672974,32.68741735327026,54.58572982701279,0.33746999999999994,0.33171476529131394,0.3519157142857143,0.33995788594939613,0.3161195,0.35332585527845917,157543.0,23328854.499999985,384738.0,31870645.157142855
2021-06-09,0.31392,0.33656,0.29307,0.31454,48012883.2,46157.0,23664840.5,0.3120533333333333,0.34500857142857144,0.31373850000000003,0.31896619132282844,0.3289369358465353,0.3463355413957455,47.0653685674548,0.39951205653726335,0.2279649434627367,-0.0269474509635676,-0.03415469825436725,0.007207247290799648,0.04349000000000003,0.06486714285714286,585024657.9199985,0.004699999999999982,-5.6936407519563526,-63.699226553296114,36.30077344670388,35.186812972526354,0.1975025484199826,0.30647,0.32463,0.26002,0.31507,58447850.1,53539.0,29198182.0,2.806147420628445,54.76606792772745,0.4027383225994863,0.22823267740051364,-0.027204944068904835,-0.035956510077067155,0.00875156600816232,0.06461,0.067275,633037541.1199986,0.03321000000000002,12.891898670679701,-63.427751882395114,36.572248117604886,44.15382663932744,0.32484333333333326,0.32339238264565695,0.35021285714285716,0.3337359144620471,0.3154855,0.3496824404900345,146648.0,23391116.599999983,400790.0,28875772.585714284
2021-06-10,0.31462,0.32025,0.27976,0.2861,35156381.0,33775.0,17458383.0,0.3052366666666666,0.32772999999999997,0.313449,0.30253309566141423,0.3182277018849015,0.3405988231675793,48.43973661608932,0.39957142544313873,0.2273265745568612,-0.028707335841567594,-0.033065225771807316,0.004357889930239722,0.04048999999999997,0.06446214285714287,549868276.9199985,-0.041649999999999965,-3.3151971883342846,-78.26665983711518,21.73334016288481,31.535453909064532,-9.064903693344348,0.31392,0.33656,0.29307,0.31454,48012883.2,46157.0,23664840.5,0.1975025484199826,47.0653685674548,0.39951205653726335,0.2279649434627367,-0.0269474509635676,-0.03415469825436725,0.007207247290799648,0.04349000000000003,0.06486714285714286,585024657.9199985,0.004699999999999982,-5.6936407519563526,-63.699226553296114,36.30077344670388,35.186812972526354,0.3120533333333333,0.31896619132282844,0.34500857142857144,0.3289369358465353,0.31373850000000003,0.3463355413957455,143911.0,24413051.76666665,401630.0,26220316.61428571
2021-06-11,0.28634,0.305,0.2683,0.27147,26600352.6,32309.0,11914952.5,0.29070333333333326,0.31422714285714287,0.31460150000000003,0.2870015478307071,0.30653827641367615,0.3340151257230479,43.21154278736463,0.397620829714918,0.23158217028508205,-0.030926079425851738,-0.0326373965026162,0.0017113170767644598,0.03670000000000001,0.06027428571428572,523267924.3199985,-0.055520000000000014,-13.467423179905646,-93.59906082289802,6.400939177101975,21.478350928896898,-5.193127051756651,0.31462,0.32025,0.27976,0.2861,35156381.0,33775.0,17458383.0,-9.064903693344348,48.43973661608932,0.39957142544313873,0.2273265745568612,-0.028707335841567594,-0.033065225771807316,0.004357889930239722,0.04048999999999997,0.06446214285714287,549868276.9199985,-0.041649999999999965,-3.3151971883342846,-78.26665983711518,21.73334016288481,31.535453909064532,0.3052366666666666,0.30253309566141423,0.32772999999999997,0.3182277018849015,0.313449,0.3405988231675793,133471.0,23440468.499999985,345048.0,23435621.57142857
2021-06-12,0.27147,0.27543,0.25246,0.25456,31004681.2,32834.0,14272488.9,0.27070999999999995,0.3001714285714286,0.3167005,0.27078077391535355,0.29354370731025714,0.32644797089228145,45.392249527410215,0.39046609245694974,0.24293490754305022,-0.03366092320925557,-0.03284210184394407,-0.0008188213653114937,0.02296999999999999,0.055905,492263243.1199985,-0.09641,-9.68565954729298,-98.8736322677537,1.1263677322462942,9.753549024077703,-6.229049250377567,0.28634,0.305,0.2683,0.27147,26600352.6,32309.0,11914952.5,-5.193127051756651,43.21154278736463,0.397620829714918,0.23158217028508205,-0.030926079425851738,-0.0326373965026162,0.0017113170767644598,0.03670000000000001,0.06027428571428572,523267924.3199985,-0.055520000000000014,-13.467423179905646,-93.59906082289802,6.400939177101975,21.478350928896898,0.29070333333333326,0.2870015478307071,0.31422714285714287,0.30653827641367615,0.31460150000000003,0.3340151257230479,112241.0,17679391.999999985,323323.0,21746131.64285714
2021-06-13,0.25478,0.28802,0.24864,0.28271,29612581.7,32758.0,15177250.1,0.26957999999999993,0.29014285714285715,0.316478,0.2767453869576768,0.29083528048269286,0.3222824498549213,45.42356870550927,0.3906445200676549,0.2423114799323451,-0.033174422775064716,-0.0329085660301682,-0.00026585674489651434,0.03938,0.05385,521875824.8199985,-0.12434,-8.7561321972631,-82.0929254704089,17.907074529591092,8.47812714631313,10.962398932412281,0.27147,0.27543,0.25246,0.25456,31004681.2,32834.0,14272488.9,-6.229049250377567,45.392249527410215,0.39046609245694974,0.24293490754305022,-0.03366092320925557,-0.03284210184394407,-0.0008188213653114937,0.02296999999999999,0.055905,492263243.1199985,-0.09641,-9.68565954729298,-98.8736322677537,1.1263677322462942,9.753549024077703,0.27070999999999995,0.27078077391535355,0.3001714285714286,0.29354370731025714,0.3167005,0.32644797089228145,98918.0,14548608.133333318,291723.0,19640573.52857143
2021-06-14,0.28253,0.30027,0.27796,0.29139,35615612.5,31258.0,17044646.5,0.27621999999999997,0.2879771428571428,0.317093,0.2840676934788384,0.29097396036201967,0.31934031177350025,43.669475590222156,0.3901498286660141,0.24403617133398595,-0.031722783713803326,-0.03267140956689523,0.0009486258530919042,0.022309999999999997,0.051807142857142864,557491437.3199985,-0.0746,-11.093821510297486,-77.53074739829707,22.469252601702923,13.834231621180114,3.135950164584284,0.25478,0.28802,0.24864,0.28271,29612581.7,32758.0,15177250.1,10.962398932412281,45.42356870550927,0.3906445200676549,0.2423114799323451,-0.033174422775064716,-0.0329085660301682,-0.00026585674489651434,0.03938,0.05385,521875824.8199985,-0.12434,-8.7561321972631,-82.0929254704089,17.907074529591092,8.47812714631313,0.26957999999999993,0.2767453869576768,0.29014285714285715,0.29083528048269286,0.316478,0.3222824498549213,97901.0,13788230.499999985,275587.0,18866032.82857143
2021-06-15,0.29137,0.2995,0.27861,0.2903,52480507.9,31091.0,27434300.6,0.2881333333333333,0.28443857142857143,0.3149315,0.2871838467394192,0.29080547027151477,0.31657456779507165,43.61935237035234,0.38849697281520584,0.2413660271847941,-0.030310898025193378,-0.03219930725855486,0.0018884092333614835,0.020889999999999964,0.051195000000000004,505010929.4199985,-0.06264999999999998,-11.220526621609228,-78.10364764007149,21.89635235992852,20.75755983040752,-0.3672306689089527,0.28253,0.30027,0.27796,0.29139,35615612.5,31258.0,17044646.5,3.135950164584284,43.669475590222156,0.3901498286660141,0.24403617133398595,-0.031722783713803326,-0.03267140956689523,0.0009486258530919042,0.022309999999999997,0.051807142857142864,557491437.3199985,-0.0746,-11.093821510297486,-77.53074739829707,22.469252601702923,13.834231621180114,0.27621999999999997,0.2840676934788384,0.2879771428571428,0.29097396036201967,0.317093,0.31934031177350025,96850.0,15498128.499999985,262630.0,18390106.214285713
2021-06-16,0.28963,0.31083,0.28001,0.29433,57924008.7,38930.0,35309109.2,0.2920066666666666,0.28155142857142856,0.31485250000000004,0.2907569233697096,0.29168660270363606,0.3144560375288743,39.415458214979814,0.3885073190798314,0.2411976809201687,-0.02853781495833152,-0.03146700879851019,0.0029291938401786732,0.030820000000000014,0.05008571428571429,562934938.1199986,-0.05858000000000002,-16.138131464227722,-75.98549353516242,24.014506464837577,22.793370475489684,1.622760073196831,0.29137,0.2995,0.27861,0.2903,52480507.9,31091.0,27434300.6,-0.3672306689089527,43.61935237035234,0.38849697281520584,0.2413660271847941,-0.030310898025193378,-0.03219930725855486,0.0018884092333614835,0.020889999999999964,0.051195000000000004,505010929.4199985,-0.06264999999999998,-11.220526621609228,-78.10364764007149,21.89635235992852,20.75755983040752,0.2881333333333333,0.2871838467394192,0.28443857142857143,0.29080547027151477,0.3149315,0.31657456779507165,95107.0,19885399.06666665,240182.0,18138123.157142855
2021-06-17,0.29411,0.31,0.2805,0.29256,63027296.7,28073.0,46476895.4,0.2923966666666666,0.28247428571428573,0.31379450000000003,0.29165846168485476,0.29190495202772704,0.31237070062136246,23.155920281359897,0.3881226337895016,0.23946636621049844,-0.02696462663006849,-0.030566532364821854,0.003601905734753365,0.02949999999999997,0.04564142857142857,499907641.4199986,-0.013990000000000002,-28.12676575359293,-75.88668057538158,24.113319424618417,23.34139274979485,-0.5270137023562599,0.28963,0.31083,0.28001,0.29433,57924008.7,38930.0,35309109.2,1.622760073196831,39.415458214979814,0.3885073190798314,0.2411976809201687,-0.02853781495833152,-0.03146700879851019,0.0029291938401786732,0.030820000000000014,0.05008571428571429,562934938.1199986,-0.05858000000000002,-16.138131464227722,-75.98549353516242,24.014506464837577,22.793370475489684,0.2920066666666666,0.2907569233697096,0.28155142857142856,0.29168660270363606,0.31485250000000004,0.3144560375288743,101279.0,26596018.76666665,232955.0,19801590.114285715
2021-06-18,0.2926,0.29632,0.255,0.26762,53814751.5,27315.0,34540021.6,0.28483666666666657,0.28192428571428574,0.31308250000000004,0.27963923084242737,0.28583371402079527,0.30810872913361365,25.049459747374826,0.3889554169834495,0.2372095830165506,-0.027414298149177896,-0.029936085521693065,0.002521787372515169,0.04131999999999997,0.04296928571428571,446092889.9199986,-0.04744999999999999,-26.87778354599851,-89.5794443834413,10.420555616558705,19.516127168671574,-8.537252221462747,0.29411,0.31,0.2805,0.29256,63027296.7,28073.0,46476895.4,-0.5270137023562599,23.155920281359897,0.3881226337895016,0.23946636621049844,-0.02696462663006849,-0.030566532364821854,0.003601905734753365,0.02949999999999997,0.04564142857142857,499907641.4199986,-0.013990000000000002,-28.12676575359293,-75.88668057538158,24.113319424618417,23.34139274979485,0.2923966666666666,0.29165846168485476,0.28247428571428573,0.29190495202772704,0.31379450000000003,0.31237070062136246,98094.0,36406768.39999998,227253.0,23947091.885714285
2021-06-19,0.26748,0.27639,0.25581,0.25588,46589227.8,17894.0,35072573.4,0.27201999999999993,0.28211285714285717,0.3103845,0.2677596154212137,0.27834528551559645,0.3031345644542218,25.215748353163463,0.39046386970017555,0.23030513029982444,-0.028390715457321358,-0.029627011508818725,0.0012362960514973667,0.020580000000000043,0.03768357142857142,399503662.1199986,-0.05865999999999999,-27.502479104689048,-94.35873461118904,5.641265388810969,13.391713476662707,-4.33677284282937,0.2926,0.29632,0.255,0.26762,53814751.5,27315.0,34540021.6,-8.537252221462747,25.049459747374826,0.3889554169834495,0.2372095830165506,-0.027414298149177896,-0.029936085521693065,0.002521787372515169,0.04131999999999997,0.04296928571428571,446092889.9199986,-0.04744999999999999,-26.87778354599851,-89.5794443834413,10.420555616558705,19.516127168671574,0.28483666666666657,0.27963923084242737,0.28192428571428574,0.28583371402079527,0.31308250000000004,0.30810872913361365,94318.0,38775342.066666655,222259.0,27179244.614285715
2021-06-20,0.25567,0.26364,0.23609,0.26132,44721066.5,24250.0,30168294.2,0.2616066666666666,0.27905714285714284,0.307063,0.2645398077106068,0.27408896413669737,0.2991522249823912,27.242458877900916,0.3895831324334888,0.22454286756651115,-0.028398213741965717,-0.029381251955448127,0.0009830382134824109,0.02754999999999999,0.036656428571428576,444224728.6199986,-0.024780000000000024,-25.95279249667054,-81.66957279860506,18.330427201394944,11.464082735588216,2.2098799233386743,0.26748,0.27639,0.25581,0.25588,46589227.8,17894.0,35072573.4,-4.33677284282937,25.215748353163463,0.39046386970017555,0.23030513029982444,-0.028390715457321358,-0.029627011508818725,0.0012362960514973667,0.020580000000000043,0.03768357142857142,399503662.1199986,-0.05865999999999999,-27.502479104689048,-94.35873461118904,5.641265388810969,13.391713476662707,0.27201999999999993,0.2677596154212137,0.28211285714285717,0.27834528551559645,0.3103845,0.3031345644542218,73282.0,38696496.79999998,207319.0,30150685.257142853
2021-06-21,0.26118,0.26344,0.19,0.19472,64250726.4,37478.0,40029006.7,0.23730666666666658,0.2652471428571429,0.3004495,0.2296299038553034,0.25424672310252305,0.289206298793592,24.752788188016424,0.39636016555585357,0.2045388344441464,-0.03339328261179292,-0.030183658086717087,-0.0032096245250758312,0.07344,0.036717857142857135,379974002.2199986,-0.07674999999999998,-36.48018267819278,-96.77947598253274,3.2205240174672496,9.06407220255773,-25.44605253082166,0.25567,0.26364,0.23609,0.26132,44721066.5,24250.0,30168294.2,2.2098799233386743,27.242458877900916,0.3895831324334888,0.22454286756651115,-0.028398213741965717,-0.029381251955448127,0.0009830382134824109,0.02754999999999999,0.036656428571428576,444224728.6199986,-0.024780000000000024,-25.95279249667054,-81.66957279860506,18.330427201394944,11.464082735588216,0.2616066666666666,0.2645398077106068,0.27905714285714284,0.27408896413669737,0.307063,0.2991522249823912,69459.0,33260296.399999987,198811.0,32292262.985714287
2021-06-22,0.19495,0.21069,0.15869,0.1878,65967313.0,37202.0,43729027.2,0.21461333333333324,0.2506042857142857,0.292291,0.20871495192765172,0.23763504232689228,0.27954855605134515,21.057897848728786,0.39742342914983797,0.18715857085016208,-0.037478270670924796,-0.03164258060355863,-0.005835690067366166,0.05199999999999999,0.03581714285714286,314006689.2199986,-0.06676000000000001,-40.39419811470467,-83.63411480294599,16.365885197054023,12.63894547197208,-3.6676070787381465,0.26118,0.26344,0.19,0.19472,64250726.4,37478.0,40029006.7,-25.44605253082166,24.752788188016424,0.39636016555585357,0.2045388344441464,-0.03339328261179292,-0.030183658086717087,-0.0032096245250758312,0.07344,0.036717857142857135,379974002.2199986,-0.07674999999999998,-36.48018267819278,-96.77947598253274,3.2205240174672496,9.06407220255773,0.23730666666666658,0.2296299038553034,0.2652471428571429,0.25424672310252305,0.3004495,0.289206298793592,79622.0,35089958.09999999,205031.0,35575743.01428571
2021-06-23,0.18789,0.21361,0.1811,0.20455,74706898.6,26661.0,52474524.8,0.19568999999999992,0.23777857142857145,0.282166,0.20663247596382586,0.22936378174516922,0.2724058364274075,26.705917234952764,0.3794766516374416,0.18485534836255835,-0.03891547475519139,-0.033097159433885186,-0.005818315321306201,0.03250999999999998,0.035032857142857136,388713587.8199986,-0.07816000000000001,-34.96852546575951,-71.61426095568208,28.38573904431791,15.990716086279738,8.866890201713773,0.19495,0.21069,0.15869,0.1878,65967313.0,37202.0,43729027.2,-3.6676070787381465,21.057897848728786,0.39742342914983797,0.18715857085016208,-0.037478270670924796,-0.03164258060355863,-0.005835690067366166,0.05199999999999999,0.03581714285714286,314006689.2199986,-0.06676000000000001,-40.39419811470467,-83.63411480294599,16.365885197054023,12.63894547197208,0.21461333333333324,0.20871495192765172,0.2506042857142857,0.23763504232689228,0.292291,0.27954855605134515,98930.0,37975442.69999999,211142.0,37903561.1
2021-06-24,0.20448,0.21446,0.198,0.21317,58963625.3,17268.0,41728541.6,0.20183999999999994,0.22643714285714284,0.274525,0.20990123798191293,0.2253153363088769,0.26676432819622586,33.1391316410043,0.36804759653771435,0.1810024034622857,-0.03891037282970003,-0.03425980211304816,-0.0046505707166518695,0.016460000000000002,0.033316428571428566,447677213.11999863,-0.07821999999999998,-25.491087032506123,-64.19087682397792,35.809123176022084,26.853582472464684,4.249804381846637,0.18789,0.21361,0.1811,0.20455,74706898.6,26661.0,52474524.8,8.866890201713773,26.705917234952764,0.3794766516374416,0.18485534836255835,-0.03891547475519139,-0.033097159433885186,-0.005818315321306201,0.03250999999999998,0.035032857142857136,388713587.8199986,-0.07816000000000001,-34.96852546575951,-71.61426095568208,28.38573904431791,15.990716086279738,0.19568999999999992,0.20663247596382586,0.23777857142857145,0.22936378174516922,0.282166,0.2724058364274075,101341.0,45410852.89999998,198873.0,40355763.32857143
2021-06-25,0.21327,0.21674,0.18511,0.1869,46484058.4,23617.0,31754161.5,0.20153999999999994,0.21490571428571428,0.2662225,0.19840061899095646,0.2157115022316577,0.25915820170134723,31.446623667237063,0.35991268504455176,0.17253231495544818,-0.04055856507805072,-0.03551955470604867,-0.005039010372002051,0.03162999999999999,0.03295428571428571,401193154.71999866,-0.10339999999999999,-31.152613548458387,-81.45786775338503,18.54213224661497,27.578998155651664,-12.364608243072151,0.20448,0.21446,0.198,0.21317,58963625.3,17268.0,41728541.6,4.249804381846637,33.1391316410043,0.36804759653771435,0.1810024034622857,-0.03891037282970003,-0.03425980211304816,-0.0046505707166518695,0.016460000000000002,0.033316428571428566,447677213.11999863,-0.07821999999999998,-25.491087032506123,-64.19087682397792,35.809123176022084,26.853582472464684,0.20183999999999994,0.20990123798191293,0.22643714285714284,0.2253153363088769,0.274525,0.26676432819622586,81131.0,45977364.533333324,188068.0,39677427.071428575
2021-06-26,0.18674,0.19478,0.17433,0.18698,47886246.2,21826.0,33909596.8,0.1956833333333333,0.20506285714285716,0.257926,0.19269030949547822,0.20852862667374328,0.2522840872535999,33.99185143073716,0.3486340964064526,0.16721790359354738,-0.04138129615492886,-0.03669190299582471,-0.0046893931591041466,0.020449999999999996,0.03277428571428571,449079400.91999865,-0.10734999999999997,-26.547768698931485,-81.40528460628367,18.59471539371632,24.315323605451137,0.12852093820285854,0.21327,0.21674,0.18511,0.1869,46484058.4,23617.0,31754161.5,-12.364608243072151,31.446623667237063,0.35991268504455176,0.17253231495544818,-0.04055856507805072,-0.03551955470604867,-0.005039010372002051,0.03162999999999999,0.03295428571428571,401193154.71999866,-0.10339999999999999,-31.152613548458387,-81.45786775338503,18.54213224661497,27.578998155651664,0.20153999999999994,0.19840061899095646,0.21490571428571428,0.2157115022316577,0.2662225,0.25915820170134723,67546.0,41985742.63333332,184370.0,39279447.057142854
2021-06-27,0.18671,0.19816,0.17874,0.19229,50387142.0,21986.0,32548962.3,0.18872333333333327,0.19520142857142855,0.252213,0.19249015474773912,0.20446897000530745,0.24657036465801896,25.98278793030171,0.3444071062392885,0.16001889376071154,-0.04113071456382286,-0.037579665309424345,-0.0035510492543985167,0.019419999999999993,0.03134857142857143,499466542.91999865,-0.10027,-31.983304446252347,-77.91507821743132,22.08492178256868,19.740589807633338,2.988591934015319,0.18674,0.19478,0.17433,0.18698,47886246.2,21826.0,33909596.8,0.12852093820285854,33.99185143073716,0.3486340964064526,0.16721790359354738,-0.04138129615492886,-0.03669190299582471,-0.0046893931591041466,0.020449999999999996,0.03277428571428571,449079400.91999865,-0.10734999999999997,-26.547768698931485,-81.40528460628367,18.59471539371632,24.315323605451137,0.1956833333333333,0.19269030949547822,0.20506285714285716,0.20852862667374328,0.257926,0.2522840872535999,62711.0,35797433.29999999,188302.0,39113307.54285715
2021-06-28,0.19239,0.216,0.18872,0.20999,48025102.9,22895.0,28931482.4,0.19641999999999993,0.1973828571428571,0.246959,0.20124007737386956,0.20584922750398058,0.2430865204048743,29.36733245462841,0.3359930168935927,0.15792498310640735,-0.03905369805154521,-0.03787447185784852,-0.0011792261936966891,0.02728,0.03170357142857142,547491645.8199986,-0.057630000000000015,-27.935069837674586,-66.28105692125673,33.718943078743266,24.7995267516761,9.148084619782736,0.18671,0.19816,0.17874,0.19229,50387142.0,21986.0,32548962.3,2.988591934015319,25.98278793030171,0.3444071062392885,0.16001889376071154,-0.04113071456382286,-0.037579665309424345,-0.0035510492543985167,0.019419999999999993,0.03134857142857143,499466542.91999865,-0.10027,-31.983304446252347,-77.91507821743132,22.08492178256868,19.740589807633338,0.18872333333333327,0.19249015474773912,0.19520142857142855,0.20446897000530745,0.252213,0.24657036465801896,67429.0,32737573.53333332,186038.0,39453402.98571428
2021-06-29,0.21068,0.23707,0.20896,0.2231,40342851.7,19599.0,24632305.5,0.2084599999999999,0.20242571428571426,0.242387,0.2121700386869348,0.21016192062798542,0.24118304227107676,33.94495412844036,0.3260372913701667,0.15873670862983333,-0.03593553755843257,-0.03748668499796533,0.0015511474395327601,0.028109999999999996,0.032219285714285714,587834497.5199987,-0.032780000000000004,-23.148467102996907,-57.66399369002235,42.33600630997765,32.713290390429876,5.895196506550212,0.19239,0.216,0.18872,0.20999,48025102.9,22895.0,28931482.4,9.148084619782736,29.36733245462841,0.3359930168935927,0.15792498310640735,-0.03905369805154521,-0.03787447185784852,-0.0011792261936966891,0.02728,0.03170357142857142,547491645.8199986,-0.057630000000000015,-27.935069837674586,-66.28105692125673,33.718943078743266,24.7995267516761,0.19641999999999993,0.20124007737386956,0.1973828571428571,0.20584922750398058,0.246959,0.2430865204048743,66707.0,31796680.499999985,171455.0,37868042.37142857
2021-06-30,0.22309,0.2349,0.2041,0.22804,45608822.4,24528.0,25717192.6,0.22037666666666658,0.20578142857142856,0.23948399999999997,0.22010501934346738,0.21463144047098906,0.23993132395954564,34.2309339169323,0.32074248979773434,0.1582255102022656,-0.03268893845347609,-0.03652713568906748,0.003838197235591388,0.030799999999999994,0.03221785714285714,633443319.9199986,-0.033280000000000004,-22.52233887133489,-54.166942039521516,45.833057960478484,40.62933578306647,2.218835447577203,0.21068,0.23707,0.20896,0.2231,40342851.7,19599.0,24632305.5,5.895196506550212,33.94495412844036,0.3260372913701667,0.15873670862983333,-0.03593553755843257,-0.03748668499796533,0.0015511474395327601,0.028109999999999996,0.032219285714285714,587834497.5199987,-0.032780000000000004,-23.148467102996907,-57.66399369002235,42.33600630997765,32.713290390429876,0.2084599999999999,0.2121700386869348,0.20242571428571426,0.21016192062798542,0.242387,0.24118304227107676,64480.0,28704250.06666665,153852.0,35139939.27142857
2021-07-01,0.22812,0.25476,0.212,0.25016,65480958.8,42839.0,36371421.5,0.2337666666666666,0.21106571428571427,0.2384185,0.23513250967173369,0.22351358035324181,0.24090548358244607,40.804198837511926,0.3184607812676168,0.1583762187323832,-0.028008224756390865,-0.034823353502532156,0.006815128746141291,0.04275999999999999,0.03316499999999999,698924278.7199986,0.05543999999999999,-14.492753623188403,-33.53919930247765,66.46080069752234,51.5432883226595,9.661581623706823,0.22309,0.2349,0.2041,0.22804,45608822.4,24528.0,25717192.6,2.218835447577203,34.2309339169323,0.32074248979773434,0.1582255102022656,-0.03268893845347609,-0.03652713568906748,0.003838197235591388,0.030799999999999994,0.03221785714285714,633443319.9199986,-0.033280000000000004,-22.52233887133489,-54.166942039521516,45.833057960478484,40.62933578306647,0.22037666666666658,0.22010501934346738,0.20578142857142856,0.21463144047098906,0.23948399999999997,0.23993132395954564,67022.0,26426993.49999999,151719.0,31317463.24285714
2021-07-02,0.24942,0.25475,0.23057,0.25092,50665629.1,31514.0,28605597.4,0.24303999999999992,0.22021142857142856,0.23823650000000002,0.24302625483586682,0.23036518526493138,0.24185924705078454,45.95367319247915,0.3181406784758013,0.15833232152419877,-0.023961190096208507,-0.03265092082126743,0.008689730725058922,0.02417999999999998,0.03194071428571428,749589907.8199986,0.06311999999999998,-6.240191316045152,-21.63976210705186,78.36023789294813,63.551365516983005,0.6013952369497128,0.22812,0.25476,0.212,0.25016,65480958.8,42839.0,36371421.5,9.661581623706823,40.804198837511926,0.3184607812676168,0.1583762187323832,-0.028008224756390865,-0.034823353502532156,0.006815128746141291,0.04275999999999999,0.03316499999999999,698924278.7199986,0.05543999999999999,-14.492753623188403,-33.53919930247765,66.46080069752234,51.5432883226595,0.2337666666666666,0.23513250967173369,0.21106571428571427,0.22351358035324181,0.2384185,0.24090548358244607,86966.0,28906973.199999988,177290.0,30552160.371428575
2021-07-03,0.25092,0.292,0.24805,0.26797,58690955.0,44651.0,33068322.3,0.2563499999999999,0.23178142857142858,0.23749950000000003,0.25549812741793343,0.23976638894869856,0.24434598542690028,52.855860537629326,0.3159349172082328,0.15906408279176726,-0.019157260489556127,-0.029952188754925172,0.010794928265369045,0.04394999999999999,0.033609999999999994,808280862.8199986,0.06341999999999998,4.724871033296862,-18.02565448953567,81.97434551046433,75.5984613669783,6.794994420532445,0.24942,0.25475,0.23057,0.25092,50665629.1,31514.0,28605597.4,0.6013952369497128,45.95367319247915,0.3181406784758013,0.15833232152419877,-0.023961190096208507,-0.03265092082126743,0.008689730725058922,0.02417999999999998,0.03194071428571428,749589907.8199986,0.06311999999999998,-6.240191316045152,-21.63976210705186,78.36023789294813,63.551365516983005,0.24303999999999992,0.24302625483586682,0.22021142857142856,0.23036518526493138,0.23823650000000002,0.24185924705078454,98881.0,30231403.833333325,185187.0,30102365.5
2021-07-04,0.26797,0.27995,0.2601,0.27594,47856637.3,28176.0,31648219.5,0.26494333333333325,0.24373142857142854,0.236727,0.2657190637089667,0.24880979171152395,0.24735493919576693,53.41269841269842,0.31320760727020286,0.16024639272979713,-0.014539398142582843,-0.02686963063245671,0.012330232489873867,0.01984999999999998,0.03305999999999999,856137500.1199986,0.06277000000000002,5.594673197612132,-12.047108243942665,87.95289175605734,82.76249171982329,2.974213531365464,0.25092,0.292,0.24805,0.26797,58690955.0,44651.0,33068322.3,6.794994420532445,52.855860537629326,0.3159349172082328,0.15906408279176726,-0.019157260489556127,-0.029952188754925172,0.010794928265369045,0.04394999999999999,0.033609999999999994,808280862.8199986,0.06341999999999998,4.724871033296862,-18.02565448953567,81.97434551046433,75.5984613669783,0.2563499999999999,0.25549812741793343,0.23178142857142858,0.23976638894869856,0.23749950000000003,0.24434598542690028,119004.0,32681780.39999999,208012.0,29982183.42857143
2021-07-05,0.27588,0.29,0.24586,0.27501,44700419.1,30310.0,25373210.1,0.27297333333333323,0.25301999999999997,0.23596250000000002,0.27036453185448334,0.25535984378364296,0.24998875451045577,77.02820978926815,0.31046849152875,0.16145650847125007,-0.010829911709568624,-0.023661686847879095,0.01283177513831047,0.044139999999999985,0.030967142857142842,811437081.0199986,0.08810999999999997,41.23356614626128,-12.744730327807371,87.25526967219263,85.72750231290479,-0.3153545019573863,0.26797,0.27995,0.2601,0.27594,47856637.3,28176.0,31648219.5,2.974213531365464,53.41269841269842,0.31320760727020286,0.16024639272979713,-0.014539398142582843,-0.02686963063245671,0.012330232489873867,0.01984999999999998,0.03305999999999999,856137500.1199986,0.06277000000000002,5.594673197612132,-12.047108243942665,87.95289175605734,82.76249171982329,0.26494333333333325,0.2657190637089667,0.24373142857142854,0.24880979171152395,0.236727,0.24735493919576693,104341.0,31107379.733333323,214202.0,29853505.88571429
2021-07-06,0.27525,0.29666,0.2731,0.28923,45075138.2,28839.0,25935792.6,0.2800599999999999,0.26246714285714284,0.23570750000000001,0.27979726592724163,0.2638273828377322,0.2537260159856505,82.54508117820701,0.3094028746673858,0.16201212533261422,-0.006665842148551038,-0.020262517908013485,0.013596675759462447,0.02355999999999997,0.02893571428571428,856512219.2199986,0.10224999999999998,54.00958466453674,-6.07373497915474,93.92626502084525,89.71147548303175,5.07901907356948,0.27588,0.29,0.24586,0.27501,44700419.1,30310.0,25373210.1,-0.3153545019573863,77.02820978926815,0.31046849152875,0.16145650847125007,-0.010829911709568624,-0.023661686847879095,0.01283177513831047,0.044139999999999985,0.030967142857142842,811437081.0199986,0.08810999999999997,41.23356614626128,-12.744730327807371,87.25526967219263,85.72750231290479,0.27297333333333323,0.27036453185448334,0.25301999999999997,0.25535984378364296,0.23596250000000002,0.24998875451045577,103137.0,30029917.299999993,221617.0,29345181.271428574
2021-07-07,0.28905,0.29849,0.26973,0.27141,27549298.6,19241.0,14635559.2,0.2785499999999999,0.26866285714285715,0.23464999999999997,0.2756036329636208,0.26572303712829914,0.25541020493939803,71.3065646908859,0.305460919169872,0.16383908083012794,-0.0047489689352346875,-0.017159808113457728,0.01241083917822304,0.028759999999999952,0.028667857142857127,828962920.6199986,0.07912,32.686384747005604,-21.810567010309278,78.18943298969072,86.45698922757622,-6.102750389206016,0.27525,0.29666,0.2731,0.28923,45075138.2,28839.0,25935792.6,5.07901907356948,82.54508117820701,0.3094028746673858,0.16201212533261422,-0.006665842148551038,-0.020262517908013485,0.013596675759462447,0.02355999999999997,0.02893571428571428,856512219.2199986,0.10224999999999998,54.00958466453674,-6.07373497915474,93.92626502084525,89.71147548303175,0.2800599999999999,0.27979726592724163,0.26246714285714284,0.2638273828377322,0.23570750000000001,0.2537260159856505,87325.0,27652407.39999999,230857.0,29531393.714285713
2021-07-08,0.27138,0.28009,0.25231,0.26782,34840110.1,23747.0,21341581.3,0.27615333333333325,0.27118571428571425,0.23466,0.2717118164818104,0.2662472778462244,0.2565920901832649,67.99236188845722,0.3054905773994169,0.16382942260058314,-0.00347940765488447,-0.014423728021743076,0.010944320366858606,0.027780000000000027,0.029476428571428563,794122810.5199986,0.05782999999999999,25.636815687010372,-24.7019974226804,75.29800257731961,82.4712335292852,-1.3118136929766406,0.28905,0.29849,0.26973,0.27141,27549298.6,19241.0,14635559.2,-6.102750389206016,71.3065646908859,0.305460919169872,0.16383908083012794,-0.0047489689352346875,-0.017159808113457728,0.01241083917822304,0.028759999999999952,0.028667857142857127,828962920.6199986,0.07912,32.686384747005604,-21.810567010309278,78.18943298969072,86.45698922757622,0.2785499999999999,0.2756036329636208,0.26866285714285715,0.26572303712829914,0.23464999999999997,0.25541020493939803,78390.0,21981520.633333325,225570.0,27948303.228571434
2021-07-09,0.26758,0.28971,0.2552,0.28606,35235056.2,19395.0,20975394.7,0.2750966666666666,0.2762057142857143,0.236169,0.2788859082409052,0.2712004583846683,0.2593985577848587,84.46885428253614,0.3101202510552021,0.1622177489447979,-0.0009900430317623665,-0.011736991023746935,0.010746947991984569,0.03451000000000004,0.029682142857142848,829357866.7199986,0.06295999999999999,53.05510968432314,-10.011275773195877,89.98872422680412,81.1587199312715,6.906345765752297,0.27138,0.28009,0.25231,0.26782,34840110.1,23747.0,21341581.3,-1.3118136929766406,67.99236188845722,0.3054905773994169,0.16382942260058314,-0.00347940765488447,-0.014423728021743076,0.010944320366858606,0.027780000000000027,0.029476428571428563,794122810.5199986,0.05782999999999999,25.636815687010372,-24.7019974226804,75.29800257731961,82.4712335292852,0.27615333333333325,0.2717118164818104,0.27118571428571425,0.2662472778462244,0.23466,0.2565920901832649,71827.0,20637644.366666656,206478.0,25801183.2
2021-07-10,0.28643,0.31145,0.27688,0.28287,35609833.0,33970.0,18828887.3,0.27891666666666654,0.2783342857142857,0.2372465,0.2808779541204526,0.2741178437885012,0.2616339332339198,82.6267437904049,0.3133377627323826,0.16115523726761738,0.000717123473894743,-0.0092461681242186,0.009963291598113343,0.03456999999999999,0.030690714285714276,793748033.7199986,0.05483000000000002,51.28355973900951,-21.535679300730916,78.46432069926908,81.25034916779761,-1.242886569144296,0.26758,0.28971,0.2552,0.28606,35235056.2,19395.0,20975394.7,6.906345765752297,84.46885428253614,0.3101202510552021,0.1622177489447979,-0.0009900430317623665,-0.011736991023746935,0.010746947991984569,0.03451000000000004,0.029682142857142848,829357866.7199986,0.06295999999999999,53.05510968432314,-10.011275773195877,89.98872422680412,81.1587199312715,0.2750966666666666,0.2788859082409052,0.2762057142857143,0.2712004583846683,0.236169,0.2593985577848587,62383.0,18984178.39999999,194359.0,24711154.242857147
2021-07-11,0.28329,0.29586,0.27839,0.28901,15153578.0,17343.0,7500199.4,0.2859799999999999,0.2802014285714286,0.241961,0.2849439770602263,0.27784088284137587,0.26424117768783223,82.72431993503858,0.3186399036793802,0.1652820963206198,0.002536275311957714,-0.006889679436983337,0.009425954748941052,0.017469999999999986,0.030551428571428563,808901611.7199986,0.038849999999999996,50.29902751053097,-18.284038132485954,81.71596186751404,83.38966893119576,2.019132337886972,0.28643,0.31145,0.27688,0.28287,35609833.0,33970.0,18828887.3,-1.242886569144296,82.6267437904049,0.3133377627323826,0.16115523726761738,0.000717123473894743,-0.0092461681242186,0.009963291598113343,0.03456999999999999,0.030690714285714276,793748033.7199986,0.05483000000000002,51.28355973900951,-21.535679300730916,78.46432069926908,81.25034916779761,0.27891666666666654,0.2808779541204526,0.2783342857142857,0.2741178437885012,0.2372465,0.2616339332339198,77112.0,20381954.433333322,183678.0,22676949.24285714
2021-07-12,0.28873,0.29054,0.25697,0.26604,22509651.0,24074.0,10336211.3,0.2793066666666666,0.27891999999999995,0.24587299999999995,0.27549198853011314,0.2748906621310319,0.26441249409851486,68.3110094740281,0.31880940664808516,0.17293659335191475,0.0021002686288223993,-0.00509168982382219,0.007191958452644589,0.033570000000000044,0.031000714285714277,786391960.7199986,0.015120000000000022,26.691747226058382,-42.30088495575222,57.69911504424778,72.62646587034364,-7.858552973366118,0.28329,0.29586,0.27839,0.28901,15153578.0,17343.0,7500199.4,2.019132337886972,82.72431993503858,0.3186399036793802,0.1652820963206198,0.002536275311957714,-0.006889679436983337,0.009425954748941052,0.017469999999999986,0.030551428571428563,808901611.7199986,0.038849999999999996,50.29902751053097,-18.284038132485954,81.71596186751404,83.38966893119576,0.2859799999999999,0.2849439770602263,0.2802014285714286,0.27784088284137587,0.241961,0.26424117768783223,70708.0,15768160.46666666,172845.0,19227232.085714284
2021-07-13,0.26564,0.26603,0.23377,0.2387,29465481.8,28687.0,13999723.4,0.2645833333333333,0.2717014285714286,0.24758050000000004,0.2570959942650566,0.26584299659827393,0.26196368513675156,54.66284074605451,0.31799912447271744,0.17716187552728263,-0.00044623539504512477,-0.004162598938066777,0.0037163635430216523,0.03225999999999998,0.03129714285714285,756926478.9199986,-0.02926999999999999,6.992380098610496,-67.76897997205403,32.23102002794596,57.21536564656927,-10.14154494804999,0.28873,0.29054,0.25697,0.26604,22509651.0,24074.0,10336211.3,-7.858552973366118,68.3110094740281,0.31880940664808516,0.17293659335191475,0.0021002686288223993,-0.00509168982382219,0.007191958452644589,0.033570000000000044,0.031000714285714277,786391960.7199986,0.015120000000000022,26.691747226058382,-42.30088495575222,57.69911504424778,72.62646587034364,0.2793066666666666,0.27549198853011314,0.27891999999999995,0.2748906621310319,0.24587299999999995,0.26441249409851486,75387.0,12221765.99999999,166609.0,17079089.400000002
2021-07-14,0.23861,0.246,0.22043,0.24286,22708167.6,25659.0,12291274.6,0.2491999999999999,0.2676228571428571,0.24906499999999995,0.24997799713252827,0.26009724744870544,0.26014428655229904,54.45045045045045,0.31765737873882677,0.18047262126117314,-0.0021044224747698848,-0.003750963645407399,0.0016465411706375142,0.02557000000000001,0.030923571428571422,779634646.5199987,-0.033080000000000026,6.498859849149263,-68.96933132227251,31.030668677727498,40.320267916640425,1.781149155525755,0.26564,0.26603,0.23377,0.2387,29465481.8,28687.0,13999723.4,-10.14154494804999,54.66284074605451,0.31799912447271744,0.17716187552728263,-0.00044623539504512477,-0.004162598938066777,0.0037163635430216523,0.03225999999999998,0.03129714285714285,756926478.9199986,-0.02926999999999999,6.992380098610496,-67.76897997205403,32.23102002794596,57.21536564656927,0.2645833333333333,0.2570959942650566,0.2717014285714286,0.26584299659827393,0.24758050000000004,0.26196368513675156,70104.0,10612044.69999999,166457.0,15373936.657142857
2021-07-15,0.24281,0.24792,0.22005,0.22473,20883358.2,19741.0,9885747.9,0.23542999999999992,0.26146714285714284,0.25095649999999997,0.23735399856626416,0.2512554355865291,0.256771497356842,42.175866100547665,0.3142095308073362,0.18770346919266373,-0.004825857679969958,-0.003965942452319911,-0.0008599152276500474,0.027870000000000006,0.029859999999999998,758751288.3199986,-0.050279999999999964,-10.165494083786363,-94.87964989059078,5.120350109409209,22.794012938360904,-7.446151311725211,0.23861,0.246,0.22043,0.24286,22708167.6,25659.0,12291274.6,1.781149155525755,54.45045045045045,0.31765737873882677,0.18047262126117314,-0.0021044224747698848,-0.003750963645407399,0.0016465411706375142,0.02557000000000001,0.030923571428571422,779634646.5199987,-0.033080000000000026,6.498859849149263,-68.96933132227251,31.030668677727498,40.320267916640425,0.2491999999999999,0.24997799713252827,0.2676228571428571,0.26009724744870544,0.24906499999999995,0.26014428655229904,78420.0,12209069.766666658,172875.0,15039038.85714286
2021-07-16,0.22468,0.23001,0.2,0.20001,24167465.9,23779.0,12790192.0,0.22253333333333325,0.24917428571428574,0.25160799999999994,0.2186819992831321,0.2384440766898968,0.2513656404657142,36.3490105647021,0.3123031958906845,0.1909128041093154,-0.008875006542392039,-0.004947755270334336,-0.003927251272057702,0.03000999999999998,0.03027642857142857,734583822.4199986,-0.08922,-20.28933524629364,-99.9910273665321,0.008972633467906905,12.053330473534885,-10.980060530532313,0.24281,0.24792,0.22005,0.22473,20883358.2,19741.0,9885747.9,-7.446151311725211,42.175866100547665,0.3142095308073362,0.18770346919266373,-0.004825857679969958,-0.003965942452319911,-0.0008599152276500474,0.027870000000000006,0.029859999999999998,758751288.3199986,-0.050279999999999964,-10.165494083786363,-94.87964989059078,5.120350109409209,22.794012938360904,0.23542999999999992,0.23735399856626416,0.26146714285714284,0.2512554355865291,0.25095649999999997,0.256771497356842,74087.0,12058915.29999999,168869.0,13402491.228571428
2021-07-17,0.20024,0.22495,0.19522,0.21857,28057675.2,21346.0,15387881.3,0.2144366666666666,0.2399885714285714,0.252922,0.21862599964156604,0.2334755575174226,0.24824224613564616,36.860304287690184,0.309186244456036,0.19665775554396397,-0.010465707143521685,-0.0060513456449718065,-0.004414361498549879,0.029730000000000006,0.029260714285714282,762641497.6199987,-0.05284,-18.434899429040563,-79.91052224038546,20.089477759614542,8.4062668341639,9.154015181781855,0.22468,0.23001,0.2,0.20001,24167465.9,23779.0,12790192.0,-10.980060530532313,36.3490105647021,0.3123031958906845,0.1909128041093154,-0.008875006542392039,-0.004947755270334336,-0.003927251272057702,0.03000999999999998,0.03027642857142857,734583822.4199986,-0.08922,-20.28933524629364,-99.9910273665321,0.008972633467906905,12.053330473534885,0.22253333333333325,0.2186819992831321,0.24917428571428574,0.2384440766898968,0.25160799999999994,0.2513656404657142,69179.0,11655738.166666657,173253.0,12233176.557142857
2021-07-18,0.2185,0.259,0.21751,0.23281,49990023.0,48082.0,26066396.8,0.21712999999999993,0.23195999999999997,0.254063,0.225717999820783,0.23330916813806696,0.24677250840844175,38.898326898326886,0.3075167833233252,0.20060921667667472,-0.010456760809437804,-0.006932428677865006,-0.0035243321315727976,0.04149,0.030806428571428568,812631520.6199987,-0.03501000000000001,-15.630209465825917,-67.65895207777683,32.34104792222317,17.479832771768553,6.549199084668188,0.20024,0.22495,0.19522,0.21857,28057675.2,21346.0,15387881.3,9.154015181781855,36.860304287690184,0.309186244456036,0.19665775554396397,-0.010465707143521685,-0.0060513456449718065,-0.004414361498549879,0.029730000000000006,0.029260714285714282,762641497.6199987,-0.05284,-18.434899429040563,-79.91052224038546,20.089477759614542,8.4062668341639,0.2144366666666666,0.21862599964156604,0.2399885714285714,0.2334755575174226,0.252922,0.24824224613564616,64866.0,12687940.399999991,160629.0,11741604.271428572
2021-07-19,0.23331,0.23371,0.20757,0.22468,31341987.7,28215.0,17055485.6,0.22535333333333327,0.22605142857142854,0.254142,0.2251989999103915,0.2311518761035502,0.24466845998859016,37.50806651774634,0.3074074455385394,0.20087655446146055,-0.01097913321652949,-0.007741769585597904,-0.0032373636309315865,0.026139999999999997,0.02952071428571429,781289532.9199986,-0.06137999999999999,-18.301152685356893,-74.6537038630302,25.346296136969787,25.925607272935846,-3.6989413227036985,0.2185,0.259,0.21751,0.23281,49990023.0,48082.0,26066396.8,6.549199084668188,38.898326898326886,0.3075167833233252,0.20060921667667472,-0.010456760809437804,-0.006932428677865006,-0.0035243321315727976,0.04149,0.030806428571428568,812631520.6199987,-0.03501000000000001,-15.630209465825917,-67.65895207777683,32.34104792222317,17.479832771768553,0.21712999999999993,0.225717999820783,0.23195999999999997,0.23330916813806696,0.254063,0.24677250840844175,93207.0,18081490.033333324,191368.0,14393918.185714288
2021-07-20,0.22484,0.29292,0.21202,0.26,99126966.3,83916.0,48463894.1,0.23916333333333326,0.22909428571428572,0.25573999999999997,0.24259949995519575,0.23836390707766264,0.24612860665634348,43.4329364187823,0.30760757672947076,0.20387242327052918,-0.008445731162638026,-0.00788256190100593,-0.0005631692616320967,0.08090000000000003,0.03361642857142857,880416499.2199986,-0.02287,-10.106143899318877,-44.265680117009374,55.734319882990626,37.80722131406121,15.63778687066358,0.23331,0.23371,0.20757,0.22468,31341987.7,28215.0,17055485.6,-3.6989413227036985,37.50806651774634,0.3074074455385394,0.20087655446146055,-0.01097913321652949,-0.007741769585597904,-0.0032373636309315865,0.026139999999999997,0.02952071428571429,781289532.9199986,-0.06137999999999999,-18.301152685356893,-74.6537038630302,25.346296136969787,25.925607272935846,0.22535333333333327,0.2251989999103915,0.22605142857142854,0.2311518761035502,0.254142,0.24466845998859016,97643.0,19503254.56666666,195509.0,15353814.514285713
2021-07-21,0.2601,0.29745,0.25564,0.26425,58357649.8,59695.0,28916128.2,0.2496433333333333,0.23215000000000002,0.2564445,0.2534247499775979,0.24483543030824698,0.24785445364145364,48.28691740836444,0.30837567610431155,0.2045133238956885,-0.006025593015997838,-0.0075111681240043115,0.0014855751080064738,0.041810000000000014,0.034548571428571435,938774149.0199986,-0.024760000000000004,-2.6380752367267224,-40.60913705583758,59.390862944162414,46.82382632137429,1.5955401768550508,0.22484,0.29292,0.21202,0.26,99126966.3,83916.0,48463894.1,15.63778687066358,43.4329364187823,0.30760757672947076,0.20387242327052918,-0.008445731162638026,-0.00788256190100593,-0.0005631692616320967,0.08090000000000003,0.03361642857142857,880416499.2199986,-0.02287,-10.106143899318877,-44.265680117009374,55.734319882990626,37.80722131406121,0.23916333333333326,0.24259949995519575,0.22909428571428572,0.23836390707766264,0.25573999999999997,0.24612860665634348,160213.0,30528592.166666657,250738.0,20277267.471428573
2021-07-22,0.26377,0.281,0.25655,0.26815,43597190.9,40426.0,21340241.3,0.2641333333333333,0.23835285714285717,0.257306,0.26078737498879895,0.25066407273118524,0.24978736281845806,50.07883797601414,0.30942262726897063,0.20518937273102936,-0.0037496945476501176,-0.006758873408733474,0.003009178861083356,0.024450000000000027,0.0343107142857143,982371339.9199985,0.0021100000000000008,0.12321708610261162,-37.25372107029167,62.74627892970833,59.29048725228714,1.660537589566666,0.2601,0.29745,0.25564,0.26425,58357649.8,59695.0,28916128.2,1.5955401768550508,48.28691740836444,0.30837567610431155,0.2045133238956885,-0.006025593015997838,-0.0075111681240043115,0.0014855751080064738,0.041810000000000014,0.034548571428571435,938774149.0199986,-0.024760000000000004,-2.6380752367267224,-40.60913705583758,59.390862944162414,46.82382632137429,0.2496433333333333,0.2534247499775979,0.23215000000000002,0.24483543030824698,0.2564445,0.24785445364145364,171826.0,31478502.633333325,284774.0,22652246.557142857
2021-07-23,0.2677,0.29374,0.2625,0.28779,38620238.1,43558.0,19602601.0,0.27339666666666657,0.25089285714285714,0.258297,0.2742886874943995,0.2599455545483889,0.2534066615976525,50.41055579287105,0.3119971229440735,0.2045968770559265,-0.00035712800352988294,-0.005478524327692755,0.005121396324162872,0.03123999999999999,0.03407714285714286,1020991578.0199986,0.049089999999999995,0.6047682304411772,-20.35619031231181,79.64380968768819,67.26031718718633,7.5046694060515495,0.26377,0.281,0.25655,0.26815,43597190.9,40426.0,21340241.3,1.660537589566666,50.07883797601414,0.30942262726897063,0.20518937273102936,-0.0037496945476501176,-0.006758873408733474,0.003009178861083356,0.024450000000000027,0.0343107142857143,982371339.9199985,0.0021100000000000008,0.12321708610261162,-37.25372107029167,62.74627892970833,59.29048725228714,0.2641333333333333,0.26078737498879895,0.23835285714285717,0.25066407273118524,0.257306,0.24978736281845806,184037.0,32906754.533333328,305459.0,24288602.75714286
2021-07-24,0.28782,0.29999,0.27168,0.2796,31980002.1,34445.0,15484867.3,0.2785133333333333,0.25961142857142855,0.25848,0.2769443437471998,0.2648591659112917,0.25590126525501894,49.24196763874079,0.31245750564621855,0.20450249435378143,0.0016516022290832266,-0.004052499016337559,0.005704101245420786,0.028310000000000002,0.03363000000000001,989011575.9199985,0.03674000000000002,-1.1560080602396883,-19.46167796124842,80.53832203875159,74.30947021871604,-2.8559516364394426,0.2677,0.29374,0.2625,0.28779,38620238.1,43558.0,19602601.0,7.5046694060515495,50.41055579287105,0.3119971229440735,0.2045968770559265,-0.00035712800352988294,-0.005478524327692755,0.005121396324162872,0.03123999999999999,0.03407714285714286,1020991578.0199986,0.049089999999999995,0.6047682304411772,-20.35619031231181,79.64380968768819,67.26031718718633,0.27339666666666657,0.2742886874943995,0.25089285714285714,0.2599455545483889,0.258297,0.2534066615976525,143679.0,23286323.49999999,325238.0,25261804.042857144
2021-07-25,0.27959,0.355,0.27173,0.34563,73327304.8,80233.0,38366560.4,0.30433999999999994,0.27572857142857143,0.262011,0.3112871718735999,0.2850518744334688,0.2644468590402552,60.27287901879672,0.3283625123850812,0.19565948761491883,0.008473922471397444,-0.0015472147187905586,0.010021137190188002,0.08326999999999996,0.03833000000000001,1062338880.7199985,0.12089999999999998,19.591017611847338,-5.864313430967575,94.13568656903243,84.77260609849075,23.62030115526306,0.28782,0.29999,0.27168,0.2796,31980002.1,34445.0,15484867.3,-2.8559516364394426,49.24196763874079,0.31245750564621855,0.20450249435378143,0.0016516022290832266,-0.004052499016337559,0.005704101245420786,0.028310000000000002,0.03363000000000001,989011575.9199985,0.03674000000000002,-1.1560080602396883,-19.46167796124842,80.53832203875159,74.30947021871604,0.2785133333333333,0.2769443437471998,0.25961142857142855,0.2648591659112917,0.25848,0.25590126525501894,118429.0,18809236.53333332,338337.0,25275659.185714286
2021-07-26,0.34565,0.40634,0.31439,0.31642,114502683.7,124392.0,55629797.8,0.3138833333333333,0.2888342857142857,0.2633705,0.3138535859367999,0.2928939058251016,0.26939668198880234,58.938329430132704,0.33309852154384684,0.19364247845615318,0.011392333801171828,0.0010406949852019187,0.01035163881596991,0.09194999999999998,0.042499999999999996,947836197.0199984,0.11640999999999999,18.937001954593292,-42.59189086775294,57.408109132247056,77.36070591334371,-8.456531173152042,0.27959,0.355,0.27173,0.34563,73327304.8,80233.0,38366560.4,23.62030115526306,60.27287901879672,0.3283625123850812,0.19565948761491883,0.008473922471397444,-0.0015472147187905586,0.010021137190188002,0.08326999999999996,0.03833000000000001,1062338880.7199985,0.12089999999999998,19.591017611847338,-5.864313430967575,94.13568656903243,84.77260609849075,0.30433999999999994,0.3112871718735999,0.27572857142857143,0.2850518744334688,0.262011,0.2644468590402552,158236.0,24484676.233333323,370488.0,27032825.414285716
2021-07-27,0.31622,0.37984,0.305,0.35495,102577463.7,107727.0,52344770.4,0.3389999999999999,0.3023985714285714,0.2675475,0.33440179296839995,0.3084079293688262,0.27754461703748784,69.83720692126549,0.3484212943048383,0.18667370569516167,0.016622629472064332,0.0041570818825744016,0.01246554758948993,0.07484000000000002,0.04554142857142857,1050413660.7199985,0.13638,48.70129870129869,-24.341606669192874,75.65839333080713,75.73406301069555,12.247802163051036,0.34565,0.40634,0.31439,0.31642,114502683.7,124392.0,55629797.8,-8.456531173152042,58.938329430132704,0.33309852154384684,0.19364247845615318,0.011392333801171828,0.0010406949852019187,0.01035163881596991,0.09194999999999998,0.042499999999999996,947836197.0199984,0.11640999999999999,18.937001954593292,-42.59189086775294,57.408109132247056,77.36070591334371,0.3138833333333333,0.3138535859367999,0.2888342857142857,0.2928939058251016,0.2633705,0.26939668198880234,239070.0,36493741.83333332,466665.0,32543441.442857146
2021-07-28,0.35499,0.39,0.33666,0.34348,62450483.6,73266.0,31581238.3,0.33828333333333327,0.31371714285714286,0.27133050000000003,0.3389408964842,0.31717594702661966,0.28382417731963183,66.75213106020246,0.3590467397434763,0.18361426025652378,0.01961602204074575,0.007248869914208672,0.012367152126537079,0.05334,0.047525,987963177.1199985,0.11067000000000002,41.431277279090835,-29.77453580901856,70.22546419098144,67.76398888467855,-3.242344854784647,0.31622,0.37984,0.305,0.35495,102577463.7,107727.0,52344770.4,12.247802163051036,69.83720692126549,0.3484212943048383,0.18667370569516167,0.016622629472064332,0.0041570818825744016,0.01246554758948993,0.07484000000000002,0.04554142857142857,1050413660.7199985,0.13638,48.70129870129869,-24.341606669192874,75.65839333080713,75.73406301069555,0.3389999999999999,0.33440179296839995,0.3023985714285714,0.3084079293688262,0.2675475,0.27754461703748784,312352.0,48780376.19999999,490476.0,33097852.34285714
2021-07-29,0.34348,0.389,0.33252,0.389,50439214.7,65115.0,26199602.6,0.3624766666666666,0.3309814285714286,0.2764775,0.3639704482421,0.3351319602699647,0.29384092233680975,75.06331817765707,0.37871198771792014,0.17424301228207983,0.02536895328924832,0.010872886589216603,0.014496066700031717,0.05648000000000003,0.04956857142857143,1038402391.8199985,0.16432000000000002,73.09660481466649,-8.213338385752165,91.78666161424783,79.2235063786788,13.252591126120883,0.35499,0.39,0.33666,0.34348,62450483.6,73266.0,31581238.3,-3.242344854784647,66.75213106020246,0.3590467397434763,0.18361426025652378,0.01961602204074575,0.007248869914208672,0.012367152126537079,0.05334,0.047525,987963177.1199985,0.11067000000000002,41.431277279090835,-29.77453580901856,70.22546419098144,67.76398888467855,0.33828333333333327,0.3389408964842,0.31371714285714286,0.31717594702661966,0.27133050000000003,0.28382417731963183,305385.0,46518602.16666666,504047.0,33478582.35714286
2021-07-30,0.38861,0.40288,0.34531,0.37801,47760343.1,60884.0,24788223.6,0.37016333333333334,0.34386999999999995,0.2812345,0.37099022412105,0.34585147020247353,0.3018570249713993,78.34575450665648,0.3931196697947419,0.1693493302052581,0.028710435568966908,0.014440396385166664,0.014270039183800244,0.05757000000000001,0.05153714285714286,990642048.7199985,0.11801,88.99555022248889,-13.418908677529354,86.58109132247066,82.86440570923332,-2.7276704150690922,0.34348,0.389,0.33252,0.389,50439214.7,65115.0,26199602.6,13.252591126120883,75.06331817765707,0.37871198771792014,0.17424301228207983,0.02536895328924832,0.010872886589216603,0.014496066700031717,0.05648000000000003,0.04956857142857143,1038402391.8199985,0.16432000000000002,73.09660481466649,-8.213338385752165,91.78666161424783,79.2235063786788,0.3624766666666666,0.3639704482421,0.3309814285714286,0.3351319602699647,0.2764775,0.29384092233680975,246108.0,36708537.09999999,528736.0,34172776.828571424
2021-07-31,0.37814,0.42784,0.36239,0.40334,53737709.4,77172.0,27057379.4,0.3901166666666666,0.36154714285714284,0.286951,0.38716511206052495,0.36022360265185516,0.31152207021221845,78.80280592361653,0.4114775649781661,0.16242443502183393,0.033021848345738236,0.01815668677728098,0.014865161568457255,0.06545000000000001,0.05408857142857144,1044379758.1199985,0.13909,84.53584663952051,-11.122713034003732,88.87728696599628,89.08167996757159,6.664198445020364,0.38861,0.40288,0.34531,0.37801,47760343.1,60884.0,24788223.6,-2.7276704150690922,78.34575450665648,0.3931196697947419,0.1693493302052581,0.028710435568966908,0.014440396385166664,0.014270039183800244,0.05757000000000001,0.05153714285714286,990642048.7199985,0.11801,88.99555022248889,-13.418908677529354,86.58109132247066,82.86440570923332,0.37016333333333334,0.37099022412105,0.34386999999999995,0.34585147020247353,0.2812345,0.3018570249713993,199265.0,27523021.49999999,546062.0,34913580.05714286
2021-08-01,0.40499,0.43135,0.38447,0.39102,44930199.7,68909.0,21676159.7,0.39078999999999997,0.3680314285714286,0.2932,0.3890925560302625,0.3679227019888914,0.3190933016205786,74.8110278204686,0.42560265333642155,0.1607973466635785,0.03504062646604922,0.02153347471503463,0.01350715175101459,0.04688000000000003,0.05447357142857144,999449558.4199984,0.12286999999999998,67.9567028907693,-18.02216462597195,81.97783537402805,85.81207122083167,-3.4494678880960117,0.37814,0.42784,0.36239,0.40334,53737709.4,77172.0,27057379.4,6.664198445020364,78.80280592361653,0.4114775649781661,0.16242443502183393,0.033021848345738236,0.01815668677728098,0.014865161568457255,0.06545000000000001,0.05408857142857144,1044379758.1199985,0.13909,84.53584663952051,-11.122713034003732,88.87728696599628,89.08167996757159,0.3901166666666666,0.38716511206052495,0.36154714285714284,0.36022360265185516,0.286951,0.31152207021221845,203171.0,26015068.533333328,588789.0,36566796.071428575
2021-08-02,0.39092,0.42137,0.38,0.38177,44227524.0,48714.0,26002248.0,0.3920433333333333,0.3773671428571429,0.3003535,0.3854312780151312,0.37138452649166853,0.3250625109900473,74.54914830442257,0.43578314073837254,0.16492385926162745,0.03548507511910143,0.024323794795847987,0.01116128032325344,0.04137000000000002,0.05556142857142858,955222034.4199984,0.09398000000000001,69.91721559551362,-22.605206766060277,77.39479323393972,82.74997185798803,-2.3406323544459204,0.40499,0.43135,0.38447,0.39102,44930199.7,68909.0,21676159.7,-3.4494678880960117,74.8110278204686,0.42560265333642155,0.1607973466635785,0.03504062646604922,0.02153347471503463,0.01350715175101459,0.04688000000000003,0.05447357142857144,999449558.4199984,0.12286999999999998,67.9567028907693,-18.02216462597195,81.97783537402805,85.81207122083167,0.39078999999999997,0.3890925560302625,0.3680314285714286,0.3679227019888914,0.2932,0.3190933016205786,206965.0,24507254.23333332,577465.0,34182453.114285715
2021-08-03,0.38178,0.39499,0.36245,0.374,30089675.2,46786.0,15259693.0,0.38226333333333323,0.38008857142857144,0.3069105,0.3797156390075656,0.37203839486875145,0.3297232242290904,69.49384404924761,0.44331474479812105,0.17050625520187887,0.034809072495491644,0.02642085033577672,0.008388222159714923,0.03254000000000001,0.052107142857142866,925132359.2199984,0.09439999999999998,43.84615384615385,-32.6390074554664,67.3609925445336,75.57787371750047,-2.0378228299020402,0.39092,0.42137,0.38,0.38177,44227524.0,48714.0,26002248.0,-2.3406323544459204,74.54914830442257,0.43578314073837254,0.16492385926162745,0.03548507511910143,0.024323794795847987,0.01116128032325344,0.04137000000000002,0.05556142857142858,955222034.4199984,0.09398000000000001,69.91721559551362,-22.605206766060277,77.39479323393972,82.74997185798803,0.3920433333333333,0.3854312780151312,0.3773671428571429,0.37138452649166853,0.3003535,0.3250625109900473,194795.0,24911929.03333332,501787.0,29949946.0
2021-08-04,0.37406,0.40973,0.36205,0.39503,28512375.1,41510.0,13883972.3,0.38359999999999994,0.38745285714285715,0.3154255,0.3873728195037828,0.3777862961515636,0.3359429171596532,71.14949220518793,0.45149078440420964,0.17936021559579043,0.035560363061090894,0.02824875288083956,0.007311610180251334,0.04768,0.05252642857142858,953644734.3199984,0.0494,49.49101229895931,-20.778032036613283,79.22196796338672,74.65925124728669,5.606052504945728,0.38178,0.39499,0.36245,0.374,30089675.2,46786.0,15259693.0,-2.0378228299020402,69.49384404924761,0.44331474479812105,0.17050625520187887,0.034809072495491644,0.02642085033577672,0.008388222159714923,0.03254000000000001,0.052107142857142866,925132359.2199984,0.09439999999999998,43.84615384615385,-32.6390074554664,67.3609925445336,75.57787371750047,0.38226333333333323,0.3797156390075656,0.38008857142857144,0.37203839486875145,0.3069105,0.3297232242290904,164409.0,20979366.899999987,440846.0,24652077.800000004
2021-08-05,0.39548,0.41903,0.3921,0.41578,37578155.9,60240.0,18500154.6,0.39493666666666655,0.3912785714285714,0.32621399999999995,0.40157640975189135,0.3872847221136727,0.3435464488587338,72.64055455019476,0.4578936919801929,0.19453430801980695,0.03739900537817187,0.030078803380306024,0.007320201997865844,0.02693000000000001,0.052703571428571426,991222890.2199984,0.09936,55.055006526198014,-9.221202250518228,90.77879774948178,79.12058608580071,5.133002933144529,0.37406,0.40973,0.36205,0.39503,28512375.1,41510.0,13883972.3,5.606052504945728,71.14949220518793,0.45149078440420964,0.17936021559579043,0.035560363061090894,0.02824875288083956,0.007311610180251334,0.04768,0.05252642857142858,953644734.3199984,0.0494,49.49101229895931,-20.778032036613283,79.22196796338672,74.65925124728669,0.38359999999999994,0.3873728195037828,0.38745285714285715,0.3777862961515636,0.3154255,0.3359429171596532,137010.0,18381971.09999999,409090.0,22123896.942857143
2021-08-06,0.41586,0.4407,0.40736,0.41292,59348727.6,119541.0,29854082.3,0.40790999999999994,0.3962657142857143,0.3359315,0.4072482048759457,0.39369354158525455,0.3501534537293306,70.23120452708166,0.4627591282825948,0.20910387171740522,0.03818518946844135,0.03170008059793309,0.006485108870508259,0.03333999999999998,0.05285357142857144,931874162.6199983,0.05797000000000002,43.47962055665591,-16.43592474263399,83.56407525736601,84.52161365674485,-0.7069686913865239,0.39548,0.41903,0.3921,0.41578,37578155.9,60240.0,18500154.6,5.133002933144529,72.64055455019476,0.4578936919801929,0.19453430801980695,0.03739900537817187,0.030078803380306024,0.007320201997865844,0.02693000000000001,0.052703571428571426,991222890.2199984,0.09936,55.055006526198014,-9.221202250518228,90.77879774948178,79.12058608580071,0.39493666666666655,0.40157640975189135,0.3912785714285714,0.3872847221136727,0.32621399999999995,0.3435464488587338,148536.0,15881273.299999991,404215.0,21023975.8
2021-08-07,0.41292,0.42517,0.39296,0.40583,68150565.9,125598.0,32603042.4,0.41151,0.39662142857142857,0.3445825,0.40653910243797287,0.3967276561889409,0.3554559819455848,70.48190816160961,0.465247224863211,0.22391777513678904,0.037800402764596175,0.03292014503126571,0.004880257733330465,0.032210000000000016,0.05313214285714286,863723596.7199984,0.062350000000000017,45.146638054363386,-20.636799431851788,79.3632005681482,84.56869119166534,-1.7170396202654232,0.41586,0.4407,0.40736,0.41292,59348727.6,119541.0,29854082.3,-0.7069686913865239,70.23120452708166,0.4627591282825948,0.20910387171740522,0.03818518946844135,0.03170008059793309,0.006485108870508259,0.03333999999999998,0.05285357142857144,931874162.6199983,0.05797000000000002,43.47962055665591,-16.43592474263399,83.56407525736601,84.52161365674485,0.40790999999999994,0.4072482048759457,0.3962657142857143,0.39369354158525455,0.3359315,0.3501534537293306,221291.0,20746069.733333323,462872.0,21747669.900000002
2021-08-08,0.40578,0.415,0.37574,0.37665,43714393.0,101438.0,21270266.2,0.3984666666666666,0.39456857142857144,0.35218099999999997,0.39159455121898645,0.3917082421417057,0.3574744598555291,55.71691854036121,0.45945031790688884,0.2449116820931111,0.034740408591901584,0.03328419774339288,0.0014562108485087003,0.03925999999999996,0.04998857142857143,820009203.7199984,-0.012350000000000028,8.974915371929516,-47.1997052321297,52.800294767870305,71.90919019779484,-7.178766819458818,0.41292,0.42517,0.39296,0.40583,68150565.9,125598.0,32603042.4,-1.7170396202654232,70.48190816160961,0.465247224863211,0.22391777513678904,0.037800402764596175,0.03292014503126571,0.004880257733330465,0.032210000000000016,0.05313214285714286,863723596.7199984,0.062350000000000017,45.146638054363386,-20.636799431851788,79.3632005681482,84.56869119166534,0.41151,0.40653910243797287,0.39662142857142857,0.3967276561889409,0.3445825,0.3554559819455848,305379.0,26985759.766666662,511298.0,22539907.471428573
2021-08-09,0.37675,0.41,0.37052,0.39836,35956265.5,83977.0,17210718.9,0.3936133333333333,0.3969385714285715,0.359099,0.39497727560949325,0.39337118160627926,0.3613683208216692,65.53070507960578,0.4589250012326647,0.2592729987673353,0.0336789270196548,0.03336314359864527,0.00031578342100953283,0.03947999999999996,0.04624071428571429,855965469.2199984,0.02034999999999998,25.89596106440808,-31.201179071481207,68.7988209285188,66.98743875484577,5.735899137358996,0.40578,0.415,0.37574,0.37665,43714393.0,101438.0,21270266.2,-7.178766819458818,55.71691854036121,0.45945031790688884,0.2449116820931111,0.034740408591901584,0.03328419774339288,0.0014562108485087003,0.03925999999999996,0.04998857142857143,820009203.7199984,-0.012350000000000028,8.974915371929516,-47.1997052321297,52.800294767870305,71.90919019779484,0.3984666666666666,0.39159455121898645,0.39456857142857144,0.3917082421417057,0.35218099999999997,0.3574744598555291,346577.0,27909130.299999986,543827.0,22481922.685714286
2021-08-10,0.39836,0.469,0.39223,0.45594,70073516.7,139341.0,37605908.7,0.4103166666666666,0.4086442857142857,0.36868350000000005,0.42545863780474663,0.40901338620470945,0.37037514741008165,67.85221849036593,0.4669628426439407,0.2704041573560594,0.03705675283034854,0.034101865444985925,0.002954887385362613,0.07676999999999995,0.04637857142857143,926038985.9199984,0.052600000000000036,28.451894633046916,-9.569167643610758,90.43083235638925,70.67664935092613,14.45426247615223,0.37675,0.41,0.37052,0.39836,35956265.5,83977.0,17210718.9,5.735899137358996,65.53070507960578,0.4589250012326647,0.2592729987673353,0.0336789270196548,0.03336314359864527,0.00031578342100953283,0.03947999999999996,0.04624071428571429,855965469.2199984,0.02034999999999998,25.89596106440808,-31.201179071481207,68.7988209285188,66.98743875484577,0.3936133333333333,0.39497727560949325,0.3969385714285715,0.39337118160627926,0.359099,0.3613683208216692,311013.0,23694675.833333325,579090.0,21225989.957142856
2021-08-11,0.45571,0.55384,0.45086,0.48337,116614366.2,264355.0,59168413.8,0.44588999999999995,0.42126428571428576,0.3794445,0.4544143189023733,0.4276025396535321,0.3811365619424548,73.40785114286672,0.47850265930685376,0.2803863406931463,0.041469046524420905,0.03557530166087292,0.0058937448635479825,0.10298000000000002,0.04992428571428571,1042653352.1199985,0.09235000000000004,40.727262140444864,-31.84077354057472,68.15922645942528,75.79629324811111,6.069649557832836,0.39836,0.469,0.39223,0.45594,70073516.7,139341.0,37605908.7,14.45426247615223,67.85221849036593,0.4669628426439407,0.2704041573560594,0.03705675283034854,0.034101865444985925,0.002954887385362613,0.07676999999999995,0.04637857142857143,926038985.9199984,0.052600000000000036,28.451894633046916,-9.569167643610758,90.43083235638925,70.67664935092613,0.4103166666666666,0.42545863780474663,0.4086442857142857,0.40901338620470945,0.36868350000000005,0.37037514741008165,324756.0,25362297.933333326,671645.0,24418306.485714287
2021-08-12,0.48346,0.51985,0.4673,0.50981,35825843.1,75975.0,18486338.1,0.4830399999999999,0.43469714285714284,0.3905455,0.4821121594511867,0.4481544047401491,0.39339117509079247,71.59403710721053,0.49591646084035673,0.28517453915964325,0.046562563845709226,0.037772754097840186,0.00878980974786904,0.05255000000000004,0.04964357142857143,1078479195.2199984,0.12804,31.05655526992288,-21.11446794226251,78.88553205773748,79.15853029118401,5.45029578455301,0.45571,0.55384,0.45086,0.48337,116614366.2,264355.0,59168413.8,6.069649557832836,73.40785114286672,0.47850265930685376,0.2803863406931463,0.041469046524420905,0.03557530166087292,0.0058937448635479825,0.10298000000000002,0.04992428571428571,1042653352.1199985,0.09235000000000004,40.727262140444864,-31.84077354057472,68.15922645942528,75.79629324811111,0.44588999999999995,0.4544143189023733,0.42126428571428576,0.4276025396535321,0.3794445,0.3811365619424548,487673.0,37995013.79999999,894490.0,30887512.414285712
2021-08-13,0.50919,0.5398,0.50117,0.51539,23305741.6,40769.0,11323784.2,0.5028566666666666,0.4493357142857143,0.402335,0.49875107972559335,0.46496330355511184,0.4050101107964313,75.04009915427238,0.5082016848844342,0.2964683151155658,0.05046771201656802,0.040311745681585756,0.010155966334982267,0.03862999999999994,0.048290714285714284,1101784936.8199983,0.14139000000000002,36.34295389010873,-20.04796913290577,79.95203086709422,75.665596461419,1.2176201417938262,0.48346,0.51985,0.4673,0.50981,35825843.1,75975.0,18486338.1,5.45029578455301,71.59403710721053,0.49591646084035673,0.28517453915964325,0.046562563845709226,0.037772754097840186,0.00878980974786904,0.05255000000000004,0.04964357142857143,1078479195.2199984,0.12804,31.05655526992288,-21.11446794226251,78.88553205773748,79.15853029118401,0.4830399999999999,0.4821121594511867,0.43469714285714284,0.4481544047401491,0.3905455,0.39339117509079247,479671.0,38420220.199999996,910225.0,30885538.62857143
2021-08-14,0.51491,0.528,0.49273,0.50178,16010750.5,28737.0,7576141.1,0.5089933333333333,0.46304285714285714,0.41014249999999997,0.5002655398627966,0.47416747766633394,0.41422629072058065,68.74333587204875,0.5213005628749185,0.2989844371250814,0.051866472412351206,0.04262269102773885,0.009243781384612355,0.035270000000000024,0.046134999999999995,1085774186.3199983,0.10675000000000001,24.406208161848575,-27.144272381250325,72.85572761874968,77.23109684786046,-2.549960187217179,0.50919,0.5398,0.50117,0.51539,23305741.6,40769.0,11323784.2,1.2176201417938262,75.04009915427238,0.5082016848844342,0.2964683151155658,0.05046771201656802,0.040311745681585756,0.010155966334982267,0.03862999999999994,0.048290714285714284,1101784936.8199983,0.14139000000000002,36.34295389010873,-20.04796913290577,79.95203086709422,75.665596461419,0.5028566666666666,0.49875107972559335,0.4493357142857143,0.46496330355511184,0.402335,0.4050101107964313,381099.0,29659512.033333328,831453.0,28238353.185714286
2021-08-15,0.50193,0.50704,0.47808,0.49755,17009952.7,27963.0,8368049.2,0.5049066666666666,0.48031428571428575,0.419199,0.4989077699313983,0.4800131082497504,0.4221618820805253,70.92845074849711,0.5276884427849486,0.31070955721505134,0.05203386050121439,0.04450492492243396,0.007528935578780434,0.02896000000000004,0.04485499999999999,1068764233.6199982,0.08177000000000001,27.24413073500078,-29.349809687679233,70.65019031232077,74.48598293272157,-0.8726316418624102,0.51491,0.528,0.49273,0.50178,16010750.5,28737.0,7576141.1,-2.549960187217179,68.74333587204875,0.5213005628749185,0.2989844371250814,0.051866472412351206,0.04262269102773885,0.009243781384612355,0.035270000000000024,0.046134999999999995,1085774186.3199983,0.10675000000000001,24.406208161848575,-27.144272381250325,72.85572761874968,77.23109684786046,0.5089933333333333,0.5002655398627966,0.46304285714285714,0.47416747766633394,0.41014249999999997,0.41422629072058065,145481.0,12462087.799999991,734592.0,24663081.57142857
2021-08-16,0.49737,0.549,0.4875,0.49082,36024809.8,51870.0,18695539.6,0.49671666666666664,0.49352285714285715,0.4259925,0.4948638849656991,0.4827148311873128,0.4287007504538086,71.63776340330965,0.534558179344709,0.31742682065529104,0.05103516045116463,0.04581097202818009,0.005224188422984541,0.061500000000000055,0.04629285714285714,1032739423.8199983,0.07789999999999997,28.564318830709578,-32.85885604046093,67.14114395953908,70.21568729686986,-1.316927036210467,0.50193,0.50704,0.47808,0.49755,17009952.7,27963.0,8368049.2,-0.8726316418624102,70.92845074849711,0.5276884427849486,0.31070955721505134,0.05203386050121439,0.04450492492243396,0.007528935578780434,0.02896000000000004,0.04485499999999999,1068764233.6199982,0.08177000000000001,27.24413073500078,-29.349809687679233,70.65019031232077,74.48598293272157,0.5049066666666666,0.4989077699313983,0.48031428571428575,0.4800131082497504,0.419199,0.4221618820805253,97469.0,9089324.833333327,661117.0,22819907.714285713
2021-08-17,0.49078,0.545,0.4573,0.46319,47008272.3,66069.0,22801279.6,0.48385333333333325,0.49455857142857135,0.431978,0.47902694248284955,0.4778336233904846,0.43198544088677926,66.40426705903991,0.5344164016398419,0.32953959836015795,0.04746700331279324,0.046142178285102725,0.0013248250276905182,0.08770000000000006,0.05023285714285714,985731151.5199983,0.05735999999999997,23.847593582887704,-47.265238020751866,52.734761979248134,63.50869875036934,-5.621663474469213,0.49737,0.549,0.4875,0.49082,36024809.8,51870.0,18695539.6,-1.316927036210467,71.63776340330965,0.534558179344709,0.31742682065529104,0.05103516045116463,0.04581097202818009,0.005224188422984541,0.061500000000000055,0.04629285714285714,1032739423.8199983,0.07789999999999997,28.564318830709578,-32.85885604046093,67.14114395953908,70.21568729686986,0.49671666666666664,0.4948638849656991,0.49352285714285715,0.4827148311873128,0.4259925,0.4287007504538086,108570.0,11546576.633333325,629010.0,23032024.95714286
2021-08-18,0.46392,0.539,0.442,0.50033,41237630.3,61504.0,23125143.7,0.48478,0.4969814285714285,0.4375445,0.48967847124142483,0.4834577175428635,0.4384944465166098,68.28378941519657,0.5422243558965651,0.3328646441034349,0.047093239135290954,0.04633239045514037,0.0007608486801505832,0.09700000000000003,0.053755714285714296,1026968781.8199983,0.12368000000000007,26.656203326329653,-29.18939559240669,70.8106044075933,63.562170115460184,7.848335919986216,0.49078,0.545,0.4573,0.46319,47008272.3,66069.0,22801279.6,-5.621663474469213,66.40426705903991,0.5344164016398419,0.32953959836015795,0.04746700331279324,0.046142178285102725,0.0013248250276905182,0.08770000000000006,0.05023285714285714,985731151.5199983,0.05735999999999997,23.847593582887704,-47.265238020751866,52.734761979248134,63.50869875036934,0.48385333333333325,0.47902694248284955,0.49455857142857135,0.4778336233904846,0.431978,0.43198544088677926,145902.0,16621622.799999991,555738.0,20917077.942857143
2021-08-19,0.50081,0.579,0.50031,0.54524,67010455.9,110608.0,34604742.6,0.5029199999999999,0.5020428571428571,0.445906,0.5174592356207124,0.49890328815714763,0.4486606897055041,70.73881840317826,0.5570773362148215,0.33473466378517863,0.049846292966190364,0.04703517095735037,0.0028111220088399974,0.07868999999999993,0.057452857142857146,1093979237.7199984,0.14687999999999996,31.13665880994756,-16.19339984650807,83.80660015349193,69.11732218011112,8.871627962700419,0.46392,0.539,0.442,0.50033,41237630.3,61504.0,23125143.7,7.848335919986216,68.28378941519657,0.5422243558965651,0.3328646441034349,0.047093239135290954,0.04633239045514037,0.0007608486801505832,0.09700000000000003,0.053755714285714296,1026968781.8199983,0.12368000000000007,26.656203326329653,-29.18939559240669,70.8106044075933,63.562170115460184,0.48478,0.48967847124142483,0.4969814285714285,0.4834577175428635,0.4375445,0.4384944465166098,179443.0,21540654.299999993,352887.0,15768039.357142856
2021-08-20,0.54355,0.58588,0.53323,0.56253,27296403.6,52284.0,13877743.1,0.5360333333333333,0.5087771428571429,0.45386550000000003,0.5399946178103562,0.5148099661178607,0.4595053859240275,72.90767110702801,0.5745894423295081,0.3331415576704919,0.05281445430987297,0.04819102762785489,0.004623426682018081,0.052649999999999975,0.058832142857142854,1121275641.3199983,0.10658999999999996,36.23219994187734,-10.842310549777112,89.15768945022289,81.25829800376938,3.4918590746021523,0.50081,0.579,0.50031,0.54524,67010455.9,110608.0,34604742.6,8.871627962700419,70.73881840317826,0.5570773362148215,0.33473466378517863,0.049846292966190364,0.04703517095735037,0.0028111220088399974,0.07868999999999993,0.057452857142857146,1093979237.7199984,0.14687999999999996,31.13665880994756,-16.19339984650807,83.80660015349193,69.11732218011112,0.5029199999999999,0.5174592356207124,0.5020428571428571,0.49890328815714763,0.445906,0.4486606897055041,238181.0,26843721.966666657,387520.0,18070668.571428575
2021-08-21,0.56309,0.591,0.54993,0.56597,23261957.9,44035.0,11379959.9,0.5579133333333334,0.5179471428571428,0.462613,0.5529823089051781,0.5275999745883955,0.469644872978882,74.7971508206875,0.589366196259916,0.33585980374008395,0.05481247867532374,0.049515317837348666,0.005297160837975073,0.04106999999999994,0.059465,1144537599.2199984,0.08259999999999995,39.459872360347916,-11.352503628447025,88.64749637155298,87.20392865842261,0.5114635315846479,0.54355,0.58588,0.53323,0.56253,27296403.6,52284.0,13877743.1,3.4918590746021523,72.90767110702801,0.5745894423295081,0.3331415576704919,0.05281445430987297,0.04819102762785489,0.004623426682018081,0.052649999999999975,0.058832142857142854,1121275641.3199983,0.10658999999999996,36.23219994187734,-10.842310549777112,89.15768945022289,81.25829800376938,0.5360333333333333,0.5399946178103562,0.5087771428571429,0.5148099661178607,0.45386550000000003,0.4595053859240275,224396.0,23869209.799999993,399035.0,18435519.842857145
2021-08-22,0.56613,0.57,0.52171,0.55844,19760625.0,34808.0,9717508.7,0.5623133333333333,0.5266457142857143,0.4714465,0.555711154452589,0.5353099809412967,0.478101551742798,80.17261410788383,0.5990988893894733,0.34379411061052667,0.05515255498813759,0.050642765267506454,0.004509789720631138,0.048289999999999944,0.06011,1124776974.2199984,0.04863000000000006,48.26496747643703,-14.767779390420868,85.23222060957913,87.67913547711834,-1.3583452563898706,0.56309,0.591,0.54993,0.56597,23261957.9,44035.0,11379959.9,0.5114635315846479,74.7971508206875,0.589366196259916,0.33585980374008395,0.05481247867532374,0.049515317837348666,0.005297160837975073,0.04106999999999994,0.059465,1144537599.2199984,0.08259999999999995,39.459872360347916,-11.352503628447025,88.64749637155298,87.20392865842261,0.5579133333333334,0.5529823089051781,0.5179471428571428,0.5275999745883955,0.462613,0.469644872978882,206927.0,19954148.533333328,414333.0,18978922.52857143
2021-08-23,0.5588,0.58527,0.55275,0.56006,29048407.1,39064.0,15098247.2,0.56149,0.5365371428571428,0.48074949999999994,0.5578855772262945,0.5414974857059724,0.4859071182434839,78.75586854460096,0.6055883395155074,0.3559106604844925,0.05491970816782782,0.051498153847570734,0.003421554320257085,0.03251999999999999,0.05961285714285714,1153825381.3199983,0.04466999999999999,40.591424841851584,-15.56572923479397,84.43427076520604,86.10466258211272,0.22548317823909073,0.56613,0.57,0.52171,0.55844,19760625.0,34808.0,9717508.7,-1.3583452563898706,80.17261410788383,0.5990988893894733,0.34379411061052667,0.05515255498813759,0.050642765267506454,0.004509789720631138,0.048289999999999944,0.06011,1124776974.2199984,0.04863000000000006,48.26496747643703,-14.767779390420868,85.23222060957913,87.67913547711834,0.5623133333333333,0.555711154452589,0.5266457142857143,0.5353099809412967,0.4714465,0.478101551742798,131127.0,11658403.899999991,421178.0,19171702.45714286
2021-08-24,0.55972,0.5685,0.5028,0.52088,33872607.3,43719.0,17682863.6,0.5464600000000001,0.5447785714285714,0.4870419999999999,0.5393827886131473,0.5363431142794793,0.4892378688869617,62.35728421373117,0.6062483302098718,0.3678356697901281,0.050985942617239544,0.051395711601504496,-0.0004097689842649521,0.06569999999999998,0.05882214285714286,1119952774.0199983,0.019100000000000006,14.243102162565258,-47.06040268456374,52.93959731543626,74.20202956340715,-6.93918387765311,0.5588,0.58527,0.55275,0.56006,29048407.1,39064.0,15098247.2,0.22548317823909073,78.75586854460096,0.6055883395155074,0.3559106604844925,0.05491970816782782,0.051498153847570734,0.003421554320257085,0.03251999999999999,0.05961285714285714,1153825381.3199983,0.04466999999999999,40.591424841851584,-15.56572923479397,84.43427076520604,86.10466258211272,0.56149,0.5578855772262945,0.5365371428571428,0.5414974857059724,0.48074949999999994,0.4859071182434839,117907.0,12065238.599999992,408372.0,18657803.542857144
2021-08-25,0.52076,0.5892,0.50921,0.56895,34516216.7,50464.0,19349977.5,0.5499633333333332,0.5545814285714286,0.4947005,0.5541663943065736,0.5444948357096095,0.4968295004215368,65.09880028228652,0.6143102196323363,0.37509078036766363,0.051157540062023776,0.05134807729360836,-0.0001905372315845824,0.0799899999999999,0.057179999999999995,1154468990.7199984,0.07139999999999996,17.704863768955438,-14.79865771812082,85.20134228187918,74.19173678750717,9.253782932636907,0.55972,0.5685,0.5028,0.52088,33872607.3,43719.0,17682863.6,-6.93918387765311,62.35728421373117,0.6062483302098718,0.3678356697901281,0.050985942617239544,0.051395711601504496,-0.0004097689842649521,0.06569999999999998,0.05882214285714286,1119952774.0199983,0.019100000000000006,14.243102162565258,-47.06040268456374,52.93959731543626,74.20202956340715,0.5464600000000001,0.5393827886131473,0.5447785714285714,0.5363431142794793,0.4870419999999999,0.4892378688869617,117591.0,14166206.499999993,386022.0,17926601.25714286
2021-08-26,0.56941,0.585,0.5146,0.5156,29865738.5,50373.0,14786298.7,0.5351433333333332,0.5503471428571428,0.49983449999999996,0.5348831971532868,0.5372711267822071,0.4986171670480571,50.932938029712226,0.6133221609986619,0.38634683900133804,0.04645315013913931,0.05036909186271456,-0.0039159417235752475,0.07040000000000002,0.058454999999999986,1124603252.2199984,0.02477999999999997,1.1357172279868877,-50.604026845637605,49.39597315436239,62.51230425055928,-9.450132593386142,0.52076,0.5892,0.50921,0.56895,34516216.7,50464.0,19349977.5,9.253782932636907,65.09880028228652,0.6143102196323363,0.37509078036766363,0.051157540062023776,0.05134807729360836,-0.0001905372315845824,0.0799899999999999,0.057179999999999995,1154468990.7199984,0.07139999999999996,17.704863768955438,-14.79865771812082,85.20134228187918,74.19173678750717,0.5499633333333332,0.5541663943065736,0.5545814285714286,0.5444948357096095,0.4947005,0.4968295004215368,133247.0,17377029.433333326,374982.0,17387291.8
2021-08-27,0.516,0.5629,0.5021,0.5622,17828705.7,32835.0,9374639.8,0.5489166666666666,0.5503,0.507653,0.5485415985766434,0.5435033450866553,0.5046726749482421,56.66182791108075,0.6152657701480976,0.40004022985190246,0.04595537284754453,0.04948634805968055,-0.0035309752121360227,0.060799999999999965,0.06003857142857142,1142431957.9199984,0.09901000000000004,9.082442422243343,-19.32885906040265,80.67114093959735,71.75615212527964,8.953488372093027,0.56941,0.585,0.5146,0.5156,29865738.5,50373.0,14786298.7,-9.450132593386142,50.932938029712226,0.6133221609986619,0.38634683900133804,0.04645315013913931,0.05036909186271456,-0.0039159417235752475,0.07040000000000002,0.058454999999999986,1124603252.2199984,0.02477999999999997,1.1357172279868877,-50.604026845637605,49.39597315436239,62.51230425055928,0.5351433333333332,0.5348831971532868,0.5503471428571428,0.5372711267822071,0.49983449999999996,0.4986171670480571,144556.0,17273046.59999999,314747.0,14556085.528571429
2021-08-28,0.5626,0.5693,0.531,0.5504,23995339.0,26803.0,15813524.0,0.5427333333333332,0.5480757142857143,0.5163405,0.5494707992883217,0.5452275088149915,0.5090276582865048,56.95525291828794,0.6059754101340367,0.42670558986596335,0.0441003579000267,0.04840915002774979,-0.004308792127723088,0.0383,0.06025499999999999,1118436618.9199984,0.05006999999999995,9.689505360915152,-27.248322147650995,72.751677852349,67.60626398210292,-2.1685033771773887,0.516,0.5629,0.5021,0.5622,17828705.7,32835.0,9374639.8,8.953488372093027,56.66182791108075,0.6152657701480976,0.40004022985190246,0.04595537284754453,0.04948634805968055,-0.0035309752121360227,0.060799999999999965,0.06003857142857142,1142431957.9199984,0.09901000000000004,9.082442422243343,-19.32885906040265,80.67114093959735,71.75615212527964,0.5489166666666666,0.5485415985766434,0.5503,0.5435033450866553,0.507653,0.5046726749482421,133672.0,14503638.666666657,295298.0,13912785.057142857
2021-08-29,0.551,0.621,0.5426,0.6061,46155617.7,77763.0,25501967.2,0.5729,0.5548842857142857,0.5267275,0.5777853996441609,0.5604456316112436,0.5182726432115996,63.53525025561734,0.6063886975477203,0.44706630245227974,0.04658773527276888,0.04804486707675361,-0.0014571318039847264,0.07840000000000003,0.06378642857142856,1164592236.6199985,0.060860000000000025,21.81690282383679,-8.324022346368729,91.67597765363126,81.69959881519254,9.999999999999986,0.5626,0.5693,0.531,0.5504,23995339.0,26803.0,15813524.0,-2.1685033771773887,56.95525291828794,0.6059754101340367,0.42670558986596335,0.0441003579000267,0.04840915002774979,-0.004308792127723088,0.0383,0.06025499999999999,1118436618.9199984,0.05006999999999995,9.689505360915152,-27.248322147650995,72.751677852349,67.60626398210292,0.5427333333333332,0.5494707992883217,0.5480757142857143,0.5452275088149915,0.5163405,0.5090276582865048,110011.0,13324820.833333327,278066.0,14546151.357142856
2021-08-30,0.6059,0.6934,0.5867,0.626,59503278.9,120014.0,31026335.5,0.5941666666666666,0.5643042857142857,0.5352304999999999,0.6018926998220804,0.5768342237084327,0.5285323914771616,66.31977979524822,0.6192620658672703,0.45119893413272955,0.049593085234059475,0.04835451070821478,0.0012385745258446934,0.10670000000000002,0.06701499999999998,1224095515.5199986,0.06347000000000003,27.541664968827682,-26.8098647573588,73.1901352426412,79.2059302495405,3.317379105462949,0.551,0.621,0.5426,0.6061,46155617.7,77763.0,25501967.2,9.999999999999986,63.53525025561734,0.6063886975477203,0.44706630245227974,0.04658773527276888,0.04804486707675361,-0.0014571318039847264,0.07840000000000003,0.06378642857142856,1164592236.6199985,0.060860000000000025,21.81690282383679,-8.324022346368729,91.67597765363126,81.69959881519254,0.5729,0.5777853996441609,0.5548842857142857,0.5604456316112436,0.5267275,0.5182726432115996,137401.0,16896710.333333325,321021.0,16801074.0
2021-08-31,0.626,0.73,0.6206,0.7248,45379689.9,98991.0,23478170.1,0.6523,0.5934357142857143,0.547302,0.6633463499110401,0.6138256677813245,0.5472245446698129,76.95176477860426,0.6632637504270502,0.4313402495729497,0.05926402226659144,0.05053641301989011,0.00872760924670133,0.10939999999999994,0.06856499999999997,1269475205.4199986,0.15883000000000003,56.48006217750816,-1.8055555555555496,98.19444444444446,87.68685244690566,15.782747603833865,0.6059,0.6934,0.5867,0.626,59503278.9,120014.0,31026335.5,3.317379105462949,66.31977979524822,0.6192620658672703,0.45119893413272955,0.049593085234059475,0.04835451070821478,0.0012385745258446934,0.10670000000000002,0.06701499999999998,1224095515.5199986,0.06347000000000003,27.541664968827682,-26.8098647573588,73.1901352426412,79.2059302495405,0.5941666666666666,0.6018926998220804,0.5643042857142857,0.5768342237084327,0.5352304999999999,0.5285323914771616,224580.0,24113942.233333323,401971.0,19076515.185714286
2021-09-01,0.7259,0.775,0.6674,0.7106,56678752.0,106825.0,28749371.8,0.6871333333333333,0.6136714285714285,0.5573414999999999,0.6869731749555201,0.6380192508359934,0.5627841118441164,72.73729968208656,0.6927695632155539,0.42191343678444587,0.06503283022921225,0.05343569646175454,0.011597133767457704,0.10760000000000003,0.06932214285714283,1212796453.4199986,0.15215999999999996,42.02626266664,-23.44461028796098,76.55538971203903,82.6466564663749,-2.1077283372365314,0.626,0.73,0.6206,0.7248,45379689.9,98991.0,23478170.1,15.782747603833865,76.95176477860426,0.6632637504270502,0.4313402495729497,0.05926402226659144,0.05053641301989011,0.00872760924670133,0.10939999999999994,0.06856499999999997,1269475205.4199986,0.15883000000000003,56.48006217750816,-1.8055555555555496,98.19444444444446,87.68685244690566,0.6523,0.6633463499110401,0.5934357142857143,0.6138256677813245,0.547302,0.5472245446698129,296768.0,26668824.266666662,457243.0,19904416.114285715
2021-09-02,0.711,0.74,0.6755,0.7058,36456363.0,70010.0,17754100.0,0.7137333333333333,0.6408428571428572,0.5668620000000001,0.69638658747776,0.654964438126995,0.5764046726208671,69.01108269394715,0.7159545610908606,0.4177694389091396,0.068428530710135,0.05643426331143064,0.011994267398704357,0.0645,0.06830857142857141,1176340090.4199986,0.14573999999999998,29.447582715868247,-25.357273726639807,74.6427262733602,83.13085347661458,-0.7313642756680707,0.7259,0.775,0.6674,0.7106,56678752.0,106825.0,28749371.8,-2.1077283372365314,72.73729968208656,0.6927695632155539,0.42191343678444587,0.06503283022921225,0.05343569646175454,0.011597133767457704,0.10760000000000003,0.06932214285714283,1212796453.4199986,0.15215999999999996,42.02626266664,-23.44461028796098,76.55538971203903,82.6466564663749,0.6871333333333333,0.6869731749555201,0.6136714285714285,0.6380192508359934,0.5573414999999999,0.5627841118441164,325830.0,27751292.466666657,513604.0,21247186.728571426
2021-09-03,0.7057,0.76,0.6875,0.7338,27422427.0,55121.0,13477077.0,0.7167333333333333,0.6653571428571429,0.578463,0.7150932937388801,0.6746733285952462,0.5913947037998323,69.777593016005,0.7416721174052816,0.4152538825947183,0.07254278572270823,0.05965596779368616,0.012886817929022062,0.07250000000000001,0.06972642857142855,1203762517.4199986,0.21292,30.446376193269707,-15.097105166727742,84.90289483327226,78.70033693955718,3.9818619810117633,0.711,0.74,0.6755,0.7058,36456363.0,70010.0,17754100.0,-0.7313642756680707,69.01108269394715,0.7159545610908606,0.4177694389091396,0.068428530710135,0.05643426331143064,0.011994267398704357,0.0645,0.06830857142857141,1176340090.4199986,0.14573999999999998,29.447582715868247,-25.357273726639807,74.6427262733602,83.13085347661458,0.7137333333333333,0.69638658747776,0.6408428571428572,0.654964438126995,0.5668620000000001,0.5764046726208671,275826.0,23327213.966666657,533241.0,21671158.342857145
2021-09-04,0.7332,0.7332,0.6934,0.7032,25515188.0,33389.0,9215517.0,0.7142666666666666,0.6871857142857144,0.5887455,0.7091466468694401,0.6818049964464346,0.6020428272474673,64.9114419211127,0.7563443854974895,0.42114661450251056,0.07249848083828325,0.062224470402605585,0.010274010435677668,0.03979999999999995,0.06963571428571427,1178247329.4199986,0.1342500000000001,24.2468682085623,-26.310003664345906,73.6899963356541,77.74520581409553,-4.091653027823229,0.7057,0.76,0.6875,0.7338,27422427.0,55121.0,13477077.0,3.9818619810117633,69.777593016005,0.7416721174052816,0.4152538825947183,0.07254278572270823,0.05965596779368616,0.012886817929022062,0.07250000000000001,0.06972642857142855,1203762517.4199986,0.21292,30.446376193269707,-15.097105166727742,84.90289483327226,78.70033693955718,0.7167333333333333,0.7150932937388801,0.6653571428571429,0.6746733285952462,0.578463,0.5913947037998323,231956.0,19993516.266666662,555527.0,22257220.800000004
2021-09-05,0.704,0.7064,0.6603,0.6704,28171277.0,40963.0,11965960.0,0.7024666666666667,0.6963714285714285,0.5977245,0.6897733234347201,0.6789537473348259,0.6085530341762799,61.53228132339005,0.7624508699178625,0.4329981300821375,0.06902105130389558,0.06358378658286358,0.005437264721031995,0.04610000000000003,0.0694792857142857,1150076052.4199986,0.15480000000000005,20.048707112670993,-38.32905826310004,61.670941736899955,73.42127763527544,-4.772727272727268,0.7332,0.7332,0.6934,0.7032,25515188.0,33389.0,9215517.0,-4.091653027823229,64.9114419211127,0.7563443854974895,0.42114661450251056,0.07249848083828325,0.062224470402605585,0.010274010435677668,0.03979999999999995,0.06963571428571427,1178247329.4199986,0.1342500000000001,24.2468682085623,-26.310003664345906,73.6899963356541,77.74520581409553,0.7142666666666666,0.7091466468694401,0.6871857142857144,0.6818049964464346,0.5887455,0.6020428272474673,158520.0,13482231.333333327,562113.0,21314648.371428575
2021-09-06,0.67,0.84,0.6585,0.815,54516567.0,111844.0,30367386.9,0.7295333333333334,0.7233714285714286,0.6153150000000001,0.75238666171736,0.7129653105011194,0.6282146499690151,70.2848504137492,0.7940890637611762,0.43654093623882395,0.0770450475227783,0.06627603877084652,0.010769008751931777,0.1815,0.08012071428571428,1204592619.4199986,0.2527999999999999,45.52012284398099,-7.3986386504883175,92.60136134951168,75.9874331406886,21.641791044776106,0.704,0.7064,0.6603,0.6704,28171277.0,40963.0,11965960.0,-4.772727272727268,61.53228132339005,0.7624508699178625,0.4329981300821375,0.06902105130389558,0.06358378658286358,0.005437264721031995,0.04610000000000003,0.0694792857142857,1150076052.4199986,0.15480000000000005,20.048707112670993,-38.32905826310004,61.670941736899955,73.42127763527544,0.7024666666666667,0.6897733234347201,0.6963714285714285,0.6789537473348259,0.5977245,0.6085530341762799,129473.0,11552851.333333327,525313.0,19380933.057142857
2021-09-07,0.815,1.12,0.685,0.9115,239019782.7,553098.0,119193186.56,0.7989666666666665,0.7500428571428571,0.6358735,0.83194333085868,0.7625989828758395,0.6551942071148231,78.4824709794085,0.8500361305084918,0.4217108694915081,0.09015165370540401,0.07105116175775802,0.019100491947645987,0.43500000000000005,0.10649928571428571,1443612402.1199987,0.3611,74.99232068806634,-33.743324162485855,66.25667583751415,73.5096596413086,11.840490797546016,0.67,0.84,0.6585,0.815,54516567.0,111844.0,30367386.9,21.641791044776106,70.2848504137492,0.7940890637611762,0.43654093623882395,0.0770450475227783,0.06627603877084652,0.010769008751931777,0.1815,0.08012071428571428,1204592619.4199986,0.2527999999999999,45.52012284398099,-7.3986386504883175,92.60136134951168,75.9874331406886,0.7295333333333334,0.75238666171736,0.7233714285714286,0.7129653105011194,0.6153150000000001,0.6282146499690151,186196.0,17182954.633333325,517143.0,19286797.542857144
2021-09-08,0.9099,1.1985,0.8523,0.8872,151871994.13,317793.0,75255835.33,0.8712333333333332,0.7752714285714285,0.6529715,0.8595716654293399,0.7937492371568796,0.6772899969134114,74.03882468464386,0.8900437739699106,0.41589922603008944,0.09745453144158767,0.07633183569452395,0.021122695747063713,0.34619999999999995,0.12551428571428572,1291740407.9899988,0.2811,55.936374022321836,-44.70132107983917,55.29867892016084,71.3855720357289,-2.494779646114963,0.815,1.12,0.685,0.9115,239019782.7,553098.0,119193186.56,11.840490797546016,78.4824709794085,0.8500361305084918,0.4217108694915081,0.09015165370540401,0.07105116175775802,0.019100491947645987,0.43500000000000005,0.10649928571428571,1443612402.1199987,0.3611,74.99232068806634,-33.743324162485855,66.25667583751415,73.5096596413086,0.7989666666666665,0.83194333085868,0.7500428571428571,0.7625989828758395,0.6358735,0.6551942071148231,705905.0,53842177.81999999,971250.0,32960371.32285714
2021-09-09,0.8874,1.036,0.8256,0.8977,94158824.0,206194.0,46983227.0,0.8988,0.8026857142857143,0.66973,0.8786358327146699,0.8197369278676597,0.6982814257788008,80.85931190437732,0.926454684397408,0.41300531560259207,0.10290317318427766,0.0816461031924747,0.021257069991802963,0.21040000000000003,0.13551428571428573,1385899231.9899988,0.27170000000000005,74.10783553141972,-43.193566915565754,56.806433084434246,59.453929280703086,1.1606941627225702,0.9099,1.1985,0.8523,0.8872,151871994.13,317793.0,75255835.33,-2.494779646114963,74.03882468464386,0.8900437739699106,0.41589922603008944,0.09745453144158767,0.07633183569452395,0.021122695747063713,0.34619999999999995,0.12551428571428572,1291740407.9899988,0.2811,55.936374022321836,-44.70132107983917,55.29867892016084,71.3855720357289,0.8712333333333332,0.8595716654293399,0.7752714285714285,0.7937492371568796,0.6529715,0.6772899969134114,982735.0,74938802.92999999,1182218.0,39604151.82714285
2021-09-10,0.8976,0.9428,0.761,0.7903,63359418.0,117491.0,31380435.0,0.8583999999999999,0.8107571428571428,0.6809464999999999,0.834467916357335,0.8123776959007447,0.7070450995141532,66.77452566553904,0.9381851632374922,0.42370783676250756,0.09743184494069534,0.08480325154211883,0.012628593398576513,0.18179999999999996,0.14415714285714287,1322539813.9899988,0.0655,40.572749911063674,-61.153558052434455,38.846441947565545,50.317184650720215,-11.954099821746876,0.8874,1.036,0.8256,0.8977,94158824.0,206194.0,46983227.0,1.1606941627225702,80.85931190437732,0.926454684397408,0.41300531560259207,0.10290317318427766,0.0816461031924747,0.021257069991802963,0.21040000000000003,0.13551428571428573,1385899231.9899988,0.27170000000000005,74.10783553141972,-43.193566915565754,56.806433084434246,59.453929280703086,0.8988,0.8786358327146699,0.8026857142857143,0.8197369278676597,0.66973,0.6982814257788008,1077085.0,80477416.29666667,1318402.0,43779741.398571424
2021-09-11,0.7909,0.9704,0.7552,0.9472,71792168.0,156825.0,36286459.0,0.8784,0.8456142857142857,0.7003845,0.8908339581786675,0.8460832719255585,0.7299169947985196,74.04848484848485,0.9766917598223361,0.42407724017766385,0.10455109665936224,0.08875282056556752,0.015798276093794722,0.21520000000000006,0.15679285714285715,1394331981.9899988,0.23660000000000003,72.09302325581397,-38.31376734258269,61.68623265741731,52.446369229805704,19.762296118346185,0.8976,0.9428,0.761,0.7903,63359418.0,117491.0,31380435.0,-11.954099821746876,66.77452566553904,0.9381851632374922,0.42370783676250756,0.09743184494069534,0.08480325154211883,0.012628593398576513,0.18179999999999996,0.14415714285714287,1322539813.9899988,0.0655,40.572749911063674,-61.153558052434455,38.846441947565545,50.317184650720215,0.8583999999999999,0.834467916357335,0.8107571428571428,0.8123776959007447,0.6809464999999999,0.7070450995141532,641478.0,51206499.10999999,1380772.0,46337363.96999999
2021-09-12,0.9475,0.9888,0.8363,0.8795,47856619.0,97211.0,24237604.0,0.8723333333333333,0.8754857142857143,0.7163565000000001,0.8851669790893337,0.8544374539441688,0.7441629952938986,66.3321385902031,0.9954269061532288,0.43728609384677125,0.1035368226878407,0.09170962099002217,0.011827201697818535,0.15249999999999997,0.1620857142857143,1346475362.9899988,0.17369999999999997,45.10806797558158,-52.141222621771824,47.858777378228176,49.46381732773702,-7.176781002638529,0.7909,0.9704,0.7552,0.9472,71792168.0,156825.0,36286459.0,19.762296118346185,74.04848484848485,0.9766917598223361,0.42407724017766385,0.10455109665936224,0.08875282056556752,0.015798276093794722,0.21520000000000006,0.15679285714285715,1394331981.9899988,0.23660000000000003,72.09302325581397,-38.31376734258269,61.68623265741731,52.446369229805704,0.8784,0.8908339581786675,0.8456142857142857,0.8460832719255585,0.7003845,0.7299169947985196,480510.0,38216706.99999999,1504208.0,50204641.398571424
2021-09-13,0.8795,0.9308,0.7844,0.899,44172143.0,104766.0,21950659.0,0.9085666666666666,0.8874857142857143,0.7352625,0.8920834895446669,0.8655780904581266,0.7589093766944797,66.31604111881424,1.0097688451955775,0.46075615480442256,0.10311781233764206,0.09399125925954616,0.0091265530780959,0.14639999999999997,0.1649214285714286,1390647505.9899988,0.1652,43.61022364217253,-51.825575359058654,48.174424640941346,52.573144892195614,2.217168845935199,0.9475,0.9888,0.8363,0.8795,47856619.0,97211.0,24237604.0,-7.176781002638529,66.3321385902031,0.9954269061532288,0.43728609384677125,0.1035368226878407,0.09170962099002217,0.011827201697818535,0.15249999999999997,0.1620857142857143,1346475362.9899988,0.17369999999999997,45.10806797558158,-52.141222621771824,47.858777378228176,49.46381732773702,0.8723333333333333,0.8851669790893337,0.8754857142857143,0.8544374539441688,0.7163565000000001,0.7441629952938986,371527.0,30634832.666666657,1560456.0,51957733.398571424
2021-09-14,0.8995,1.01,0.8586,0.9085,43030948.0,99207.0,21105443.0,0.8956666666666666,0.8870571428571429,0.7522399999999999,0.9002917447723334,0.876308567843595,0.7731561027235769,62.29091395691154,1.0254343237446888,0.47904567625531097,0.10237223086853875,0.09566745358134468,0.006704777287194069,0.15139999999999998,0.16792142857142858,1433678453.9899988,0.20529999999999993,25.34492273730684,-53.703703703703695,46.296296296296305,47.443166105155285,1.0005558643690948,0.8795,0.9308,0.7844,0.899,44172143.0,104766.0,21950659.0,2.217168845935199,66.31604111881424,1.0097688451955775,0.46075615480442256,0.10311781233764206,0.09399125925954616,0.0091265530780959,0.14639999999999997,0.1649214285714286,1390647505.9899988,0.1652,43.61022364217253,-51.825575359058654,48.174424640941346,52.573144892195614,0.9085666666666666,0.8920834895446669,0.8874857142857143,0.8655780904581266,0.7352625,0.7589093766944797,358802.0,27491573.99999999,1553378.0,50755343.69857143
2021-09-15,0.9087,0.985,0.87,0.9497,34829829.0,69685.0,18398751.0,0.9190666666666667,0.8959857142857144,0.773945,0.9249958723861667,0.8946564258826962,0.7899698072260933,65.4397520340953,1.0367584137007755,0.5111315862992245,0.10390806041988476,0.0973155749490527,0.006592485470832063,0.11499999999999999,0.16845,1468508282.9899988,0.2793,33.64762172811708,-46.07407407407406,53.92592592592593,49.46554895438786,4.511940134257735,0.8995,1.01,0.8586,0.9085,43030948.0,99207.0,21105443.0,1.0005558643690948,62.29091395691154,1.0254343237446888,0.47904567625531097,0.10237223086853875,0.09566745358134468,0.006704777287194069,0.15139999999999998,0.16792142857142858,1433678453.9899988,0.20529999999999993,25.34492273730684,-53.703703703703695,46.296296296296305,47.443166105155285,0.8956666666666666,0.9002917447723334,0.8870571428571429,0.876308567843595,0.7522399999999999,0.7731561027235769,301184.0,22431235.333333325,1099487.0,36742808.904285714
2021-09-16,0.9497,1.0285,0.8891,0.9098,48923309.0,97146.0,24998726.0,0.9226666666666666,0.8977142857142857,0.791325,0.9173979361930833,0.8984423194120222,0.801382206537894,62.60192735359526,1.0408154607394888,0.5418345392605111,0.10074430225732245,0.09800132041070667,0.002742981846615783,0.13939999999999997,0.17379999999999998,1419584973.9899988,0.0948000000000001,28.903372060073696,-53.46296296296295,46.53703703703706,48.919753086419774,-4.201326734758338,0.9087,0.985,0.87,0.9497,34829829.0,69685.0,18398751.0,4.511940134257735,65.4397520340953,1.0367584137007755,0.5111315862992245,0.10390806041988476,0.0973155749490527,0.006592485470832063,0.11499999999999999,0.16845,1468508282.9899988,0.2793,33.64762172811708,-46.07407407407406,53.92592592592593,49.46554895438786,0.9190666666666667,0.9249958723861667,0.8959857142857144,0.8946564258826962,0.773945,0.7899698072260933,273658.0,20484950.99999999,851379.0,28620368.285714287
2021-09-17,0.9108,0.945,0.822,0.8253,62602587.0,65304.0,32775888.0,0.8949333333333334,0.9027142857142858,0.80507,0.8713489680965416,0.8801567395590166,0.8036600916295232,55.283520036955764,1.027495397073177,0.5826446029268229,0.09037675039483262,0.09647640640753186,-0.006099656012699239,0.123,0.17740714285714285,1356982386.9899988,-0.08619999999999994,12.469337694194603,-69.1111111111111,30.888888888888903,43.78395061728398,-9.387351778656129,0.9497,1.0285,0.8891,0.9098,48923309.0,97146.0,24998726.0,-4.201326734758338,62.60192735359526,1.0408154607394888,0.5418345392605111,0.10074430225732245,0.09800132041070667,0.002742981846615783,0.13939999999999997,0.17379999999999998,1419584973.9899988,0.0948000000000001,28.903372060073696,-53.46296296296295,46.53703703703706,48.919753086419774,0.9226666666666666,0.9173979361930833,0.8977142857142857,0.8984423194120222,0.791325,0.801382206537894,266038.0,21500973.333333325,742331.0,25479725.285714287
2021-09-18,0.8259,0.8883,0.8061,0.8385,117785111.0,64199.0,59921045.0,0.8578666666666667,0.8871857142857144,0.81669,0.8549244840482708,0.8697425546692625,0.8069781781409973,57.97289334119033,1.0186931464059348,0.6146868535940654,0.08227708155220004,0.09363654143646549,-0.011359459884265455,0.08219999999999994,0.18043571428571428,1474767497.9899988,-0.048699999999999966,19.240614334470997,-66.66666666666666,33.33333333333335,36.91975308641978,1.5256084271703665,0.9108,0.945,0.822,0.8253,62602587.0,65304.0,32775888.0,-9.387351778656129,55.283520036955764,1.027495397073177,0.5826446029268229,0.09037675039483262,0.09647640640753186,-0.006099656012699239,0.123,0.17740714285714285,1356982386.9899988,-0.08619999999999994,12.469337694194603,-69.1111111111111,30.888888888888903,43.78395061728398,0.8949333333333334,0.8713489680965416,0.9027142857142858,0.8801567395590166,0.80507,0.8036600916295232,232135.0,25391121.666666657,690144.0,25679075.714285713
2021-09-19,0.8379,0.847,0.7575,0.7651,114348112.0,62609.0,60805290.0,0.8096333333333333,0.870842857142857,0.823645,0.8100122420241354,0.8435819160019469,0.802989780222807,55.32561016758519,1.0066931383335302,0.6405968616664697,0.06913828594555393,0.08873689033828319,-0.019598604392729257,0.08950000000000002,0.18353571428571427,1360419385.9899988,-0.13260000000000005,14.125894988066822,-80.25925925925925,19.740740740740748,27.987654320987676,-8.688387635756053,0.8259,0.8883,0.8061,0.8385,117785111.0,64199.0,59921045.0,1.5256084271703665,57.97289334119033,1.0186931464059348,0.6146868535940654,0.08227708155220004,0.09363654143646549,-0.011359459884265455,0.08219999999999994,0.18043571428571428,1474767497.9899988,-0.048699999999999966,19.240614334470997,-66.66666666666666,33.33333333333335,36.91975308641978,0.8578666666666667,0.8549244840482708,0.8871857142857144,0.8697425546692625,0.81669,0.8069781781409973,226649.0,39231886.33333332,597518.0,29055445.14285714
2021-09-20,0.7652,0.7679,0.6219,0.6805,188360946.0,128287.0,117414306.0,0.7613666666666666,0.8396285714285714,0.82143,0.7452561210120676,0.8028114370014602,0.7913240868682538,41.888795079001326,1.0104877644948556,0.6323722355051444,0.05130773912045461,0.08125106009471747,-0.02994332097426286,0.14600000000000002,0.18100000000000002,1172058439.9899988,-0.10980000000000001,-16.50306748466257,-89.83697537287549,10.163024627124523,21.079032900399547,-11.069001568217459,0.8379,0.847,0.7575,0.7651,114348112.0,62609.0,60805290.0,-8.688387635756053,55.32561016758519,1.0066931383335302,0.6405968616664697,0.06913828594555393,0.08873689033828319,-0.019598604392729257,0.08950000000000002,0.18353571428571427,1360419385.9899988,-0.13260000000000005,14.125894988066822,-80.25925925925925,19.740740740740748,27.987654320987676,0.8096333333333333,0.8100122420241354,0.870842857142857,0.8435819160019469,0.823645,0.802989780222807,192112.0,51167407.66666666,562916.0,34279400.28571428
2021-09-21,0.6811,0.722,0.58,0.6031,113118723.0,90873.0,71611788.0,0.6829,0.7959999999999999,0.8160550000000001,0.6741780605060338,0.7528835777510952,0.7733979833569915,30.962962962962962,1.023589585323184,0.6085204146768162,0.030578874922778887,0.07111662306032976,-0.04053774813755087,0.14200000000000002,0.1600714285714286,1058939716.9899988,-0.3441000000000001,-33.83433900164564,-96.26515763945028,3.7348423605497194,11.212869242805006,-11.45206283952431,0.7652,0.7679,0.6219,0.6805,188360946.0,128287.0,117414306.0,-11.069001568217459,41.888795079001326,1.0104877644948556,0.6323722355051444,0.05130773912045461,0.08125106009471747,-0.02994332097426286,0.14600000000000002,0.18100000000000002,1172058439.9899988,-0.10980000000000001,-16.50306748466257,-89.83697537287549,10.163024627124523,21.079032900399547,0.7613666666666666,0.7452561210120676,0.8396285714285714,0.8028114370014602,0.82143,0.7913240868682538,255095.0,79380213.66666666,586437.0,47917064.14285714
2021-09-22,0.6029,0.7451,0.587,0.743,40485788.0,66512.0,20627503.0,0.6755333333333332,0.7664714285714285,0.817915,0.7085890302530169,0.7504126833133213,0.7705029373229924,42.2104580812446,1.0219258591021116,0.6139041408978883,0.0251499485579586,0.06192328815985553,-0.03677333960189693,0.15810000000000002,0.14663571428571429,1099425504.9899988,-0.13649999999999995,-16.253381424706948,-64.25438596491227,35.74561403508772,16.54782700758733,23.237684524796816,0.6811,0.722,0.58,0.6031,113118723.0,90873.0,71611788.0,-11.45206283952431,30.962962962962962,1.023589585323184,0.6085204146768162,0.030578874922778887,0.07111662306032976,-0.04053774813755087,0.14200000000000002,0.1600714285714286,1058939716.9899988,-0.3441000000000001,-33.83433900164564,-96.26515763945028,3.7348423605497194,11.212869242805006,0.6829,0.6741780605060338,0.7959999999999999,0.7528835777510952,0.8160550000000001,0.7733979833569915,281769.0,83277127.99999999,578103.0,55132256.28571428
2021-09-23,0.7436,0.8695,0.6981,0.8443,51299536.0,97822.0,28170455.0,0.7301333333333333,0.7571142857142857,0.8234400000000001,0.7764445151265085,0.773884512484991,0.7775312290065169,47.37308146399055,1.0238119530746512,0.623068046925349,0.0286908188013848,0.05527679428816139,-0.02658597548677659,0.1714,0.14385,1150725040.9899988,-0.05469999999999997,-5.948535145371503,-41.07023411371236,58.92976588628764,32.80340742730837,13.542227003765467,0.6029,0.7451,0.587,0.743,40485788.0,66512.0,20627503.0,23.237684524796816,42.2104580812446,1.0219258591021116,0.6139041408978883,0.0251499485579586,0.06192328815985553,-0.03677333960189693,0.15810000000000002,0.14663571428571429,1099425504.9899988,-0.13649999999999995,-16.253381424706948,-64.25438596491227,35.74561403508772,16.54782700758733,0.6755333333333332,0.7085890302530169,0.7664714285714285,0.7504126833133213,0.817915,0.7705029373229924,285672.0,69884532.33333333,574930.0,55450649.428571425
2021-09-24,0.8444,0.87,0.6947,0.8129,94194589.0,149540.0,46462186.0,0.8000666666666666,0.7553428571428572,0.8289250000000001,0.7946722575632542,0.7836383843637432,0.7808996833868487,51.201616333475116,1.0212838190418125,0.6365661809581877,0.0286332006866743,0.04994807556786397,-0.021314874881189674,0.1753,0.14338571428571428,1056530451.9899988,-0.09560000000000002,2.859673541693031,-48.07134894091416,51.92865105908584,48.86801032682041,-3.7304594978683188,0.7436,0.8695,0.6981,0.8443,51299536.0,97822.0,28170455.0,13.542227003765467,47.37308146399055,1.0238119530746512,0.623068046925349,0.0286908188013848,0.05527679428816139,-0.02658597548677659,0.1714,0.14385,1150725040.9899988,-0.05469999999999997,-5.948535145371503,-41.07023411371236,58.92976588628764,32.80340742730837,0.7301333333333333,0.7764445151265085,0.7571142857142857,0.773884512484991,0.8234400000000001,0.7775312290065169,255207.0,40136581.99999999,575606.0,55903753.571428575
2021-09-25,0.8129,0.8838,0.7728,0.8359,66519121.0,125192.0,33873132.0,0.8310333333333334,0.7549714285714285,0.8371999999999999,0.8152861287816271,0.7967037882728074,0.7861378087785774,43.099814011159324,1.0144943196762846,0.6599056803237153,0.030096511842537477,0.04597776282279868,-0.015881250980261205,0.11099999999999999,0.13594285714285714,1123049572.9899988,-0.11380000000000001,-11.750422297297302,-42.943143812709025,57.056856187290975,55.97175771088816,2.8293763070488405,0.8444,0.87,0.6947,0.8129,94194589.0,149540.0,46462186.0,-3.7304594978683188,51.201616333475116,1.0212838190418125,0.6365661809581877,0.0286332006866743,0.04994807556786397,-0.021314874881189674,0.1753,0.14338571428571428,1056530451.9899988,-0.09560000000000002,2.859673541693031,-48.07134894091416,51.92865105908584,48.86801032682041,0.8000666666666666,0.7946722575632542,0.7553428571428572,0.7836383843637432,0.8289250000000001,0.7808996833868487,313874.0,31753381.333333325,659842.0,57858939.0
2021-09-26,0.8353,0.875,0.7651,0.8114,44821660.0,87133.0,21157519.0,0.8200666666666666,0.7615857142857143,0.8370200000000001,0.8133430643908135,0.8003778412046055,0.7885437317520463,45.53910651120137,1.014416500291839,0.6596234997081611,0.028945584550492454,0.04257132716833744,-0.013625742617844987,0.1099,0.1329,1078227912.9899988,-0.09840000000000004,-7.743035815804433,-48.40579710144927,51.59420289855073,53.52657004830919,-2.861247456003835,0.8129,0.8838,0.7728,0.8359,66519121.0,125192.0,33873132.0,2.8293763070488405,43.099814011159324,1.0144943196762846,0.6599056803237153,0.030096511842537477,0.04597776282279868,-0.015881250980261205,0.11099999999999999,0.13594285714285714,1123049572.9899988,-0.11380000000000001,-11.750422297297302,-42.943143812709025,57.056856187290975,55.97175771088816,0.8310333333333334,0.8152861287816271,0.7549714285714285,0.7967037882728074,0.8371999999999999,0.7861378087785774,372554.0,36168590.99999999,720835.0,54137808.571428575
2021-09-27,0.811,0.8308,0.7339,0.7378,42508761.0,60952.0,23110807.0,0.7950333333333334,0.7697714285714286,0.828335,0.7755715321954068,0.7847333809034541,0.7837109953947086,40.13946660141914,1.0073786380209928,0.6492913619790072,0.021842771606007116,0.03842561605587138,-0.016582844449864263,0.09689999999999999,0.1293642857142857,1035719151.9899988,-0.08750000000000002,-17.931034482758623,-64.81605351170568,35.183946488294325,47.94500185804535,-9.025893958076454,0.8353,0.875,0.7651,0.8114,44821660.0,87133.0,21157519.0,-2.861247456003835,45.53910651120137,1.014416500291839,0.6596234997081611,0.028945584550492454,0.04257132716833744,-0.013625742617844987,0.1099,0.1329,1078227912.9899988,-0.09840000000000004,-7.743035815804433,-48.40579710144927,51.59420289855073,53.52657004830919,0.8200666666666666,0.8133430643908135,0.7615857142857143,0.8003778412046055,0.8370200000000001,0.7885437317520463,361865.0,33830945.66666666,745359.0,48473841.28571428
2021-09-28,0.7366,0.7545,0.681,0.684,95677823.0,67156.0,67491253.0,0.7444000000000001,0.7813285714285714,0.8181749999999999,0.7297857660977034,0.7595500356775906,0.7742147101190221,36.973424625739824,1.0060002028938289,0.6303497971061709,0.011737231303564188,0.03308793910540994,-0.021350707801845753,0.0734999999999999,0.1238,940041328.9899988,-0.15449999999999997,-24.71106219042377,-76.81159420289852,23.18840579710147,36.65551839464885,-7.14091773011132,0.811,0.8308,0.7339,0.7378,42508761.0,60952.0,23110807.0,-9.025893958076454,40.13946660141914,1.0073786380209928,0.6492913619790072,0.021842771606007116,0.03842561605587138,-0.016582844449864263,0.09689999999999999,0.1293642857142857,1035719151.9899988,-0.08750000000000002,-17.931034482758623,-64.81605351170568,35.183946488294325,47.94500185804535,0.7950333333333334,0.7755715321954068,0.7697714285714286,0.7847333809034541,0.828335,0.7837109953947086,273277.0,26047152.666666657,678024.0,35001912.85714286
2021-09-29,0.6837,0.7531,0.6718,0.6981,37774862.0,55047.0,20999067.0,0.7066333333333333,0.7749142857142858,0.8081949999999999,0.7139428830488517,0.744187526758193,0.7669656901076867,34.92691109513541,0.9994092526619165,0.6169807473380833,0.0048108139007548845,0.02743251406447893,-0.022621700163724046,0.08130000000000004,0.12139285714285715,977816190.9899988,-0.06699999999999995,-26.49257660313783,-73.66778149386843,26.33221850613157,28.234856930509135,2.1061869240895246,0.7366,0.7545,0.681,0.684,95677823.0,67156.0,67491253.0,-7.14091773011132,36.973424625739824,1.0060002028938289,0.6303497971061709,0.011737231303564188,0.03308793910540994,-0.021350707801845753,0.0734999999999999,0.1238,940041328.9899988,-0.15449999999999997,-24.71106219042377,-76.81159420289852,23.18840579710147,36.65551839464885,0.7444000000000001,0.7297857660977034,0.7813285714285714,0.7595500356775906,0.8181749999999999,0.7742147101190221,215241.0,37253192.99999999,654307.0,34413265.0
2021-09-30,0.6978,0.7744,0.6912,0.7229,32909846.0,57223.0,15656222.0,0.7016666666666667,0.7575714285714286,0.8048250000000001,0.7184214415244259,0.7388656450686448,0.7627689577164785,38.59670530811471,0.9997077434233549,0.6099422565766454,0.0013076570877190719,0.02220754266912696,-0.020899885581407887,0.08319999999999994,0.11737857142857143,1010726036.9899988,0.04239999999999999,-20.542976478346898,-60.84931506849314,39.15068493150686,29.557103078246644,3.5970192032100905,0.6837,0.7531,0.6718,0.6981,37774862.0,55047.0,20999067.0,2.1061869240895246,34.92691109513541,0.9994092526619165,0.6169807473380833,0.0048108139007548845,0.02743251406447893,-0.022621700163724046,0.08130000000000004,0.12139285714285715,977816190.9899988,-0.06699999999999995,-26.49257660313783,-73.66778149386843,26.33221850613157,28.234856930509135,0.7066333333333333,0.7139428830488517,0.7749142857142858,0.744187526758193,0.8081949999999999,0.7669656901076867,183155.0,37200375.66666666,642842.0,34466345.571428575
2021-10-01,0.7224,0.815,0.7157,0.7902,32051783.0,66512.0,15718688.0,0.7370666666666666,0.7543285714285713,0.796975,0.754310720762213,0.7516992338014836,0.7653814379339567,47.812538950517265,0.9799978041586834,0.6139521958413166,0.00391677745257446,0.01854938962581646,-0.014632612173242,0.09929999999999994,0.11568571428571427,1042777819.9899988,0.18710000000000004,-4.252998909487459,-31.81965617904637,68.18034382095362,44.55441575286403,9.385382059800659,0.6978,0.7744,0.6912,0.7229,32909846.0,57223.0,15656222.0,3.5970192032100905,38.59670530811471,0.9997077434233549,0.6099422565766454,0.0013076570877190719,0.02220754266912696,-0.020899885581407887,0.08319999999999994,0.11737857142857143,1010726036.9899988,0.04239999999999999,-20.542976478346898,-60.84931506849314,39.15068493150686,29.557103078246644,0.7016666666666667,0.7184214415244259,0.7575714285714286,0.7388656450686448,0.8048250000000001,0.7627689577164785,179426.0,34715513.99999999,602243.0,32678598.0
2021-10-02,0.79,0.85,0.7729,0.8018,168519624.0,73612.0,93700045.0,0.7716333333333333,0.7494571428571428,0.7930900000000001,0.7780553603811065,0.7642244253511128,0.768849872416437,47.70825527663295,0.9719892295002748,0.6141907704997254,0.006841680559483088,0.016207847812549785,-0.009366167253066698,0.07709999999999995,0.11532142857142857,1211297443.9899988,0.05879999999999996,-4.376863446630896,-26.991441737985532,73.00855826201446,60.11319567149167,1.4936708860759393,0.7224,0.815,0.7157,0.7902,32051783.0,66512.0,15718688.0,9.385382059800659,47.812538950517265,0.9799978041586834,0.6139521958413166,0.00391677745257446,0.01854938962581646,-0.014632612173242,0.09929999999999994,0.11568571428571427,1042777819.9899988,0.18710000000000004,-4.252998909487459,-31.81965617904637,68.18034382095362,44.55441575286403,0.7370666666666666,0.754310720762213,0.7543285714285713,0.7516992338014836,0.796975,0.7653814379339567,178782.0,17457992.333333325,519215.0,28286669.714285713
2021-10-03,0.8009,0.8234,0.7758,0.7957,136410980.0,68413.0,81624246.0,0.7958999999999999,0.7472142857142857,0.787925,0.7868776801905533,0.7720933190133346,0.7714070274243954,52.08617398418325,0.9597754720297402,0.6160745279702597,0.008568693756525692,0.014680017001344968,-0.006111323244819276,0.047599999999999976,0.11232857142857142,1074886463.9899988,-0.04860000000000009,3.999477192523848,-28.999341672152745,71.00065832784725,70.72985347027179,-0.6492695717317996,0.79,0.85,0.7729,0.8018,168519624.0,73612.0,93700045.0,1.4936708860759393,47.70825527663295,0.9719892295002748,0.6141907704997254,0.006841680559483088,0.016207847812549785,-0.009366167253066698,0.07709999999999995,0.11532142857142857,1211297443.9899988,0.05879999999999996,-4.376863446630896,-26.991441737985532,73.00855826201446,60.11319567149167,0.7716333333333333,0.7780553603811065,0.7494571428571428,0.7642244253511128,0.7930900000000001,0.768849872416437,197347.0,41691651.66666666,467635.0,36833371.571428575
2021-10-04,0.7956,0.7971,0.7283,0.7482,149070282.0,82044.0,110654615.0,0.7818999999999999,0.7487,0.77991,0.7675388400952766,0.7661199892600008,0.7691968343363578,54.86141031164728,0.9428014511019766,0.6170185488980234,0.006034944053279645,0.012951002411731903,-0.006916058358452258,0.06880000000000008,0.10681428571428568,925816181.9899988,-0.06469999999999998,9.948567229977945,-44.6346280447663,55.3653719552337,66.45819618169848,-5.957767722473604,0.8009,0.8234,0.7758,0.7957,136410980.0,68413.0,81624246.0,-0.6492695717317996,52.08617398418325,0.9597754720297402,0.6160745279702597,0.008568693756525692,0.014680017001344968,-0.006111323244819276,0.047599999999999976,0.11232857142857142,1074886463.9899988,-0.04860000000000009,3.999477192523848,-28.999341672152745,71.00065832784725,70.72985347027179,0.7958999999999999,0.7868776801905533,0.7472142857142857,0.7720933190133346,0.787925,0.7714070274243954,208537.0,63680992.99999999,448915.0,45471475.428571425
2021-10-05,0.7482,0.7822,0.7233,0.7402,138445248.0,70112.0,105471402.0,0.7613666666666665,0.7567285714285715,0.769435,0.7538694200476384,0.7596399919450005,0.7664352310662285,60.934758334662625,0.9120337713093967,0.6268362286906033,0.003342861590015289,0.01102937424738858,-0.007686512657373291,0.05889999999999995,0.1008785714285714,787370933.9899988,-0.09570000000000001,22.732548499419657,-48.382749326145564,51.61725067385444,59.32776031897847,-1.0692328254477423,0.7956,0.7971,0.7283,0.7482,149070282.0,82044.0,110654615.0,-5.957767722473604,54.86141031164728,0.9428014511019766,0.6170185488980234,0.006034944053279645,0.012951002411731903,-0.006916058358452258,0.06880000000000008,0.10681428571428568,925816181.9899988,-0.06469999999999998,9.948567229977945,-44.6346280447663,55.3653719552337,66.45819618169848,0.7818999999999999,0.7675388400952766,0.7487,0.7661199892600008,0.77991,0.7691968343363578,224069.0,95326302.0,470007.0,57977733.71428572
2021-10-06,0.7402,0.7509,0.6706,0.6967,95221584.0,65476.0,60584058.0,0.7283666666666666,0.7565285714285714,0.75878,0.7252847100238191,0.7439049939587503,0.7597937804884924,45.63619227144203,0.8884807990074078,0.6290792009925922,-0.002274500585932704,0.008368599280724323,-0.010643099866657027,0.08030000000000004,0.09532142857142856,692149349.9899988,-0.11470000000000002,-6.23149394347241,-87.75797373358348,12.242026266416513,39.74154963183489,-5.876790056741419,0.7482,0.7822,0.7233,0.7402,138445248.0,70112.0,105471402.0,-1.0692328254477423,60.934758334662625,0.9120337713093967,0.6268362286906033,0.003342861590015289,0.01102937424738858,-0.007686512657373291,0.05889999999999995,0.1008785714285714,787370933.9899988,-0.09570000000000001,22.732548499419657,-48.382749326145564,51.61725067385444,59.32776031897847,0.7613666666666665,0.7538694200476384,0.7567285714285715,0.7596399919450005,0.769435,0.7664352310662285,220569.0,99250087.66666667,472963.0,63403469.28571428
2021-10-07,0.6967,0.7361,0.6776,0.7133,133121492.0,76815.0,78978926.0,0.7167333333333333,0.7551571428571427,0.75318,0.7192923550119096,0.7362537454690627,0.7553658013943503,35.307312696276355,0.8804362536980608,0.6259237463019391,-0.0053254310589867515,0.005629793212782109,-0.01095522427176886,0.058499999999999996,0.08725714285714285,825270841.9899988,-0.024499999999999966,-15.515811915196021,-79.97185741088177,20.02814258911823,27.962473176463067,2.3826611166929896,0.7402,0.7509,0.6706,0.6967,95221584.0,65476.0,60584058.0,-5.876790056741419,45.63619227144203,0.8884807990074078,0.6290792009925922,-0.002274500585932704,0.008368599280724323,-0.010643099866657027,0.08030000000000004,0.09532142857142856,692149349.9899988,-0.11470000000000002,-6.23149394347241,-87.75797373358348,12.242026266416513,39.74154963183489,0.7283666666666666,0.7252847100238191,0.7565285714285714,0.7439049939587503,0.75878,0.7597937804884924,217632.0,92236691.66666667,483392.0,69058468.0
2021-10-08,0.7128,0.8,0.6872,0.7563,125457235.0,100737.0,67291892.0,0.7220999999999999,0.7503142857142857,0.74907,0.7377961775059547,0.741265309101797,0.7554547726901265,43.812855268911235,0.8698696357610486,0.6282703642389514,-0.00422487309845665,0.003658859950534357,-0.007883733048991006,0.11280000000000001,0.08279285714285714,950728076.9899988,0.07229999999999992,-6.962726042563661,-59.80300187617262,40.196998123827385,24.155722326454054,6.1026936026936,0.6967,0.7361,0.6776,0.7133,133121492.0,76815.0,78978926.0,2.3826611166929896,35.307312696276355,0.8804362536980608,0.6259237463019391,-0.0053254310589867515,0.005629793212782109,-0.01095522427176886,0.058499999999999996,0.08725714285714285,825270841.9899988,-0.024499999999999966,-15.515811915196021,-79.97185741088177,20.02814258911823,27.962473176463067,0.7167333333333333,0.7192923550119096,0.7551571428571427,0.7362537454690627,0.75318,0.7553658013943503,212403.0,81678128.66666666,502984.0,78104568.57142857
2021-10-09,0.7564,0.8869,0.743,0.7823,126911176.0,140923.0,76550362.0,0.7506333333333334,0.7475285714285714,0.74993,0.7600480887529774,0.7515239818263477,0.7580114610053525,44.17897480451781,0.8714528824023295,0.6284071175976704,-0.0012403918120190704,0.002679009598023672,-0.003919401410042742,0.14390000000000003,0.08514285714285712,1077639252.9899988,0.08419999999999994,-6.412250269170949,-48.3587609801202,51.64123901987979,37.28879324427515,3.424114225277636,0.7128,0.8,0.6872,0.7563,125457235.0,100737.0,67291892.0,6.1026936026936,43.812855268911235,0.8698696357610486,0.6282703642389514,-0.00422487309845665,0.003658859950534357,-0.007883733048991006,0.11280000000000001,0.08279285714285714,950728076.9899988,0.07229999999999992,-6.962726042563661,-59.80300187617262,40.196998123827385,24.155722326454054,0.7220999999999999,0.7377961775059547,0.7503142857142857,0.741265309101797,0.74907,0.7554547726901265,243028.0,68951625.33333333,537209.0,85472169.14285715
2021-10-10,0.7824,0.874,0.7632,0.7755,91388892.0,100315.0,47518747.0,0.7713666666666666,0.7446428571428572,0.7546799999999999,0.7677740443764887,0.7575179863697608,0.7596770361476999,45.94533544160831,0.8721347187105332,0.6372252812894666,0.0005695623789165882,0.002257120154202255,-0.001687557775285667,0.11080000000000001,0.08520714285714284,986250360.9899988,0.05259999999999998,-4.424451565195964,-51.50254276467871,48.4974572353213,46.7785647930095,-0.8819018404907998,0.7564,0.8869,0.743,0.7823,126911176.0,140923.0,76550362.0,3.424114225277636,44.17897480451781,0.8714528824023295,0.6284071175976704,-0.0012403918120190704,0.002679009598023672,-0.003919401410042742,0.14390000000000003,0.08514285714285712,1077639252.9899988,0.08419999999999994,-6.412250269170949,-48.3587609801202,51.64123901987979,37.28879324427515,0.7506333333333334,0.7600480887529774,0.7475285714285714,0.7515239818263477,0.74993,0.7580114610053525,318475.0,74273726.66666666,604520.0,83022214.42857143
2021-10-11,0.7753,0.8141,0.7218,0.7442,29763343.0,54519.0,14343590.0,0.7673333333333332,0.7440714285714286,0.761735,0.7559870221882443,0.7541884897773206,0.7582030327050617,50.79920079920079,0.855393984451163,0.6680760155488371,-0.0005157391795117539,0.0017025482874594533,-0.002218287466971207,0.09230000000000005,0.08487857142857143,956487017.9899988,-0.04600000000000004,0.8674437516942302,-65.97318539066113,34.02681460933887,44.72183695484667,-4.011350444989039,0.7824,0.874,0.7632,0.7755,91388892.0,100315.0,47518747.0,-0.8819018404907998,45.94533544160831,0.8721347187105332,0.6372252812894666,0.0005695623789165882,0.002257120154202255,-0.001687557775285667,0.11080000000000001,0.08520714285714284,986250360.9899988,0.05259999999999998,-4.424451565195964,-51.50254276467871,48.4974572353213,46.7785647930095,0.7713666666666666,0.7677740443764887,0.7446428571428572,0.7575179863697608,0.7546799999999999,0.7596770361476999,341975.0,63787000.33333332,636422.0,78150000.28571428
2021-10-12,0.7438,0.751,0.6871,0.7267,25791924.0,46943.0,12945971.0,0.7488,0.7421428571428571,0.7609199999999999,0.7413435110941222,0.7473163673329904,0.7552027438760083,55.86377368854709,0.8555441228840779,0.666295877115922,-0.002756180694753252,0.0008108024910169124,-0.003566983185770164,0.06389999999999996,0.08419285714285715,930695093.9899988,-0.07509999999999994,6.2426900584795275,-74.0638002773925,25.9361997226075,36.153490522422565,-2.2990051089002423,0.7753,0.8141,0.7218,0.7442,29763343.0,54519.0,14343590.0,-4.011350444989039,50.79920079920079,0.855393984451163,0.6680760155488371,-0.0005157391795117539,0.0017025482874594533,-0.002218287466971207,0.09230000000000005,0.08487857142857143,956487017.9899988,-0.04600000000000004,0.8674437516942302,-65.97318539066113,34.02681460933887,44.72183695484667,0.7673333333333332,0.7559870221882443,0.7440714285714286,0.7541884897773206,0.761735,0.7582030327050617,295757.0,46137566.33333332,608897.0,64391282.428571425
2021-10-13,0.727,0.7459,0.7003,0.7332,16154073.0,34712.0,7739720.0,0.7346999999999998,0.7473571428571428,0.755365,0.7372717555470611,0.7437872754997429,0.7531072444592456,54.92286115007012,0.8420941069941462,0.6686358930058537,-0.003961584381113381,-0.0001436748834091464,-0.0038179094977042346,0.045599999999999974,0.08164285714285713,946849166.9899988,-0.0625,5.027932960893833,-71.05871474803514,28.941285251964853,29.634766527970417,0.8528198074277831,0.7438,0.751,0.6871,0.7267,25791924.0,46943.0,12945971.0,-2.2990051089002423,55.86377368854709,0.8555441228840779,0.666295877115922,-0.002756180694753252,0.0008108024910169124,-0.003566983185770164,0.06389999999999996,0.08419285714285715,930695093.9899988,-0.07509999999999994,6.2426900584795275,-74.0638002773925,25.9361997226075,36.153490522422565,0.7488,0.7413435110941222,0.7421428571428571,0.7473163673329904,0.7609199999999999,0.7552027438760083,201777.0,24936102.666666657,585728.0,51173363.71428572
2021-10-14,0.7342,0.7588,0.7164,0.7326,26698757.0,35972.0,14688062.0,0.7308333333333333,0.7501142857142857,0.75135,0.7349358777735306,0.7409904566248072,0.7511541735583651,51.4595245260307,0.834212943276371,0.668487056723629,-0.004908705965798843,-0.0010966810998870858,-0.003812024865911757,0.04239999999999999,0.07872857142857144,920150409.9899988,-0.015599999999999947,1.3418176787937552,-71.33610725843734,28.663892741562663,27.84712590537835,-0.2179242713157089,0.727,0.7459,0.7003,0.7332,16154073.0,34712.0,7739720.0,0.8528198074277831,54.92286115007012,0.8420941069941462,0.6686358930058537,-0.003961584381113381,-0.0001436748834091464,-0.0038179094977042346,0.045599999999999974,0.08164285714285713,946849166.9899988,-0.0625,5.027932960893833,-71.05871474803514,28.941285251964853,29.634766527970417,0.7346999999999998,0.7372717555470611,0.7473571428571428,0.7437872754997429,0.755365,0.7531072444592456,136174.0,11676426.99999999,554964.0,43624172.571428575
2021-10-15,0.7321,0.758,0.7076,0.7525,64433913.0,60108.0,38229674.0,0.7394333333333333,0.7495714285714286,0.74718,0.7437179388867653,0.7438678424686054,0.7512823475051875,43.38364338364337,0.8199009692483745,0.6744590307516254,-0.004007348734816785,-0.0016788146268730255,-0.002328534107943759,0.0504,0.07523571428571428,984584322.9899988,0.012299999999999978,-4.770944064793737,-62.1359223300971,37.86407766990289,31.823085221143476,2.786504575877609,0.7342,0.7588,0.7164,0.7326,26698757.0,35972.0,14688062.0,-0.2179242713157089,51.4595245260307,0.834212943276371,0.668487056723629,-0.004908705965798843,-0.0010966810998870858,-0.003812024865911757,0.04239999999999999,0.07872857142857144,920150409.9899988,-0.015599999999999947,1.3418176787937552,-71.33610725843734,28.663892741562663,27.84712590537835,0.7308333333333333,0.7349358777735306,0.7501142857142857,0.7409904566248072,0.75135,0.7511541735583651,117627.0,11791250.99999999,514121.0,34439763.428571425
2021-10-16,0.7529,0.845,0.739,0.7676,73923069.0,103122.0,41217788.0,0.7509,0.7474714285714285,0.74499,0.7556589694433826,0.749800881851454,0.7528364096475506,44.07073509015256,0.8119801139603674,0.6779998860396327,-0.0020509309756733263,-0.0017532378966330859,-0.0002976930790402404,0.10599999999999998,0.07730000000000001,1058507391.9899988,0.07089999999999996,-4.265402843601896,-55.1548774849746,44.8451225150254,37.12436430883033,1.9524505246380577,0.7321,0.758,0.7076,0.7525,64433913.0,60108.0,38229674.0,2.786504575877609,43.38364338364337,0.8199009692483745,0.6744590307516254,-0.004007348734816785,-0.0016788146268730255,-0.002328534107943759,0.0504,0.07523571428571428,984584322.9899988,0.012299999999999978,-4.770944064793737,-62.1359223300971,37.86407766990289,31.823085221143476,0.7394333333333333,0.7437179388867653,0.7495714285714286,0.7438678424686054,0.74718,0.7512823475051875,130792.0,20219151.99999999,473492.0,30288018.0
2021-10-17,0.7675,0.7899,0.7254,0.742,35011934.0,50318.0,19510959.0,0.7540333333333332,0.7426857142857142,0.7452,0.7488294847216913,0.7478506613885905,0.7518043706334981,41.27963624553426,0.8121215094050829,0.6782784905949171,-0.0025369178484164756,-0.001909973886989764,-0.0006269439614267117,0.0645,0.07850714285714287,1023495457.9899988,0.028699999999999948,-6.748774663818013,-66.99029126213593,33.00970873786408,38.5729696409308,-3.3224755700325694,0.7529,0.845,0.739,0.7676,73923069.0,103122.0,41217788.0,1.9524505246380577,44.07073509015256,0.8119801139603674,0.6779998860396327,-0.0020509309756733263,-0.0017532378966330859,-0.0002976930790402404,0.10599999999999998,0.07730000000000001,1058507391.9899988,0.07089999999999996,-4.265402843601896,-55.1548774849746,44.8451225150254,37.12436430883033,0.7509,0.7556589694433826,0.7474714285714285,0.749800881851454,0.74499,0.7528364096475506,199202.0,31378507.99999999,435691.0,25240507.42857143
2021-10-18,0.742,0.764,0.7148,0.7274,20811594.0,36867.0,10835717.0,0.7456666666666667,0.7402857142857143,0.74737,0.7381147423608456,0.7427379960414429,0.7494801448588793,46.218181818181826,0.8084997877255468,0.6862402122744532,-0.004053438414258981,-0.0023386667924436074,-0.0017147716218153734,0.04920000000000002,0.07710714285714285,1002683863.9899988,-0.028899999999999926,-2.780005346164116,-73.74017568192322,26.259824318076774,34.704885190322095,-1.9676549865229038,0.7675,0.7899,0.7254,0.742,35011934.0,50318.0,19510959.0,-3.3224755700325694,41.27963624553426,0.8121215094050829,0.6782784905949171,-0.0025369178484164756,-0.001909973886989764,-0.0006269439614267117,0.0645,0.07850714285714287,1023495457.9899988,0.028699999999999948,-6.748774663818013,-66.99029126213593,33.00970873786408,38.5729696409308,0.7540333333333332,0.7488294847216913,0.7426857142857142,0.7478506613885905,0.7452,0.7518043706334981,213548.0,32986140.333333325,385694.0,21239394.85714286
2021-10-19,0.7271,0.7393,0.6944,0.7132,53375689.0,55790.0,23363620.0,0.7275333333333333,0.7383571428571428,0.7481249999999999,0.7256573711804228,0.7353534970310821,0.7460248929675574,45.19914651493598,0.8070249106424296,0.6892250893575702,-0.006328166055141193,-0.0031365666449831246,-0.003191599410158069,0.04489999999999994,0.07610714285714286,949308174.9899988,-0.06910000000000005,-3.647662793839501,-80.30513176144247,19.694868238557543,26.321467098166142,-1.9117040297070589,0.742,0.764,0.7148,0.7274,20811594.0,36867.0,10835717.0,-1.9676549865229038,46.218181818181826,0.8084997877255468,0.6862402122744532,-0.004053438414258981,-0.0023386667924436074,-0.0017147716218153734,0.04920000000000002,0.07710714285714285,1002683863.9899988,-0.028899999999999926,-2.780005346164116,-73.74017568192322,26.259824318076774,34.704885190322095,0.7456666666666667,0.7381147423608456,0.7402857142857143,0.7427379960414429,0.74737,0.7494801448588793,190307.0,23854821.333333325,368042.0,20738270.14285714
2021-10-20,0.7129,0.7614,0.7032,0.7384,54701952.0,59148.0,22396208.0,0.7263333333333333,0.7391,0.7489,0.7320286855902114,0.7361151227733116,0.7452987126849329,57.93077215671358,0.8068018407125088,0.6909981592874912,-0.006027987813038593,-0.0037148508785942187,-0.0023131369344443747,0.05819999999999992,0.07452857142857142,1004010126.9899988,-0.03710000000000002,5.985359552174541,-70.95078834209271,29.049211657907286,25.00130140484721,3.5769392621686027,0.7271,0.7393,0.6944,0.7132,53375689.0,55790.0,23363620.0,-1.9117040297070589,45.19914651493598,0.8070249106424296,0.6892250893575702,-0.006328166055141193,-0.0031365666449831246,-0.003191599410158069,0.04489999999999994,0.07610714285714286,949308174.9899988,-0.06910000000000005,-3.647662793839501,-80.30513176144247,19.694868238557543,26.321467098166142,0.7275333333333333,0.7256573711804228,0.7383571428571428,0.7353534970310821,0.7481249999999999,0.7460248929675574,142975.0,17903431.99999999,376889.0,22226505.714285713
2021-10-21,0.7385,0.7608,0.7161,0.7177,45773006.0,56672.0,20924652.0,0.7231,0.7369714285714286,0.745275,0.7248643427951057,0.7315113420799837,0.7426702638577964,50.82397003745317,0.8013386808976314,0.6892113191023687,-0.00737539246309471,-0.004446959195494317,-0.0029284332676003926,0.04470000000000007,0.07354285714285713,958237120.9899988,-0.026499999999999968,0.6168512547315208,-84.68468468468471,15.315315315315297,21.353131737260053,-2.8165199729180825,0.7129,0.7614,0.7032,0.7384,54701952.0,59148.0,22396208.0,3.5769392621686027,57.93077215671358,0.8068018407125088,0.6909981592874912,-0.006027987813038593,-0.0037148508785942187,-0.0023131369344443747,0.05819999999999992,0.07452857142857142,1004010126.9899988,-0.03710000000000002,5.985359552174541,-70.95078834209271,29.049211657907286,25.00130140484721,0.7263333333333333,0.7320286855902114,0.7391,0.7361151227733116,0.7489,0.7452987126849329,151805.0,18865181.666666657,401325.0,24320289.714285713
2021-10-22,0.7174,0.7729,0.7144,0.7578,45049154.0,64758.0,19380995.0,0.7379666666666665,0.7377285714285714,0.7430749999999999,0.7413321713975529,0.7380835065599878,0.7441111911094349,50.28398333964408,0.7929060778108542,0.6932439221891457,-0.0051481409215364815,-0.0045871955407027504,-0.0005609453808337311,0.058499999999999996,0.0696642857142857,1003286274.9899988,0.031100000000000017,0.19833399444666444,-64.61461461461462,35.38538538538538,26.583304119535995,5.631446891552828,0.7385,0.7608,0.7161,0.7177,45773006.0,56672.0,20924652.0,-2.8165199729180825,50.82397003745317,0.8013386808976314,0.6892113191023687,-0.00737539246309471,-0.004446959195494317,-0.0029284332676003926,0.04470000000000007,0.07354285714285713,958237120.9899988,-0.026499999999999968,0.6168512547315208,-84.68468468468471,15.315315315315297,21.353131737260053,0.7231,0.7248643427951057,0.7369714285714286,0.7315113420799837,0.745275,0.7426702638577964,171610.0,22228159.99999999,422025.0,25211231.14285714
2021-10-23,0.7574,0.802,0.7443,0.7654,54563701.0,84504.0,25310363.0,0.7469666666666667,0.7374142857142857,0.74156,0.7533660856987765,0.7449126299199909,0.7461386967180602,46.56084656084656,0.7862295657608744,0.6968904342391256,-0.002738207196138598,-0.00421739787178992,0.0014791906756513222,0.057700000000000085,0.06350714285714286,1057849975.9899988,0.032200000000000006,-2.1602965614214487,-58.10593900481544,41.89406099518456,30.86492056529509,1.0562450488513346,0.7174,0.7729,0.7144,0.7578,45049154.0,64758.0,19380995.0,5.631446891552828,50.28398333964408,0.7929060778108542,0.6932439221891457,-0.0051481409215364815,-0.0045871955407027504,-0.0005609453808337311,0.058499999999999996,0.0696642857142857,1003286274.9899988,0.031100000000000017,0.19833399444666444,-64.61461461461462,35.38538538538538,26.583304119535995,0.7379666666666665,0.7413321713975529,0.7377285714285714,0.7380835065599878,0.7430749999999999,0.7441111911094349,180578.0,20900618.333333325,426675.0,22518562.714285713
2021-10-24,0.7654,0.7788,0.726,0.7321,28799534.0,53893.0,15007356.0,0.7517666666666667,0.736,0.740755,0.7427330428493882,0.7417094724399931,0.7448016779830069,42.02792064658339,0.7855009483611507,0.6960090516388494,-0.0034752880985061685,-0.0040689759171331705,0.000593687818627002,0.05280000000000007,0.05936428571428572,1029050441.9899988,-0.000500000000000056,-5.596389426176662,-71.50094996833442,28.49905003166558,35.25949880407852,-4.350666318264959,0.7574,0.802,0.7443,0.7654,54563701.0,84504.0,25310363.0,1.0562450488513346,46.56084656084656,0.7862295657608744,0.6968904342391256,-0.002738207196138598,-0.00421739787178992,0.0014791906756513222,0.057700000000000085,0.06350714285714286,1057849975.9899988,0.032200000000000006,-2.1602965614214487,-58.10593900481544,41.89406099518456,30.86492056529509,0.7469666666666667,0.7533660856987765,0.7374142857142857,0.7449126299199909,0.74156,0.7461386967180602,205934.0,21872003.333333325,408057.0,20246073.42857143
2021-10-25,0.7322,0.7854,0.7294,0.7674,32387451.0,49728.0,17584980.0,0.7549666666666667,0.7417142857142857,0.7421149999999999,0.7550665214246941,0.7481321043299948,0.7469538991274824,54.199855177407684,0.7884163140657201,0.6958136859342796,-0.0011972142972442867,-0.003494623593155394,0.002297409295911107,0.05599999999999994,0.05677142857142857,1061437892.9899988,0.014900000000000024,3.1174415479709783,-49.145028499050056,50.854971500949944,40.416027509266705,4.807429664026224,0.7654,0.7788,0.726,0.7321,28799534.0,53893.0,15007356.0,-4.350666318264959,42.02792064658339,0.7855009483611507,0.6960090516388494,-0.0034752880985061685,-0.0040689759171331705,0.000593687818627002,0.05280000000000007,0.05936428571428572,1029050441.9899988,-0.000500000000000056,-5.596389426176662,-71.50094996833442,28.49905003166558,35.25949880407852,0.7517666666666667,0.7427330428493882,0.736,0.7417094724399931,0.740755,0.7448016779830069,203155.0,19899571.333333325,411632.0,19602701.57142857
2021-10-26,0.7673,0.845,0.7576,0.7947,61043941.0,117373.0,30751662.0,0.7647333333333332,0.753357142857143,0.747015,0.774883260712347,0.759774078247496,0.751501146829627,61.888111888111894,0.7938193306588507,0.7002106693411493,0.002779022604567749,-0.0022398943536107653,0.005018916958178514,0.08739999999999992,0.058449999999999995,1122481833.9899988,0.027100000000000013,9.357368928030807,-33.39973439575034,66.60026560424966,48.65142904562174,3.570963117424734,0.7322,0.7854,0.7294,0.7674,32387451.0,49728.0,17584980.0,4.807429664026224,54.199855177407684,0.7884163140657201,0.6958136859342796,-0.0011972142972442867,-0.003494623593155394,0.002297409295911107,0.05599999999999994,0.05677142857142857,1061437892.9899988,0.014900000000000024,3.1174415479709783,-49.145028499050056,50.854971500949944,40.416027509266705,0.7549666666666667,0.7550665214246941,0.7417142857142857,0.7481321043299948,0.7421149999999999,0.7469538991274824,188125.0,19300899.666666657,424493.0,20566882.0
2021-10-27,0.7947,0.84,0.7177,0.7204,44585343.0,83990.0,19904616.0,0.7608333333333333,0.7507857142857143,0.74737,0.7476416303561735,0.7499305586856221,0.7485391328458529,48.19106840022612,0.7931950724294013,0.7015449275705986,-6.442737383671737e-05,-0.001804800957655956,0.0017403735838192385,0.12229999999999996,0.06392857142857142,1077896490.9899988,-0.021599999999999953,-1.7457719585379006,-82.73572377158033,17.264276228419675,44.90650444453977,-9.349440040266758,0.7673,0.845,0.7576,0.7947,61043941.0,117373.0,30751662.0,3.570963117424734,61.888111888111894,0.7938193306588507,0.7002106693411493,0.002779022604567749,-0.0022398943536107653,0.005018916958178514,0.08739999999999992,0.058449999999999995,1122481833.9899988,0.027100000000000013,9.357368928030807,-33.39973439575034,66.60026560424966,48.65142904562174,0.7647333333333332,0.774883260712347,0.753357142857143,0.759774078247496,0.747015,0.751501146829627,220994.0,21114665.99999999,486076.0,21622316.57142857
2021-10-28,0.7201,0.7773,0.704,0.7385,30028250.0,56214.0,14815469.0,0.7512,0.7537571428571429,0.7464799999999999,0.7430708151780867,0.7470729190142166,0.7475830249557718,50.794505790465934,0.7922662125880692,0.7006937874119307,-0.0008475927144802053,-0.0016133593090208059,0.0007657665945406005,0.07330000000000003,0.06613571428571428,1107924740.9899988,0.011099999999999999,0.8053508053508018,-70.71713147410355,29.282868525896443,37.71580345285527,2.5552006665740987,0.7947,0.84,0.7177,0.7204,44585343.0,83990.0,19904616.0,-9.349440040266758,48.19106840022612,0.7931950724294013,0.7015449275705986,-6.442737383671737e-05,-0.001804800957655956,0.0017403735838192385,0.12229999999999996,0.06392857142857142,1077896490.9899988,-0.021599999999999953,-1.7457719585379006,-82.73572377158033,17.264276228419675,44.90650444453977,0.7608333333333333,0.7476416303561735,0.7507857142857143,0.7499305586856221,0.74737,0.7485391328458529,251091.0,22747085.99999999,510918.0,21266374.85714286
2021-10-29,0.7385,0.7619,0.7353,0.7421,18236928.0,35788.0,9056364.0,0.7336666666666667,0.7515142857142857,0.74447,0.7425854075890433,0.7458296892606624,0.7470608321028411,48.53521126760564,0.7870526799483182,0.7018873200516818,-0.001164345129919031,-0.001523556473200451,0.0003592113432814199,0.026600000000000068,0.06443571428571429,1126161668.9899988,0.028900000000000037,-1.382059800664448,-68.32669322709165,31.673306772908354,26.073483842408166,0.48747461069735093,0.7201,0.7773,0.704,0.7385,30028250.0,56214.0,14815469.0,2.5552006665740987,50.794505790465934,0.7922662125880692,0.7006937874119307,-0.0008475927144802053,-0.0016133593090208059,0.0007657665945406005,0.07330000000000003,0.06613571428571428,1107924740.9899988,0.011099999999999999,0.8053508053508018,-70.71713147410355,29.282868525896443,37.71580345285527,0.7512,0.7430708151780867,0.7537571428571429,0.7470729190142166,0.7464799999999999,0.7475830249557718,257577.0,21823915.666666657,510460.0,20393634.42857143
2021-10-30,0.7415,0.767,0.7222,0.7536,16332638.0,40413.0,8059632.0,0.7447333333333334,0.7498285714285714,0.7433750000000001,0.7480927037945218,0.7477722669454968,0.7476836099978087,48.007968127490045,0.783662434373797,0.7030875656262032,-0.00048186516902448684,-0.0013152182123652581,0.0008333530433407713,0.04480000000000006,0.06006428571428572,1142494306.9899988,0.015200000000000102,-1.823866597186019,-60.69057104913676,39.30942895086324,33.42186808322269,1.6318273769386378,0.7385,0.7619,0.7353,0.7421,18236928.0,35788.0,9056364.0,0.48747461069735093,48.53521126760564,0.7870526799483182,0.7018873200516818,-0.001164345129919031,-0.001523556473200451,0.0003592113432814199,0.026600000000000068,0.06443571428571429,1126161668.9899988,0.028900000000000037,-1.382059800664448,-68.32669322709165,31.673306772908354,26.073483842408166,0.7336666666666667,0.7425854075890433,0.7515142857142857,0.7458296892606624,0.74447,0.7470608321028411,175992.0,14592149.666666657,481490.0,18918687.14285714
2021-10-31,0.7536,0.9474,0.752,0.7807,78051936.0,181550.0,38987543.0,0.7587999999999999,0.7567714285714285,0.7452,0.7643963518972609,0.7560042002091226,0.7508280280932554,55.48313969963163,0.7888142902704083,0.7015857097295917,0.002220156055824596,-0.0006081433587272872,0.002828299414551883,0.19540000000000002,0.06941428571428572,1220546242.9899988,0.06299999999999994,5.215633423180588,-65.88932806324114,34.11067193675887,35.031135886843494,3.596072186836505,0.7415,0.767,0.7222,0.7536,16332638.0,40413.0,8059632.0,1.6318273769386378,48.007968127490045,0.783662434373797,0.7030875656262032,-0.00048186516902448684,-0.0013152182123652581,0.0008333530433407713,0.04480000000000006,0.06006428571428572,1142494306.9899988,0.015200000000000102,-1.823866597186019,-60.69057104913676,39.30942895086324,33.42186808322269,0.7447333333333334,0.7480927037945218,0.7498285714285714,0.7477722669454968,0.7433750000000001,0.7476836099978087,132415.0,10643821.666666657,437399.0,16454297.0
2021-11-01,0.7807,0.7889,0.7366,0.7885,21482729.0,57380.0,9746038.0,0.7742666666666667,0.7597857142857143,0.74829,0.7764481759486304,0.764128150156842,0.7544158349415169,58.82692863334296,0.7950303983948283,0.7015496016051718,0.0049340455504407466,0.0005002944231063194,0.004433751127334427,0.05230000000000001,0.06963571428571429,1242028971.9899988,0.03069999999999995,8.399780038493244,-62.80632411067195,37.19367588932805,36.87125892565007,0.999103368771619,0.7536,0.9474,0.752,0.7807,78051936.0,181550.0,38987543.0,3.596072186836505,55.48313969963163,0.7888142902704083,0.7015857097295917,0.002220156055824596,-0.0006081433587272872,0.002828299414551883,0.19540000000000002,0.06941428571428572,1220546242.9899988,0.06299999999999994,5.215633423180588,-65.88932806324114,34.11067193675887,35.031135886843494,0.7587999999999999,0.7643963518972609,0.7567714285714285,0.7560042002091226,0.7452,0.7508280280932554,257751.0,18701179.666666657,565056.0,19880038.0
2021-11-02,0.7883,0.9083,0.7813,0.8597,44945653.0,116691.0,22906892.0,0.8096333333333332,0.7690714285714285,0.754615,0.8180740879743151,0.7880211126176315,0.76444289828042,68.17166956090301,0.8223008463009495,0.6869291536990506,0.0126838558889526,0.002937006716275576,0.009746849172677024,0.127,0.07550000000000001,1286974624.9899988,0.09430000000000005,20.54122265844085,-35.91318591318592,64.08681408681409,45.13038730430035,9.057465431942155,0.7807,0.7889,0.7366,0.7885,21482729.0,57380.0,9746038.0,0.999103368771619,58.82692863334296,0.7950303983948283,0.7015496016051718,0.0049340455504407466,0.0005002944231063194,0.004433751127334427,0.05230000000000001,0.06963571428571429,1242028971.9899988,0.03069999999999995,8.399780038493244,-62.80632411067195,37.19367588932805,36.87125892565007,0.7742666666666667,0.7764481759486304,0.7597857142857143,0.764128150156842,0.74829,0.7544158349415169,279343.0,18931070.99999999,572708.0,18760189.14285714
2021-11-03,0.8598,0.9786,0.8435,0.8741,73077630.0,173964.0,36474710.0,0.8407666666666667,0.7910285714285715,0.76169,0.8460870439871575,0.8095408344632237,0.7748864317775228,67.29543716543463,0.8469788812399368,0.6764011187600631,0.019759817198168994,0.00630156881265426,0.013458248385514734,0.1351,0.08099285714285716,1360052254.9899988,0.14200000000000002,18.377573131094273,-38.05535324107794,61.94464675892206,54.40837891168807,1.6631774831356103,0.7883,0.9083,0.7813,0.8597,44945653.0,116691.0,22906892.0,9.057465431942155,68.17166956090301,0.8223008463009495,0.6869291536990506,0.0126838558889526,0.002937006716275576,0.009746849172677024,0.127,0.07550000000000001,1286974624.9899988,0.09430000000000005,20.54122265844085,-35.91318591318592,64.08681408681409,45.13038730430035,0.8096333333333332,0.8180740879743151,0.7690714285714285,0.7880211126176315,0.754615,0.76444289828042,355621.0,23880157.666666657,572026.0,17639507.714285713
2021-11-04,0.874,0.8986,0.7985,0.8325,39726208.0,84390.0,16743208.0,0.8554333333333334,0.8044571428571429,0.76569,0.8392935219935788,0.8152806258474178,0.7803734382749016,63.89157792836399,0.8564899744957192,0.6748900255042808,0.02175995990825974,0.009393247031775357,0.012366712876484384,0.10009999999999997,0.08495,1320326046.9899988,0.06510000000000005,15.995541312526118,-53.20466132556445,46.795338674435556,57.608933173390575,-4.748283752860409,0.8598,0.9786,0.8435,0.8741,73077630.0,173964.0,36474710.0,1.6631774831356103,67.29543716543463,0.8469788812399368,0.6764011187600631,0.019759817198168994,0.00630156881265426,0.013458248385514734,0.1351,0.08099285714285716,1360052254.9899988,0.14200000000000002,18.377573131094273,-38.05535324107794,61.94464675892206,54.40837891168807,0.8407666666666667,0.8460870439871575,0.7910285714285715,0.8095408344632237,0.76169,0.7748864317775228,348035.0,23042546.666666657,662000.0,20006664.0
2021-11-05,0.8328,0.935,0.8162,0.8747,40865877.0,95660.0,19310626.0,0.8604333333333333,0.8234,0.771045,0.8569967609967895,0.8301354693855634,0.7893569203439585,64.07416325547798,0.8741219048613303,0.6679680951386696,0.026445428300401863,0.01280368328550066,0.013641745014901204,0.11880000000000002,0.08925714285714288,1361191923.9899988,0.08000000000000007,15.426233834784897,-37.83685360524398,62.16314639475602,56.96771060937123,5.03121998078771,0.874,0.8986,0.7985,0.8325,39726208.0,84390.0,16743208.0,-4.748283752860409,63.89157792836399,0.8564899744957192,0.6748900255042808,0.02175995990825974,0.009393247031775357,0.012366712876484384,0.10009999999999997,0.08495,1320326046.9899988,0.06510000000000005,15.995541312526118,-53.20466132556445,46.795338674435556,57.608933173390575,0.8554333333333334,0.8392935219935788,0.8044571428571429,0.8152806258474178,0.76569,0.7803734382749016,375045.0,25374936.666666657,690176.0,20282055.285714287
2021-11-06,0.8739,0.9007,0.8143,0.8651,17877476.0,48767.0,8386911.0,0.8574333333333333,0.8393285714285713,0.7772,0.8610483804983947,0.8388766020391725,0.7965705469778672,61.9458423196741,0.8874275923045836,0.6669724076954164,0.029049194951790702,0.01605278561875867,0.012996409333032033,0.08639999999999992,0.09130714285714284,1343314447.9899988,0.14469999999999994,13.025868826757247,-41.33284777858704,58.667152221412955,55.87521243020152,-1.0069802036846356,0.8328,0.935,0.8162,0.8747,40865877.0,95660.0,19310626.0,5.03121998078771,64.07416325547798,0.8741219048613303,0.6679680951386696,0.026445428300401863,0.01280368328550066,0.013641745014901204,0.11880000000000002,0.08925714285714288,1361191923.9899988,0.08000000000000007,15.426233834784897,-37.83685360524398,62.16314639475602,56.96771060937123,0.8604333333333333,0.8569967609967895,0.8234,0.8301354693855634,0.771045,0.7893569203439585,354014.0,24176181.333333325,750048.0,21746949.85714286
2021-11-07,0.8651,0.8775,0.8183,0.8274,27602147.0,53609.0,10980691.0,0.8557333333333332,0.8460000000000001,0.7821999999999999,0.8442241902491974,0.8360074515293794,0.7995066853609275,61.29950201565095,0.8919874309745992,0.6724125690254006,0.02775073070485279,0.018392374635977492,0.009358356068875296,0.05919999999999992,0.09176428571428571,1315712300.9899988,0.08889999999999998,13.017347356918464,-55.06190823015294,44.93809176984706,55.25613012867203,-4.357877701999763,0.8739,0.9007,0.8143,0.8651,17877476.0,48767.0,8386911.0,-1.0069802036846356,61.9458423196741,0.8874275923045836,0.6669724076954164,0.029049194951790702,0.01605278561875867,0.012996409333032033,0.08639999999999992,0.09130714285714284,1343314447.9899988,0.14469999999999994,13.025868826757247,-41.33284777858704,58.667152221412955,55.87521243020152,0.8574333333333333,0.8610483804983947,0.8393285714285713,0.8388766020391725,0.7772,0.7965705469778672,228817.0,14813581.666666657,758402.0,21793704.0
2021-11-08,0.8274,0.9144,0.818,0.8604,32198683.0,72718.0,14627890.0,0.8509666666666668,0.8562714285714286,0.78956,0.8523120951245987,0.8421055886470346,0.8053060486598868,61.08726752503578,0.8996068110922868,0.6795131889077133,0.029049646400786333,0.02052382898893926,0.008525817411847072,0.09640000000000004,0.09465,1347910983.9899988,0.11830000000000007,12.118842845973422,-43.044428259286214,56.955571740713786,53.520271910657954,3.9883973894126212,0.8651,0.8775,0.8183,0.8274,27602147.0,53609.0,10980691.0,-4.357877701999763,61.29950201565095,0.8919874309745992,0.6724125690254006,0.02775073070485279,0.018392374635977492,0.009358356068875296,0.05919999999999992,0.09176428571428571,1315712300.9899988,0.08889999999999998,13.017347356918464,-55.06190823015294,44.93809176984706,55.25613012867203,0.8557333333333332,0.8442241902491974,0.8460000000000001,0.8360074515293794,0.7821999999999999,0.7995066853609275,198036.0,12892742.666666657,630461.0,17792725.14285714
2021-11-09,0.8603,0.935,0.8415,0.9286,39713969.0,86496.0,19184640.0,0.8721333333333333,0.8661142857142857,0.7990700000000001,0.8904560475622993,0.8637291914852759,0.8170483297398975,64.54486204649143,0.9225544136766064,0.6755855863233937,0.035176721132349154,0.02345440741762124,0.011722313714727914,0.09350000000000003,0.0950857142857143,1387624952.9899988,0.17499999999999993,16.849125456146986,-18.2083029861617,81.79169701383829,61.228453508133065,7.939091014762297,0.8274,0.9144,0.818,0.8604,32198683.0,72718.0,14627890.0,3.9883973894126212,61.08726752503578,0.8996068110922868,0.6795131889077133,0.029049646400786333,0.02052382898893926,0.008525817411847072,0.09640000000000004,0.09465,1347910983.9899988,0.11830000000000007,12.118842845973422,-43.044428259286214,56.955571740713786,53.520271910657954,0.8509666666666668,0.8523120951245987,0.8562714285714286,0.8421055886470346,0.78956,0.8053060486598868,175094.0,11331830.666666657,645799.0,18490132.57142857
2021-11-10,0.929,1.0275,0.85,0.8688,62027804.0,143162.0,31387180.0,0.8859333333333334,0.8653571428571428,0.806625,0.8796280237811497,0.8649968936139569,0.8219770602408596,66.64423508299686,0.9276117652614275,0.6856382347385725,0.034805891122806076,0.02572470415865821,0.009081186964147867,0.1775000000000001,0.09902857142857144,1325597148.9899988,0.08810000000000007,20.59966685174903,-49.057187017001546,50.942812982998454,63.23002724585019,-6.480086114101187,0.8603,0.935,0.8415,0.9286,39713969.0,86496.0,19184640.0,7.939091014762297,64.54486204649143,0.9225544136766064,0.6755855863233937,0.035176721132349154,0.02345440741762124,0.011722313714727914,0.09350000000000003,0.0950857142857143,1387624952.9899988,0.17499999999999993,16.849125456146986,-18.2083029861617,81.79169701383829,61.228453508133065,0.8721333333333333,0.8904560475622993,0.8661142857142857,0.8637291914852759,0.7990700000000001,0.8170483297398975,212823.0,14931073.666666657,615604.0,17958382.285714287
2021-11-11,0.8684,0.964,0.8498,0.8994,28331999.0,73869.0,13970756.0,0.8989333333333333,0.8749142857142858,0.813705,0.8895140118905749,0.8735976702104677,0.8293506735512539,67.55400392755837,0.9391518472050494,0.6882581527949506,0.03655973209968488,0.027891709746863547,0.008668022352821336,0.11419999999999997,0.10195,1353929147.9899988,0.1109,21.787406905890315,-41.958729118899456,58.04127088110054,63.59192695931244,3.5697835099032735,0.929,1.0275,0.85,0.8688,62027804.0,143162.0,31387180.0,-6.480086114101187,66.64423508299686,0.9276117652614275,0.6856382347385725,0.034805891122806076,0.02572470415865821,0.009081186964147867,0.1775000000000001,0.09902857142857144,1325597148.9899988,0.08810000000000007,20.59966685174903,-49.057187017001546,50.942812982998454,63.23002724585019,0.8859333333333334,0.8796280237811497,0.8653571428571428,0.8649968936139569,0.806625,0.8219770602408596,302376.0,21733236.666666657,584802.0,17231592.285714287
2021-11-12,0.8993,0.9264,0.8464,0.8804,19964533.0,59439.0,8887188.0,0.8828666666666667,0.8757285714285715,0.8194549999999999,0.8849570059452874,0.8752982526578508,0.8342125141654202,64.59784673844206,0.9461156984281969,0.692794301571803,0.03600151939382423,0.029513671676255685,0.006487847717568548,0.07999999999999996,0.10576428571428573,1333964614.9899988,0.02069999999999994,18.636302385123305,-48.182115951523116,51.81788404847689,53.60065597085864,-2.1016346046925416,0.8684,0.964,0.8498,0.8994,28331999.0,73869.0,13970756.0,3.5697835099032735,67.55400392755837,0.9391518472050494,0.6882581527949506,0.03655973209968488,0.027891709746863547,0.008668022352821336,0.11419999999999997,0.10195,1353929147.9899988,0.1109,21.787406905890315,-41.958729118899456,58.04127088110054,63.59192695931244,0.8989333333333333,0.8895140118905749,0.8749142857142858,0.8735976702104677,0.813705,0.8293506735512539,303527.0,21514191.99999999,574281.0,16835527.714285713
2021-11-13,0.8802,0.8897,0.8434,0.8587,55117542.0,40220.0,11044676.0,0.8794999999999998,0.8748142857142858,0.825785,0.8718285029726437,0.871148689493388,0.8365446556734755,60.85968175242819,0.9465821989044483,0.7049878010955517,0.03342284540041396,0.030295506421087342,0.0031273389793266167,0.04630000000000001,0.10587142857142859,1278847072.9899988,-0.01539999999999997,13.94639065817409,-58.02681333791681,41.97318666208318,50.61078053055355,-2.442626675755506,0.8993,0.9264,0.8464,0.8804,19964533.0,59439.0,8887188.0,-2.1016346046925416,64.59784673844206,0.9461156984281969,0.692794301571803,0.03600151939382423,0.029513671676255685,0.006487847717568548,0.07999999999999996,0.10576428571428573,1333964614.9899988,0.02069999999999994,18.636302385123305,-48.182115951523116,51.81788404847689,53.60065597085864,0.8828666666666667,0.8849570059452874,0.8757285714285715,0.8752982526578508,0.8194549999999999,0.8342125141654202,276470.0,18081707.99999999,538060.0,15346465.142857144
2021-11-14,0.8587,0.88,0.8315,0.8585,120697174.0,57784.0,18511690.0,0.8658666666666667,0.879257142857143,0.83034,0.8651642514863218,0.8679865171200409,0.8386356408474303,58.512035010940934,0.9487134749804633,0.7119665250195366,0.03100567523007358,0.030437540182884592,0.0005681350471889897,0.04849999999999999,0.09537857142857141,1158149898.9899988,0.026000000000000023,9.965415652619459,-58.09556548642145,41.90443451357855,45.23183507471288,-0.023291021311281936,0.8802,0.8897,0.8434,0.8587,55117542.0,40220.0,11044676.0,-2.442626675755506,60.85968175242819,0.9465821989044483,0.7049878010955517,0.03342284540041396,0.030295506421087342,0.0031273389793266167,0.04630000000000001,0.10587142857142859,1278847072.9899988,-0.01539999999999997,13.94639065817409,-58.02681333791681,41.97318666208318,50.61078053055355,0.8794999999999998,0.8718285029726437,0.8748142857142858,0.871148689493388,0.825785,0.8365446556734755,173528.0,11300873.333333323,529513.0,15726145.857142856
2021-11-15,0.8588,0.8859,0.8376,0.8818,99072604.0,57070.0,18551735.0,0.8663333333333334,0.8823142857142858,0.834695,0.8734821257431609,0.8714398878400307,0.842746532195294,59.87301587301587,0.9539531715174573,0.7154368284825426,0.030617229367498444,0.030473478019807362,0.00014375134769108178,0.04830000000000001,0.09509285714285716,1257222502.9899988,0.007099999999999995,11.83259353202284,-59.17952883834281,40.82047116165719,41.56603077910632,2.6781555659059175,0.8587,0.88,0.8315,0.8585,120697174.0,57784.0,18511690.0,-0.023291021311281936,58.512035010940934,0.9487134749804633,0.7119665250195366,0.03100567523007358,0.030437540182884592,0.0005681350471889897,0.04849999999999999,0.09537857142857141,1158149898.9899988,0.026000000000000023,9.965415652619459,-58.09556548642145,41.90443451357855,45.23183507471288,0.8658666666666667,0.8651642514863218,0.879257142857143,0.8679865171200409,0.83034,0.8386356408474303,157443.0,12814517.99999999,533688.0,16802002.85714286
2021-11-16,0.8818,0.8838,0.7263,0.7591,69887424.0,70895.0,21321777.0,0.8331333333333332,0.8581000000000001,0.8366300000000001,0.8162910628715805,0.8433549158800231,0.8347801957957423,40.40076335877862,0.9491450768844731,0.724114923115527,0.020175942958158832,0.028413971007477657,-0.008238028049318825,0.15750000000000008,0.09727142857142856,1187335078.9899988,-0.10599999999999998,-11.70175642666047,-89.1102257636122,10.889774236387794,31.204893303874528,-13.91471989113178,0.8588,0.8859,0.8376,0.8818,99072604.0,57070.0,18551735.0,2.6781555659059175,59.87301587301587,0.9539531715174573,0.7154368284825426,0.030617229367498444,0.030473478019807362,0.00014375134769108178,0.04830000000000001,0.09509285714285716,1257222502.9899988,0.007099999999999995,11.83259353202284,-59.17952883834281,40.82047116165719,41.56603077910632,0.8663333333333334,0.8734821257431609,0.8823142857142858,0.8714398878400307,0.834695,0.842746532195294,155074.0,16036033.666666657,518040.0,17362552.14285714
2021-11-17,0.7591,0.8082,0.7271,0.7811,18715206.0,38503.0,9409107.0,0.8073333333333333,0.8455714285714285,0.8387600000000001,0.7986955314357902,0.8277911869100173,0.8296677961961478,41.252821670428894,0.9448847012270444,0.7326352987729557,0.013520508387215857,0.0254352784834253,-0.011914770096209441,0.08110000000000006,0.09341428571428574,1206050284.9899988,-0.04630000000000001,-10.639514929641914,-81.80610889774235,18.193891102257652,23.301378833434228,2.898168884204982,0.8818,0.8838,0.7263,0.7591,69887424.0,70895.0,21321777.0,-13.91471989113178,40.40076335877862,0.9491450768844731,0.724114923115527,0.020175942958158832,0.028413971007477657,-0.008238028049318825,0.15750000000000008,0.09727142857142856,1187335078.9899988,-0.10599999999999998,-11.70175642666047,-89.1102257636122,10.889774236387794,31.204893303874528,0.8331333333333332,0.8162910628715805,0.8581000000000001,0.8433549158800231,0.8366300000000001,0.8347801957957423,185749.0,19461733.99999999,502439.0,17667857.42857143
2021-11-18,0.7806,0.787,0.6624,0.6826,30263999.0,49561.0,13076845.0,0.7409333333333333,0.8145999999999999,0.8357849999999999,0.7406477657178951,0.791493390182513,0.8156613394155624,37.26423109600679,0.9557520353845189,0.7158179646154809,0.0002945068471640333,0.02040712415617305,-0.020112617309009016,0.12460000000000004,0.09516428571428572,1175786285.9899988,-0.17780000000000007,-18.006006006006015,-94.46726924130375,5.532730758696245,11.538798699113912,-12.55444529848834,0.7591,0.8082,0.7271,0.7811,18715206.0,38503.0,9409107.0,2.898168884204982,41.252821670428894,0.9448847012270444,0.7326352987729557,0.013520508387215857,0.0254352784834253,-0.011914770096209441,0.08110000000000006,0.09341428571428574,1206050284.9899988,-0.04630000000000001,-10.639514929641914,-81.80610889774235,18.193891102257652,23.301378833434228,0.8073333333333333,0.7986955314357902,0.8455714285714285,0.8277911869100173,0.8387600000000001,0.8296677961961478,166468.0,16427539.666666657,397780.0,14528132.714285715
2021-11-19,0.6818,0.7896,0.6673,0.7207,25082893.0,47316.0,11640858.0,0.7281333333333332,0.7917857142857142,0.83414,0.7306738828589476,0.7737950426368847,0.806617402328366,36.82409308692676,0.9596272507678218,0.7086527492321781,-0.007031785035750304,0.01491934231778838,-0.021951127353538685,0.12229999999999996,0.09541428571428572,1200869178.9899988,-0.20789999999999997,-17.60603635532183,-84.03177211722816,15.968227882771844,13.231616581241928,5.705485479612796,0.7806,0.787,0.6624,0.6826,30263999.0,49561.0,13076845.0,-12.55444529848834,37.26423109600679,0.9557520353845189,0.7158179646154809,0.0002945068471640333,0.02040712415617305,-0.020112617309009016,0.12460000000000004,0.09516428571428572,1175786285.9899988,-0.17780000000000007,-18.006006006006015,-94.46726924130375,5.532730758696245,11.538798699113912,0.7409333333333333,0.7406477657178951,0.8145999999999999,0.791493390182513,0.8357849999999999,0.8156613394155624,158959.0,14602576.333333323,373472.0,14400431.142857144
2021-11-20,0.7207,0.8499,0.718,0.833,36398365.0,64839.0,18505324.0,0.7454333333333333,0.7881142857142857,0.8367549999999999,0.7818369414294738,0.7885962819776635,0.8091300306780455,47.664095473730164,0.9597074422394067,0.7138025577605931,-0.003733218447882547,0.011188830164654195,-0.014922048612536742,0.13190000000000002,0.09866428571428572,1237267543.9899988,-0.035800000000000054,-3.7105536932146577,-53.273075869624776,46.72692413037522,22.74262759061445,15.5820729845983,0.6818,0.7896,0.6673,0.7207,25082893.0,47316.0,11640858.0,5.705485479612796,36.82409308692676,0.9596272507678218,0.7086527492321781,-0.007031785035750304,0.01491934231778838,-0.021951127353538685,0.12229999999999996,0.09541428571428572,1200869178.9899988,-0.20789999999999997,-17.60603635532183,-84.03177211722816,15.968227882771844,13.231616581241928,0.7281333333333332,0.7306738828589476,0.7917857142857142,0.7737950426368847,0.83414,0.806617402328366,135380.0,11375603.333333323,361349.0,14793812.57142857
2021-11-21,0.833,0.91,0.7887,0.9014,30309154.0,66121.0,15536646.0,0.8183666666666666,0.794242857142857,0.8423999999999999,0.8416184707147369,0.8167972114832476,0.8179176468039459,55.154639175257735,0.9663866716096744,0.7184133283903255,0.0043500826502803625,0.00982108066177943,-0.005470998011499067,0.12130000000000007,0.10310000000000004,1267576697.9899988,0.0020000000000000018,8.943678994440418,-34.53848260750481,65.46151739249518,42.718889801880756,8.211284513805525,0.7207,0.8499,0.718,0.833,36398365.0,64839.0,18505324.0,15.5820729845983,47.664095473730164,0.9597074422394067,0.7138025577605931,-0.003733218447882547,0.011188830164654195,-0.014922048612536742,0.13190000000000002,0.09866428571428572,1237267543.9899988,-0.035800000000000054,-3.7105536932146577,-53.273075869624776,46.72692413037522,22.74262759061445,0.7454333333333333,0.7818369414294738,0.7881142857142857,0.7885962819776635,0.8367549999999999,0.8091300306780455,161716.0,14407675.666666657,385968.0,15859619.42857143
2021-11-22,0.9021,0.99,0.812,0.8449,84557197.0,175160.0,41390429.0,0.8597666666666667,0.7889714285714284,0.8416600000000001,0.8432592353573685,0.8238229086124357,0.8204873947273796,48.95453932281127,0.965388316973342,0.7179316830266581,0.006126457212655478,0.00908215597195464,-0.0029556987592991614,0.17799999999999994,0.10892857142857146,1183019500.9899988,-0.035499999999999976,-1.8014876801487723,-50.0136948781156,49.9863051218844,54.05824888158495,-6.340760447843922,0.833,0.91,0.7887,0.9014,30309154.0,66121.0,15536646.0,8.211284513805525,55.154639175257735,0.9663866716096744,0.7184133283903255,0.0043500826502803625,0.00982108066177943,-0.005470998011499067,0.12130000000000007,0.10310000000000004,1267576697.9899988,0.0020000000000000018,8.943678994440418,-34.53848260750481,65.46151739249518,42.718889801880756,0.8183666666666666,0.8416184707147369,0.794242857142857,0.8167972114832476,0.8423999999999999,0.8179176468039459,178276.0,15227609.333333323,394305.0,15434613.142857144
2021-11-23,0.8437,0.8565,0.8098,0.8211,22044148.0,41079.0,10298786.0,0.8558,0.7978285714285714,0.83901,0.8321796176786842,0.8231421814593267,0.8205457380866769,42.28727220548142,0.9620814110203074,0.7159385889796926,0.005549810989870729,0.008375686975537859,-0.0028258759856671298,0.046700000000000075,0.1055857142857143,1160975352.9899988,-0.03759999999999997,-11.57656687486538,-56.53245686113393,43.46754313886607,52.97178855108191,-2.6786772549484357,0.9021,0.99,0.812,0.8449,84557197.0,175160.0,41390429.0,-6.340760447843922,48.95453932281127,0.965388316973342,0.7179316830266581,0.006126457212655478,0.00908215597195464,-0.0029556987592991614,0.17799999999999994,0.10892857142857146,1183019500.9899988,-0.035499999999999976,-1.8014876801487723,-50.0136948781156,49.9863051218844,54.05824888158495,0.8597666666666667,0.8432592353573685,0.7889714285714284,0.8238229086124357,0.8416600000000001,0.8204873947273796,306120.0,25144132.99999999,512395.0,18697283.714285713
2021-11-24,0.8211,0.8644,0.78,0.7919,21070080.0,42543.0,9811422.0,0.8193,0.7993714285714286,0.83698,0.8120398088393421,0.8153316360944951,0.8178175725546124,44.229326129371145,0.9618300338300775,0.7121299661699224,0.0027054322000551467,0.007241636020441316,-0.0045362038203861695,0.08439999999999992,0.09893571428571428,1139905272.9899988,-0.06659999999999999,-8.8512891344383,-60.47008547008546,39.52991452991455,44.327920930221694,-3.5562050907319454,0.8437,0.8565,0.8098,0.8211,22044148.0,41079.0,10298786.0,-2.6786772549484357,42.28727220548142,0.9620814110203074,0.7159385889796926,0.005549810989870729,0.008375686975537859,-0.0028258759856671298,0.046700000000000075,0.1055857142857143,1160975352.9899988,-0.03759999999999997,-11.57656687486538,-56.53245686113393,43.46754313886607,52.97178855108191,0.8558,0.8321796176786842,0.7978285714285714,0.8231421814593267,0.83901,0.8205457380866769,282360.0,22408620.333333325,482579.0,17122570.714285713
2021-11-25,0.7912,0.8275,0.7727,0.8262,22571605.0,43813.0,11127743.0,0.8130666666666667,0.8198857142857143,0.8345549999999999,0.8191199044196711,0.8180487270708714,0.8186158989779826,44.53731343283582,0.9581984342862908,0.7109115657137091,0.0031822814992016335,0.00642976511619338,-0.0032474836169917465,0.05479999999999996,0.09469285714285715,1162476877.9899988,-0.05559999999999998,-8.138759172781851,-49.999999999999986,50.00000000000002,44.33248588959356,4.423660262891814,0.8211,0.8644,0.78,0.7919,21070080.0,42543.0,9811422.0,-3.5562050907319454,44.229326129371145,0.9618300338300775,0.7121299661699224,0.0027054322000551467,0.007241636020441316,-0.0045362038203861695,0.08439999999999992,0.09893571428571428,1139905272.9899988,-0.06659999999999999,-8.8512891344383,-60.47008547008546,39.52991452991455,44.327920930221694,0.8193,0.8120398088393421,0.7993714285714286,0.8153316360944951,0.83698,0.8178175725546124,258782.0,20500212.333333325,486619.0,17180044.285714287
2021-11-26,0.8269,0.836,0.707,0.7307,25254645.0,51848.0,11626738.0,0.7829333333333334,0.8213142857142858,0.827835,0.7749099522098355,0.7962115453031536,0.8102429562181748,39.97320830542532,0.95887638799793,0.69679361200207,-0.004098617557013462,0.004324088581552012,-0.008422706138565474,0.129,0.09819285714285717,1137222232.9899988,-0.02839999999999998,-17.003634711494776,-79.15140415140415,20.848595848595856,36.79283679283683,-11.633813036642877,0.7912,0.8275,0.7727,0.8262,22571605.0,43813.0,11127743.0,4.423660262891814,44.53731343283582,0.9581984342862908,0.7109115657137091,0.0031822814992016335,0.00642976511619338,-0.0032474836169917465,0.05479999999999996,0.09469285714285715,1162476877.9899988,-0.05559999999999998,-8.138759172781851,-49.999999999999986,50.00000000000002,44.33248588959356,0.8130666666666667,0.8191199044196711,0.8198857142857143,0.8180487270708714,0.8345549999999999,0.8186158989779826,127435.0,10412650.333333323,480871.0,16901601.14285714
2021-11-27,0.731,0.8156,0.7238,0.7531,19021849.0,40382.0,9433778.0,0.77,0.8099,0.82412,0.7640049761049177,0.7854336589773652,0.8048007699116819,42.933618843683085,0.9593588701520495,0.6888811298479505,-0.007969423170207435,0.0018653862312001225,-0.009834809401407556,0.09179999999999999,0.10144285714285717,1156244081.9899988,-0.028000000000000025,-12.297659252358217,-72.31379731379731,27.686202686202687,32.84493284493288,3.0232558139534897,0.8269,0.836,0.707,0.7307,25254645.0,51848.0,11626738.0,-11.633813036642877,39.97320830542532,0.95887638799793,0.69679361200207,-0.004098617557013462,0.004324088581552012,-0.008422706138565474,0.129,0.09819285714285717,1137222232.9899988,-0.02839999999999998,-17.003634711494776,-79.15140415140415,20.848595848595856,36.79283679283683,0.7829333333333334,0.7749099522098355,0.8213142857142858,0.7962115453031536,0.827835,0.8102429562181748,138204.0,10855300.99999999,485403.0,16899584.0
2021-11-28,0.7524,0.7669,0.6943,0.7613,17793403.0,34519.0,8561493.0,0.7483666666666666,0.7898857142857143,0.8191650000000001,0.7626524880524588,0.7794002442330238,0.8006578394439028,43.56461864406779,0.9560586932921338,0.6822713067078665,-0.010257154939288693,-0.0005591220028976405,-0.009698032936391052,0.0726,0.10316428571428572,1174037484.9899988,0.07869999999999999,-11.322073383808974,-69.81074481074482,30.18925518925519,26.241351241351264,1.1828814460393433,0.731,0.8156,0.7238,0.7531,19021849.0,40382.0,9433778.0,3.0232558139534897,42.933618843683085,0.9593588701520495,0.6888811298479505,-0.007969423170207435,0.0018653862312001225,-0.009834809401407556,0.09179999999999999,0.10144285714285717,1156244081.9899988,-0.028000000000000025,-12.297659252358217,-72.31379731379731,27.686202686202687,32.84493284493288,0.77,0.7640049761049177,0.8099,0.7854336589773652,0.82412,0.8048007699116819,136043.0,10729419.666666657,460946.0,15603648.857142856
2021-11-29,0.7613,0.7692,0.7293,0.7488,10573405.0,23080.0,4932570.0,0.7544,0.7761571428571429,0.8101749999999999,0.7557262440262293,0.7717501831747678,0.7957189975921026,41.06663084363246,0.9402545363978377,0.680095463602162,-0.012929797722024294,-0.0030332571467229716,-0.009896540575301323,0.03990000000000005,0.10256428571428573,1163464079.9899988,0.028100000000000014,-15.08278521206623,-73.62637362637362,26.373626373626387,28.083028083028108,-1.641928280572699,0.7524,0.7669,0.6943,0.7613,17793403.0,34519.0,8561493.0,1.1828814460393433,43.56461864406779,0.9560586932921338,0.6822713067078665,-0.010257154939288693,-0.0005591220028976405,-0.009698032936391052,0.0726,0.10316428571428572,1174037484.9899988,0.07869999999999999,-11.322073383808974,-69.81074481074482,30.18925518925519,26.241351241351264,0.7483666666666666,0.7626524880524588,0.7898857142857143,0.7794002442330238,0.8191650000000001,0.8006578394439028,126749.0,9874002.99999999,429344.0,14607198.42857143
2021-11-30,0.7485,0.7627,0.723,0.7291,46634809.0,37658.0,11090893.0,0.7464,0.7630142857142858,0.8031900000000001,0.7424131220131147,0.7610876373810759,0.7893743311547595,47.66136576239476,0.9350062341252019,0.6713737658747982,-0.01644791046950056,-0.00571618781127849,-0.01073172265822207,0.03970000000000007,0.09415000000000003,1116829270.9899988,-0.10389999999999999,-3.952048478461334,-79.63980463980465,20.360195360195355,25.641025641025664,-2.5918503674014803,0.7613,0.7692,0.7293,0.7488,10573405.0,23080.0,4932570.0,-1.641928280572699,41.06663084363246,0.9402545363978377,0.680095463602162,-0.012929797722024294,-0.0030332571467229716,-0.009896540575301323,0.03990000000000005,0.10256428571428573,1163464079.9899988,0.028100000000000014,-15.08278521206623,-73.62637362637362,26.373626373626387,28.083028083028108,0.7544,0.7557262440262293,0.7761571428571429,0.7717501831747678,0.8101749999999999,0.7957189975921026,97981.0,7642613.666666657,277264.0,9398932.857142856
2021-12-01,0.7293,0.7974,0.7271,0.7565,45275008.0,49905.0,13143003.0,0.7448,0.7579571428571429,0.796045,0.7494565610065573,0.7599407280358069,0.7862434424733539,48.09833024118738,0.9212280571182708,0.6708619428817292,-0.016831071049779656,-0.007939164458978723,-0.008891906590800932,0.07030000000000003,0.09337857142857144,1162104278.9899988,-0.14490000000000003,-3.149404685699664,-71.2759462759463,28.72405372405371,25.152625152625166,3.7296037296037303,0.7485,0.7627,0.723,0.7291,46634809.0,37658.0,11090893.0,-2.5918503674014803,47.66136576239476,0.9350062341252019,0.6713737658747982,-0.01644791046950056,-0.00571618781127849,-0.01073172265822207,0.03970000000000007,0.09415000000000003,1116829270.9899988,-0.10389999999999999,-3.952048478461334,-79.63980463980465,20.360195360195355,25.641025641025664,0.7464,0.7424131220131147,0.7630142857142858,0.7610876373810759,0.8031900000000001,0.7893743311547595,95257.0,8194985.333333324,273843.0,9512091.0
2021-12-02,0.7561,0.77,0.728,0.7367,13873345.0,33576.0,6646629.0,0.7407666666666666,0.7451714285714285,0.7888599999999999,0.7430782805032787,0.7541305460268551,0.7815250193806536,54.761485653934166,0.9100904182777241,0.6676295817222757,-0.018518948187607687,-0.010055121204704517,-0.00846382698290317,0.04200000000000004,0.08747857142857142,1148230933.9899988,-0.10819999999999996,7.925578669791977,-78.49395723582275,21.50604276417726,23.530097282808793,-2.5657981748445935,0.7293,0.7974,0.7271,0.7565,45275008.0,49905.0,13143003.0,3.7296037296037303,48.09833024118738,0.9212280571182708,0.6708619428817292,-0.016831071049779656,-0.007939164458978723,-0.008891906590800932,0.07030000000000003,0.09337857142857144,1162104278.9899988,-0.14490000000000003,-3.149404685699664,-71.2759462759463,28.72405372405371,25.152625152625166,0.7448,0.7494565610065573,0.7579571428571429,0.7599407280358069,0.796045,0.7862434424733539,110643.0,9722155.333333323,281205.0,9988031.142857144
2021-12-03,0.7362,0.8234,0.7203,0.76,48480180.0,84517.0,21577660.0,0.7510666666666665,0.7493571428571428,0.783925,0.7515391402516394,0.7555979095201413,0.779475017534877,53.551418760166285,0.9011544713259888,0.6666955286740112,-0.017771627447300875,-0.011598422453223789,-0.006173204994077086,0.10309999999999997,0.08610714285714287,1196711113.9899988,-0.06110000000000004,5.453031774663519,-77.7815353398715,22.218464660128504,24.14952038278651,3.2328171692474936,0.7561,0.77,0.728,0.7367,13873345.0,33576.0,6646629.0,-2.5657981748445935,54.761485653934166,0.9100904182777241,0.6676295817222757,-0.018518948187607687,-0.010055121204704517,-0.00846382698290317,0.04200000000000004,0.08747857142857142,1148230933.9899988,-0.10819999999999996,7.925578669791977,-78.49395723582275,21.50604276417726,23.530097282808793,0.7407666666666666,0.7430782805032787,0.7451714285714285,0.7541305460268551,0.7888599999999999,0.7815250193806536,121139.0,10293508.333333323,270968.0,9347872.0
2021-12-04,0.759,0.7638,0.5978,0.6781,63702448.0,81689.0,24457209.0,0.7249333333333333,0.7386428571428573,0.774905,0.7148195701258198,0.736223432140106,0.7698202539601269,35.188372537770135,0.8956817400924976,0.6541282599075023,-0.02351692740919953,-0.013982123444418936,-0.009534803964780592,0.16600000000000004,0.08854285714285716,1133008665.9899988,-0.11380000000000001,-18.595438175270097,-79.52575216726159,20.47424783273841,21.39958508568141,-10.658761528326743,0.7362,0.8234,0.7203,0.76,48480180.0,84517.0,21577660.0,3.2328171692474936,53.551418760166285,0.9011544713259888,0.6666955286740112,-0.017771627447300875,-0.011598422453223789,-0.006173204994077086,0.10309999999999997,0.08610714285714287,1196711113.9899988,-0.06110000000000004,5.453031774663519,-77.7815353398715,22.218464660128504,24.14952038278651,0.7510666666666665,0.7515391402516394,0.7493571428571428,0.7555979095201413,0.783925,0.779475017534877,167998.0,13789097.333333323,303637.0,10769432.285714285
2021-12-05,0.6775,0.692,0.5921,0.6043,51530704.0,56735.0,23377743.0,0.6808,0.7162142857142858,0.76103,0.6595597850629098,0.7032425741050795,0.7540564202496386,21.881506719666845,0.8933116468950447,0.6287483531049552,-0.033637411112576565,-0.01791318097805046,-0.015724230134526104,0.09989999999999999,0.08701428571428571,1081477961.9899988,-0.2219000000000001,-32.95984024850234,-96.93390299070118,3.066097009298816,15.25293650072193,-10.80442804428045,0.759,0.7638,0.5978,0.6781,63702448.0,81689.0,24457209.0,-10.658761528326743,35.188372537770135,0.8956817400924976,0.6541282599075023,-0.02351692740919953,-0.013982123444418936,-0.009534803964780592,0.16600000000000004,0.08854285714285716,1133008665.9899988,-0.11380000000000001,-18.595438175270097,-79.52575216726159,20.47424783273841,21.39958508568141,0.7249333333333333,0.7148195701258198,0.7386428571428573,0.736223432140106,0.774905,0.7698202539601269,199782.0,17560499.333333325,344944.0,12915636.714285715
2021-12-06,0.6048,0.623,0.5158,0.6039,37202584.0,52513.0,18512204.0,0.6287666666666666,0.6955142857142856,0.75327,0.631729892531455,0.6784069305788096,0.7397558087972921,24.481152054214306,0.9030764168395928,0.6034635831604072,-0.04121514152277117,-0.022573573086994606,-0.018641568435776565,0.10719999999999996,0.08195714285714287,1044275377.9899988,-0.12680000000000002,-28.524085690614275,-74.72748135398739,25.272518646012614,16.270954496016632,-0.14880952380952578,0.6775,0.692,0.5921,0.6043,51530704.0,56735.0,23377743.0,-10.80442804428045,21.881506719666845,0.8933116468950447,0.6287483531049552,-0.033637411112576565,-0.01791318097805046,-0.015724230134526104,0.09989999999999999,0.08701428571428571,1081477961.9899988,-0.2219000000000001,-32.95984024850234,-96.93390299070118,3.066097009298816,15.25293650072193,0.6808,0.6595597850629098,0.7162142857142858,0.7032425741050795,0.76103,0.7540564202496386,222941.0,23137537.333333325,367160.0,15032243.857142856
2021-12-07,0.6036,0.6318,0.57,0.5792,24284605.0,35076.0,14247041.0,0.5958,0.6741,0.743175,0.6054649462657276,0.6536051979341073,0.7244647793880261,24.43458042697104,0.9111894088432575,0.5751605911567426,-0.048652791940755336,-0.027789416857746753,-0.020863375083008583,0.06180000000000008,0.0830357142857143,1019990772.9899988,-0.17389999999999994,-29.460479844111553,-81.81296615031553,18.18703384968446,15.508549834998648,-4.042412193505629,0.6048,0.623,0.5158,0.6039,37202584.0,52513.0,18512204.0,-0.14880952380952578,24.481152054214306,0.9030764168395928,0.6034635831604072,-0.04121514152277117,-0.022573573086994606,-0.018641568435776565,0.10719999999999996,0.08195714285714287,1044275377.9899988,-0.12680000000000002,-28.524085690614275,-74.72748135398739,25.272518646012614,16.270954496016632,0.6287666666666666,0.631729892531455,0.6955142857142856,0.6784069305788096,0.75327,0.7397558087972921,190937.0,22115718.666666657,396593.0,16972191.57142857
2021-12-08,0.5786,0.6161,0.5506,0.6144,25374689.0,32607.0,15487931.0,0.5991666666666666,0.6538,0.739765,0.6099324731328637,0.6438038984505805,0.7139824194463094,31.47568357336671,0.9155448296913433,0.5639851703086567,-0.05111758594982274,-0.03245505067616195,-0.01866253527366079,0.0655,0.08168571428571429,1045365461.9899988,-0.14690000000000003,-22.414446268468257,-69.2067457838851,30.793254216114907,24.750935570604014,6.187348772900094,0.6036,0.6318,0.57,0.5792,24284605.0,35076.0,14247041.0,-4.042412193505629,24.43458042697104,0.9111894088432575,0.5751605911567426,-0.048652791940755336,-0.027789416857746753,-0.020863375083008583,0.06180000000000008,0.0830357142857143,1019990772.9899988,-0.17389999999999994,-29.460479844111553,-81.81296615031553,18.18703384968446,15.508549834998648,0.5958,0.6054649462657276,0.6741,0.6536051979341073,0.743175,0.7244647793880261,144324.0,18712329.333333325,394011.0,17423069.85714286
2021-12-09,0.6147,0.6168,0.5324,0.5328,19428465.0,27431.0,11126571.0,0.5754666666666667,0.6246714285714285,0.73037,0.5713662365664318,0.6160529238379354,0.6967269509276133,22.131458966565333,0.9290359836324109,0.531704016367589,-0.05897555748456407,-0.03775915203784237,-0.021216405446721695,0.08440000000000003,0.08380000000000001,1025936996.9899988,-0.21599999999999997,-35.5119825708061,-94.69081823860087,5.309181761399132,18.09648994239952,-13.32357247437774,0.5786,0.6161,0.5506,0.6144,25374689.0,32607.0,15487931.0,6.187348772900094,31.47568357336671,0.9155448296913433,0.5639851703086567,-0.05111758594982274,-0.03245505067616195,-0.01866253527366079,0.0655,0.08168571428571429,1045365461.9899988,-0.14690000000000003,-22.414446268468257,-69.2067457838851,30.793254216114907,24.750935570604014,0.5991666666666666,0.6099324731328637,0.6538,0.6438038984505805,0.739765,0.7139824194463094,120196.0,16082391.99999999,376713.0,17758059.57142857
2021-12-10,0.5329,0.5766,0.5062,0.5095,10450505.0,17860.0,5453588.0,0.5522333333333332,0.5888857142857143,0.714195,0.5404331182832158,0.5894146928784516,0.6788958127440311,25.64949361514749,0.929646471883679,0.49874352811632106,-0.06631869122278522,-0.04347105987483094,-0.022847631347954277,0.07040000000000002,0.07961428571428573,1015486491.9899988,-0.21960000000000002,-30.272341590255923,-98.95964691046659,1.0403530895334077,12.380929689015835,-4.391067742540831,0.6147,0.6168,0.5324,0.5328,19428465.0,27431.0,11126571.0,-13.32357247437774,22.131458966565333,0.9290359836324109,0.531704016367589,-0.05897555748456407,-0.03775915203784237,-0.021216405446721695,0.08440000000000003,0.08380000000000001,1025936996.9899988,-0.21599999999999997,-35.5119825708061,-94.69081823860087,5.309181761399132,18.09648994239952,0.5754666666666667,0.5713662365664318,0.6246714285714285,0.6160529238379354,0.73037,0.6967269509276133,95114.0,13620514.333333323,370568.0,18398051.285714287
2021-12-11,0.5096,0.5388,0.4974,0.5314,13528788.5,20093.0,6615483.0,0.5245666666666666,0.5679285714285714,0.695695,0.535916559141608,0.5749110196588387,0.6648485924826948,25.567555653515512,0.9069644211564722,0.48442557884352766,-0.06956908157355346,-0.04869066421457545,-0.02087841735897801,0.04139999999999994,0.07601428571428571,1029015280.4899988,-0.22509999999999997,-29.438321604036656,-89.57055214723927,10.42944785276073,5.592994234564441,4.277864992150692,0.5329,0.5766,0.5062,0.5095,10450505.0,17860.0,5453588.0,-4.391067742540831,25.64949361514749,0.929646471883679,0.49874352811632106,-0.06631869122278522,-0.04347105987483094,-0.022847631347954277,0.07040000000000002,0.07961428571428573,1015486491.9899988,-0.21960000000000002,-30.272341590255923,-98.95964691046659,1.0403530895334077,12.380929689015835,0.5522333333333332,0.5404331182832158,0.5888857142857143,0.5894146928784516,0.714195,0.6788958127440311,77898.0,10689363.333333323,303911.0,16094612.42857143
2021-12-12,0.5323,0.5539,0.5191,0.549,14384100.0,18529.0,9305724.0,0.5299666666666666,0.5600285714285714,0.6809000000000001,0.542458279570804,0.568433264744129,0.6538153931986286,27.078384798099762,0.8896025584288274,0.4721974415711727,-0.06991888504981292,-0.05293630838162294,-0.016982576668189975,0.03479999999999994,0.07331428571428573,1043399380.4899988,-0.18769999999999998,-27.886509917246805,-84.17177914110428,15.828220858895717,9.099340600396637,3.1373285741123516,0.5096,0.5388,0.4974,0.5314,13528788.5,20093.0,6615483.0,4.277864992150692,25.567555653515512,0.9069644211564722,0.48442557884352766,-0.06956908157355346,-0.04869066421457545,-0.02087841735897801,0.04139999999999994,0.07601428571428571,1029015280.4899988,-0.22509999999999997,-29.438321604036656,-89.57055214723927,10.42944785276073,5.592994234564441,0.5245666666666666,0.535916559141608,0.5679285714285714,0.5749110196588387,0.695695,0.6648485924826948,65384.0,7731880.666666657,242315.0,13545794.42857143
2021-12-13,0.5494,0.5538,0.4626,0.4786,15367186.8,27777.0,7738342.6,0.5196666666666666,0.5421285714285714,0.663775,0.5105291397854019,0.5459749485580968,0.6371282128939973,24.06909788867563,0.8801073649047091,0.4474426350952909,-0.07501210560756821,-0.057351467826812,-0.017660637780756216,0.09119999999999995,0.07697857142857144,1028032193.6899989,-0.2814,-36.0844017094017,-95.56541019955654,4.4345898004434625,10.230752837366655,-12.886785584273749,0.5323,0.5539,0.5191,0.549,14384100.0,18529.0,9305724.0,3.1373285741123516,27.078384798099762,0.8896025584288274,0.4721974415711727,-0.06991888504981292,-0.05293630838162294,-0.016982576668189975,0.03479999999999994,0.07331428571428573,1043399380.4899988,-0.18769999999999998,-27.886509917246805,-84.17177914110428,15.828220858895717,9.099340600396637,0.5299666666666666,0.542458279570804,0.5600285714285714,0.568433264744129,0.6809000000000001,0.6538153931986286,56482.0,7124931.666666657,204109.0,11535506.0
2021-12-14,0.4782,0.5051,0.465,0.4863,9873347.0,17183.0,4537616.0,0.5046333333333334,0.5288571428571428,0.6484949999999999,0.49841456989270094,0.5310562114185726,0.6227636211898072,26.149312377210208,0.8698355708761734,0.4271544291238265,-0.07753343674988278,-0.06138786161142616,-0.016145575138456617,0.04009999999999997,0.07700714285714286,1037905540.6899989,-0.19180000000000003,-33.30133040735153,-93.43126385809313,6.568736141906874,8.943848933748704,1.6938519447929727,0.5494,0.5538,0.4626,0.4786,15367186.8,27777.0,7738342.6,-12.886785584273749,24.06909788867563,0.8801073649047091,0.4474426350952909,-0.07501210560756821,-0.057351467826812,-0.017660637780756216,0.09119999999999995,0.07697857142857144,1028032193.6899989,-0.2814,-36.0844017094017,-95.56541019955654,4.4345898004434625,10.230752837366655,0.5196666666666666,0.5105291397854019,0.5421285714285714,0.5459749485580968,0.663775,0.6371282128939973,66399.0,7886516.533333324,179373.0,9996382.942857143
2021-12-15,0.4862,0.5101,0.4501,0.5035,15951678.0,21445.0,8151665.7,0.48946666666666666,0.5130142857142858,0.63236,0.5009572849463504,0.5241671585639295,0.6114051810764922,24.639133921411386,0.8460730629211948,0.41864693707880524,-0.07725318694115624,-0.06456092667737218,-0.012692260263784061,0.06,0.07627142857142856,1053857218.6899989,-0.1008,-33.443489755452745,-85.69515135279937,14.304848647200627,8.436058196517008,3.558206499382955,0.4782,0.5051,0.465,0.4863,9873347.0,17183.0,4537616.0,1.6938519447929727,26.149312377210208,0.8698355708761734,0.4271544291238265,-0.07753343674988278,-0.06138786161142616,-0.016145575138456617,0.04009999999999997,0.07700714285714286,1037905540.6899989,-0.19180000000000003,-33.30133040735153,-93.43126385809313,6.568736141906874,8.943848933748704,0.5046333333333334,0.49841456989270094,0.5288571428571428,0.5310562114185726,0.6484949999999999,0.6227636211898072,63489.0,7193894.199999991,161480.0,8609322.228571428
2021-12-16,0.5037,0.538,0.4923,0.4995,12450992.0,22486.0,5953874.0,0.4964333333333333,0.5082571428571429,0.6208,0.5002286424731752,0.5180003689229471,0.600747544783493,25.44513457556934,0.8371118606379042,0.40448813936209577,-0.07647232812302396,-0.06694320696650254,-0.009529121156521422,0.04570000000000002,0.07653571428571428,1041406226.6899989,-0.10439999999999999,-32.19763811592236,-86.76667559603536,13.23332440396464,11.368969731024066,-0.833829660512217,0.4862,0.5101,0.4501,0.5035,15951678.0,21445.0,8151665.7,3.558206499382955,24.639133921411386,0.8460730629211948,0.41864693707880524,-0.07725318694115624,-0.06456092667737218,-0.012692260263784061,0.06,0.07627142857142856,1053857218.6899989,-0.1008,-33.443489755452745,-85.69515135279937,14.304848647200627,8.436058196517008,0.48946666666666666,0.5009572849463504,0.5130142857142858,0.5241671585639295,0.63236,0.6114051810764922,66405.0,6809208.09999999,150318.0,7561284.328571429
2021-12-17,0.4993,0.5065,0.4588,0.4714,9743115.0,16061.0,4586178.0,0.49146666666666666,0.5028142857142858,0.6067150000000001,0.48581432123658763,0.5063502766922103,0.5884287309945889,20.418204182041805,0.8234397711293129,0.38999022887068735,-0.07723066006752988,-0.06900069758670802,-0.008229962480821862,0.047699999999999965,0.07257857142857141,1031663111.6899989,-0.10780000000000006,-37.973684210526315,-93.21007331845713,6.78992668154287,11.442699910902732,-5.587822952132993,0.5037,0.538,0.4923,0.4995,12450992.0,22486.0,5953874.0,-0.833829660512217,25.44513457556934,0.8371118606379042,0.40448813936209577,-0.07647232812302396,-0.06694320696650254,-0.009529121156521422,0.04570000000000002,0.07653571428571428,1041406226.6899989,-0.10439999999999999,-32.19763811592236,-86.76667559603536,13.23332440396464,11.368969731024066,0.4964333333333333,0.5002286424731752,0.5082571428571429,0.5180003689229471,0.6208,0.600747544783493,61114.0,6214385.233333323,145373.0,6822327.614285714
2021-12-18,0.4723,0.4924,0.46,0.477,5110031.0,10212.0,2606228.0,0.48263333333333325,0.4950428571428572,0.5925,0.4814071606182938,0.4990127075191577,0.5778164708998661,25.56500607533414,0.8037588135813265,0.3812411864186735,-0.07649794965291157,-0.07050014799994872,-0.0059978016529628475,0.032399999999999984,0.06303571428571428,1036773142.6899989,-0.13739999999999997,-29.656392862409685,-88.8797023563456,11.120297643654396,10.381182909720653,0.9951302138471273,0.4993,0.5065,0.4588,0.4714,9743115.0,16061.0,4586178.0,-5.587822952132993,20.418204182041805,0.8234397711293129,0.38999022887068735,-0.07723066006752988,-0.06900069758670802,-0.008229962480821862,0.047699999999999965,0.07257857142857141,1031663111.6899989,-0.10780000000000006,-37.973684210526315,-93.21007331845713,6.78992668154287,11.442699910902732,0.49146666666666666,0.48581432123658763,0.5028142857142858,0.5063502766922103,0.6067150000000001,0.5884287309945889,59992.0,6230572.566666656,143574.0,6698411.899999999
2021-12-19,0.4768,0.4866,0.4595,0.4648,6172318.0,11089.0,2815814.0,0.4710666666666666,0.48301428571428573,0.5782999999999999,0.4731035803091469,0.4904595306393683,0.5670529974808313,30.06573306659044,0.7834128880448649,0.373187111955135,-0.07602533665396083,-0.07160518573075114,-0.004420150923209687,0.027099999999999957,0.057835714285714275,1030600824.6899989,-0.06800000000000006,-23.084560648684427,-91.90974133186572,8.09025866813428,8.666827664443867,-2.5167785234899354,0.4723,0.4924,0.46,0.477,5110031.0,10212.0,2606228.0,0.9951302138471273,25.56500607533414,0.8037588135813265,0.3812411864186735,-0.07649794965291157,-0.07050014799994872,-0.0059978016529628475,0.032399999999999984,0.06303571428571428,1036773142.6899989,-0.13739999999999997,-29.656392862409685,-88.8797023563456,11.120297643654396,10.381182909720653,0.48263333333333325,0.4814071606182938,0.4950428571428572,0.4990127075191577,0.5925,0.5778164708998661,48759.0,4382093.333333324,133693.0,6125661.185714285
2021-12-20,0.4642,0.4732,0.431,0.4722,14262009.3,19202.0,8864719.0,0.4713333333333333,0.4821,0.565455,0.4726517901545735,0.4858946479795262,0.558019378673133,31.54945362846736,0.762835396563003,0.3680746034369971,-0.07419835682111964,-0.07212381994882484,-0.0020745368722947938,0.042200000000000015,0.05319285714285714,1044862833.9899988,-0.037299999999999944,-21.808246398410336,-79.4820717131474,20.517928286852595,13.24282819954711,1.7233950883239997,0.4768,0.4866,0.4595,0.4648,6172318.0,11089.0,2815814.0,-2.5167785234899354,30.06573306659044,0.7834128880448649,0.373187111955135,-0.07602533665396083,-0.07160518573075114,-0.004420150923209687,0.027099999999999957,0.057835714285714275,1030600824.6899989,-0.06800000000000006,-23.084560648684427,-91.90974133186572,8.09025866813428,8.666827664443867,0.4710666666666666,0.4731035803091469,0.48301428571428573,0.4904595306393683,0.5782999999999999,0.5670529974808313,37362.0,3336073.3333333232,126253.0,5198531.185714285
2021-12-21,0.4722,0.595,0.472,0.5635,85593845.0,165001.0,43877246.0,0.5001666666666665,0.49312857142857147,0.555805,0.5180758950772868,0.5052959859846446,0.5585413426090251,48.14639905548996,0.731543160191144,0.380066839808856,-0.06463820616210014,-0.0706266971914799,0.005988491029379761,0.123,0.0575642857142857,1130456678.9899988,0.03210000000000002,-2.7106353591160315,-28.686759956942954,71.31324004305705,33.30714233268133,19.335027530707325,0.4642,0.4732,0.431,0.4722,14262009.3,19202.0,8864719.0,1.7233950883239997,31.54945362846736,0.762835396563003,0.3680746034369971,-0.07419835682111964,-0.07212381994882484,-0.0020745368722947938,0.042200000000000015,0.05319285714285714,1044862833.9899988,-0.037299999999999944,-21.808246398410336,-79.4820717131474,20.517928286852595,13.24282819954711,0.4713333333333333,0.4726517901545735,0.4821,0.4858946479795262,0.565455,0.558019378673133,40503.0,4762253.666666657,117678.0,5359442.100000001
2021-12-22,0.5626,0.5893,0.5439,0.5547,17874528.0,34192.0,9069163.0,0.5301333333333332,0.5004428571428571,0.546705,0.5363879475386434,0.5176469894884834,0.5581755004557847,42.483001762780155,0.7004789622747748,0.3929310377252252,-0.05711343620233156,-0.06792404499365023,0.010810608791318677,0.045399999999999996,0.05612857142857142,1112582150.9899988,0.005699999999999927,-9.716796875,-33.423035522066755,66.57696447793325,52.80271093594765,-1.4041948098115924,0.4722,0.595,0.472,0.5635,85593845.0,165001.0,43877246.0,19.335027530707325,48.14639905548996,0.731543160191144,0.380066839808856,-0.06463820616210014,-0.0706266971914799,0.005988491029379761,0.123,0.0575642857142857,1130456678.9899988,0.03210000000000002,-2.7106353591160315,-28.686759956942954,71.31324004305705,33.30714233268133,0.5001666666666665,0.5180758950772868,0.49312857142857147,0.5052959859846446,0.555805,0.5585413426090251,195292.0,18519259.666666657,265496.0,10979389.242857143
2021-12-23,0.5543,0.59,0.5386,0.5735,13971022.0,26900.0,6790502.0,0.5639,0.5110142857142856,0.53738,0.5549439737693217,0.5316102421163625,0.5596349766028528,56.0873466945857,0.6550813634048814,0.4196786365951185,-0.049067380693084583,-0.0641527121335371,0.015085331440452515,0.0514,0.053771428571428546,1126553172.9899988,0.09489999999999998,7.638888888888884,-13.109756097560954,86.89024390243904,74.92681614114314,3.4638282518491783,0.5626,0.5893,0.5439,0.5547,17874528.0,34192.0,9069163.0,-1.4041948098115924,42.483001762780155,0.7004789622747748,0.3929310377252252,-0.05711343620233156,-0.06792404499365023,0.010810608791318677,0.045399999999999996,0.05612857142857142,1112582150.9899988,0.005699999999999927,-9.716796875,-33.423035522066755,66.57696447793325,52.80271093594765,0.5301333333333332,0.5363879475386434,0.5004428571428571,0.5176469894884834,0.546705,0.5581755004557847,218395.0,20603709.333333325,278243.0,11110460.285714285
2021-12-24,0.5736,0.6175,0.5697,0.5734,15559958.0,32396.0,9115163.0,0.5672,0.5255857142857143,0.5321450000000001,0.5641719868846609,0.5420576815872719,0.5609459312121049,60.27000964320156,0.6313543687214306,0.4329356312785696,-0.04221229582751407,-0.05976462887233249,0.017552333044818423,0.047800000000000065,0.05215714285714284,1110993214.9899988,0.08710000000000001,12.541707556427895,-23.646112600536203,76.35388739946379,76.60703192661204,-0.03486750348674651,0.5543,0.59,0.5386,0.5735,13971022.0,26900.0,6790502.0,3.4638282518491783,56.0873466945857,0.6550813634048814,0.4196786365951185,-0.049067380693084583,-0.0641527121335371,0.015085331440452515,0.0514,0.053771428571428546,1126553172.9899988,0.09489999999999998,7.638888888888884,-13.109756097560954,86.89024390243904,74.92681614114314,0.5639,0.5549439737693217,0.5110142857142856,0.5316102421163625,0.53738,0.5596349766028528,226093.0,19912303.666666657,282657.0,11229978.57142857
2021-12-25,0.5727,0.588,0.5519,0.5681,31250644.0,33398.0,21355789.0,0.5716666666666667,0.5386,0.530335,0.5661359934423305,0.5485682611904539,0.5616272710966663,56.23089983022072,0.6252285863841259,0.435441413615874,-0.03678324306015812,-0.055168351709897624,0.018385108649739502,0.03610000000000002,0.05177857142857142,1079742570.9899988,0.0646000000000001,6.906285284155067,-26.487935656836452,73.51206434316356,78.91873188168881,-0.8032128514056116,0.5736,0.6175,0.5697,0.5734,15559958.0,32396.0,9115163.0,-0.03486750348674651,60.27000964320156,0.6313543687214306,0.4329356312785696,-0.04221229582751407,-0.05976462887233249,0.017552333044818423,0.047800000000000065,0.05215714285714284,1110993214.9899988,0.08710000000000001,12.541707556427895,-23.646112600536203,76.35388739946379,76.60703192661204,0.5672,0.5641719868846609,0.5255857142857143,0.5420576815872719,0.5321450000000001,0.5609459312121049,93488.0,8324942.666666657,298992.0,11876976.42857143
2021-12-26,0.5682,0.5706,0.5453,0.5588,35346544.0,34271.0,24165230.0,0.5667666666666666,0.5520285714285714,0.52808,0.5624679967211652,0.5511261958928404,0.5613580071826981,51.71208944793848,0.6176044888578684,0.4385555111421316,-0.032852409774506985,-0.0507051633228195,0.017852753548312512,0.02529999999999999,0.0511,1044396026.9899988,0.059299999999999964,1.7850637522768498,-31.474530831099234,68.52546916890077,72.79714030384272,-1.6543470608940645,0.5727,0.588,0.5519,0.5681,31250644.0,33398.0,21355789.0,-0.8032128514056116,56.23089983022072,0.6252285863841259,0.435441413615874,-0.03678324306015812,-0.055168351709897624,0.018385108649739502,0.03610000000000002,0.05177857142857142,1079742570.9899988,0.0646000000000001,6.906285284155067,-26.487935656836452,73.51206434316356,78.91873188168881,0.5716666666666667,0.5661359934423305,0.5386,0.5485682611904539,0.530335,0.5616272710966663,92694.0,12420484.666666657,322178.0,14555485.142857144
2021-12-27,0.5588,0.597,0.5536,0.5678,23903135.0,33874.0,15029477.0,0.5649,0.5656857142857142,0.52751,0.5651339983605825,0.5552946469196303,0.5619715303081555,69.83985765124555,0.6158007135845135,0.4392192864154865,-0.028680361932193477,-0.046300203044694295,0.01761984111250082,0.043399999999999994,0.04768571428571428,1068299161.9899988,0.09639999999999999,18.637693272043453,-26.648793565683683,73.35120643431632,71.79624664879357,1.610594130279171,0.5682,0.5706,0.5453,0.5588,35346544.0,34271.0,24165230.0,-1.6543470608940645,51.71208944793848,0.6176044888578684,0.4385555111421316,-0.032852409774506985,-0.0507051633228195,0.017852753548312512,0.02529999999999999,0.0511,1044396026.9899988,0.059299999999999964,1.7850637522768498,-31.474530831099234,68.52546916890077,72.79714030384272,0.5667666666666666,0.5624679967211652,0.5520285714285714,0.5511261958928404,0.52808,0.5613580071826981,100065.0,18212060.666666657,345360.0,17605401.714285713
2021-12-28,0.568,0.5783,0.5135,0.52,14702080.0,25968.0,7638428.0,0.5488666666666666,0.5594714285714286,0.52279,0.5425669991802913,0.5464709851897227,0.5579742417073787,56.36089090222726,0.6010451804237731,0.44453481957622687,-0.028897927161922743,-0.04281974786813999,0.013921820706217246,0.06480000000000008,0.04945000000000001,1053597081.9899988,0.04300000000000004,6.929878675714574,-52.27882037533512,47.72117962466488,63.19928507596068,-8.450704225352101,0.5588,0.597,0.5536,0.5678,23903135.0,33874.0,15029477.0,1.610594130279171,69.83985765124555,0.6158007135845135,0.4392192864154865,-0.028680361932193477,-0.046300203044694295,0.01761984111250082,0.043399999999999994,0.04768571428571428,1068299161.9899988,0.09639999999999999,18.637693272043453,-26.648793565683683,73.35120643431632,71.79624664879357,0.5649,0.5651339983605825,0.5656857142857142,0.5552946469196303,0.52751,0.5619715303081555,101543.0,20183498.666666657,360032.0,18486081.42857143
2021-12-29,0.5192,0.5316,0.4955,0.5004,7694690.0,15553.0,3469236.0,0.5294,0.5517142857142857,0.52117,0.5214834995901456,0.534953238892292,0.5524909805923903,49.420127197904975,0.5998927272741046,0.4424472727258954,-0.03030259590701634,-0.04031631747591526,0.010013721568898924,0.036099999999999965,0.04774285714285714,1045902391.9899988,0.035599999999999965,-0.6156901688182725,-62.78820375335123,37.21179624664876,52.761394101876675,-3.6209553158705776,0.568,0.5783,0.5135,0.52,14702080.0,25968.0,7638428.0,-8.450704225352101,56.36089090222726,0.6010451804237731,0.44453481957622687,-0.028897927161922743,-0.04281974786813999,0.013921820706217246,0.06480000000000008,0.04945000000000001,1053597081.9899988,0.04300000000000004,6.929878675714574,-52.27882037533512,47.72117962466488,63.19928507596068,0.5488666666666666,0.5425669991802913,0.5594714285714286,0.5464709851897227,0.52279,0.5579742417073787,94113.0,15611044.99999999,220999.0,13309107.42857143
2021-12-30,0.5007,0.5173,0.4882,0.495,6892382.0,15513.0,3063050.0,0.5051333333333333,0.5405,0.5204449999999999,0.5082417497950729,0.524964929169219,0.5470156491074007,49.162634908820245,0.599884072316623,0.4410059276833768,-0.031488560355086626,-0.03855076605174954,0.007062205696662917,0.02909999999999996,0.04655714285714285,1039010009.9899988,0.022799999999999987,-0.9009009009009028,-65.68364611260054,34.31635388739945,39.749776586237715,-1.1384062312762209,0.5192,0.5316,0.4955,0.5004,7694690.0,15553.0,3469236.0,-3.6209553158705776,49.420127197904975,0.5998927272741046,0.4424472727258954,-0.03030259590701634,-0.04031631747591526,0.010013721568898924,0.036099999999999965,0.04774285714285714,1045902391.9899988,0.035599999999999965,-0.6156901688182725,-62.78820375335123,37.21179624664876,52.761394101876675,0.5294,0.5214834995901456,0.5517142857142857,0.534953238892292,0.52117,0.5524909805923903,75395.0,8712380.333333323,202360.0,12509117.857142856
2021-12-31,0.495,0.5399,0.4857,0.5025,35050783.0,37593.0,25277851.0,0.4992999999999999,0.5303714285714285,0.5189999999999999,0.5053708748975364,0.5193486968769142,0.5427760634781245,56.2676340185409,0.5986511340653357,0.4393488659346642,-0.03146060018927188,-0.03713273287925401,0.00567213268998213,0.054200000000000026,0.04702142857142858,1074060792.9899988,-0.061000000000000054,6.597369537547726,-61.66219839142095,38.337801608579056,36.62198391420911,1.5151515151515054,0.5007,0.5173,0.4882,0.495,6892382.0,15513.0,3063050.0,-1.1384062312762209,49.162634908820245,0.599884072316623,0.4410059276833768,-0.031488560355086626,-0.03855076605174954,0.007062205696662917,0.02909999999999996,0.04655714285714285,1039010009.9899988,0.022799999999999987,-0.9009009009009028,-65.68364611260054,34.31635388739945,39.749776586237715,0.5051333333333333,0.5082417497950729,0.5405,0.524964929169219,0.5204449999999999,0.5470156491074007,57034.0,4723571.333333324,190973.0,11976624.714285715
2022-01-01,0.5022,0.5273,0.5008,0.5231,24396149.0,29089.0,17728955.0,0.5068666666666667,0.5239428571428572,0.5177050000000001,0.5142354374487682,0.5202865226576856,0.5409021526706841,58.76092740402889,0.5961352700693886,0.43927472993061156,-0.02943686387486688,-0.03559355907837659,0.006156695203509706,0.026499999999999968,0.04660000000000001,1098456941.9899988,-0.03159999999999996,9.664570230607982,-50.616621983914214,49.383378016085786,40.67917783735478,4.1616885702907265,0.495,0.5399,0.4857,0.5025,35050783.0,37593.0,25277851.0,1.5151515151515054,56.2676340185409,0.5986511340653357,0.4393488659346642,-0.03146060018927188,-0.03713273287925401,0.00567213268998213,0.054200000000000026,0.04702142857142858,1074060792.9899988,-0.061000000000000054,6.597369537547726,-61.66219839142095,38.337801608579056,36.62198391420911,0.4992999999999999,0.5053708748975364,0.5303714285714285,0.5193486968769142,0.5189999999999999,0.5427760634781245,68659.0,10603378.99999999,196170.0,14285580.142857144
2022-01-02,0.5231,0.5698,0.5187,0.5661,19046422.0,34642.0,11823768.0,0.5305666666666666,0.5249857142857143,0.5220800000000001,0.5401677187243841,0.5317398919932642,0.5433019476544285,67.23375297720312,0.6010853589121744,0.44307464108782574,-0.024085653214009795,-0.03329197790550323,0.009206324691493434,0.05109999999999992,0.04831428571428572,1117503363.9899988,-0.007399999999999962,21.794320137693646,-27.560321715817686,72.43967828418232,53.38695263628241,8.220225578283317,0.5022,0.5273,0.5008,0.5231,24396149.0,29089.0,17728955.0,4.1616885702907265,58.76092740402889,0.5961352700693886,0.43927472993061156,-0.02943686387486688,-0.03559355907837659,0.006156695203509706,0.026499999999999968,0.04660000000000001,1098456941.9899988,-0.03159999999999996,9.664570230607982,-50.616621983914214,49.383378016085786,40.67917783735478,0.5068666666666667,0.5142354374487682,0.5239428571428572,0.5202865226576856,0.5177050000000001,0.5409021526706841,82195.0,15356618.666666657,191861.0,13767461.0
2022-01-03,0.5661,0.5698,0.5232,0.5355,15701337.0,27304.0,9468211.0,0.5415666666666666,0.5203714285714286,0.52454,0.5378338593621921,0.5326799189949482,0.5425589050206734,59.981078524124875,0.601901255092411,0.44717874490758897,-0.022059654511469184,-0.031045513226696422,0.008985858715227238,0.046599999999999975,0.04862857142857143,1101802026.9899988,-0.037900000000000045,13.405336721728078,-56.35738831615122,43.64261168384878,55.155222661372314,-5.405405405405418,0.5231,0.5698,0.5187,0.5661,19046422.0,34642.0,11823768.0,8.220225578283317,67.23375297720312,0.6010853589121744,0.44307464108782574,-0.024085653214009795,-0.03329197790550323,0.009206324691493434,0.05109999999999992,0.04831428571428572,1117503363.9899988,-0.007399999999999962,21.794320137693646,-27.560321715817686,72.43967828418232,53.38695263628241,0.5305666666666666,0.5401677187243841,0.5249857142857143,0.5317398919932642,0.5220800000000001,0.5433019476544285,101324.0,18276857.99999999,192232.0,12004395.0
2022-01-04,0.5349,0.5659,0.5206,0.5413,18776012.0,31919.0,11583250.0,0.5476333333333333,0.5234142857142857,0.52643,0.5395669296810961,0.5348349392462112,0.5424390093044188,45.20725388601038,0.6034732578422459,0.449386742157754,-0.0197582634537925,-0.028788063272115638,0.009029799818323136,0.04530000000000001,0.043078571428571424,1120578038.9899988,-0.026800000000000046,-3.9396628216504026,-57.81487101669198,42.18512898330802,52.75580631711306,1.196485324359686,0.5661,0.5698,0.5232,0.5355,15701337.0,27304.0,9468211.0,-5.405405405405418,59.981078524124875,0.601901255092411,0.44717874490758897,-0.022059654511469184,-0.031045513226696422,0.008985858715227238,0.046599999999999975,0.04862857142857143,1101802026.9899988,-0.037900000000000045,13.405336721728078,-56.35738831615122,43.64261168384878,55.155222661372314,0.5415666666666666,0.5378338593621921,0.5203714285714286,0.5326799189949482,0.52454,0.5425589050206734,91035.0,13006977.99999999,185662.0,11209928.42857143
2022-01-05,0.5413,0.65,0.5215,0.569,80299523.0,139059.0,44285078.0,0.5486,0.5332142857142858,0.5299050000000001,0.554283464840548,0.5433762044346584,0.5449686274659027,52.85429141716566,0.6080948761787073,0.4517151238212928,-0.015520327286623559,-0.026134516075017225,0.010614188788393666,0.12850000000000006,0.04901428571428571,1200877561.9899988,0.010199999999999987,2.5779700739138267,-49.300060864272716,50.69993913572729,45.50922660096138,5.117310179198217,0.5349,0.5659,0.5206,0.5413,18776012.0,31919.0,11583250.0,1.196485324359686,45.20725388601038,0.6034732578422459,0.449386742157754,-0.0197582634537925,-0.028788063272115638,0.009029799818323136,0.04530000000000001,0.043078571428571424,1120578038.9899988,-0.026800000000000046,-3.9396628216504026,-57.81487101669198,42.18512898330802,52.75580631711306,0.5476333333333333,0.5395669296810961,0.5234142857142857,0.5348349392462112,0.52643,0.5424390093044188,93865.0,10958409.666666657,191613.0,11773474.42857143
2022-01-06,0.569,0.63,0.5319,0.545,53798228.0,94699.0,26917976.0,0.5517666666666666,0.5403571428571429,0.533585,0.549641732420274,0.5437821533259938,0.5449716153262929,44.42706296441143,0.6069608105845985,0.46020918941540145,-0.013937667015632371,-0.023695146263140256,0.009757479247507885,0.09809999999999997,0.05235000000000001,1147079333.9899988,-0.02279999999999993,-4.969485614646896,-63.90748630553864,36.09251369446137,42.99252727116558,-4.2179261862917246,0.5413,0.65,0.5215,0.569,80299523.0,139059.0,44285078.0,5.117310179198217,52.85429141716566,0.6080948761787073,0.4517151238212928,-0.015520327286623559,-0.026134516075017225,0.010614188788393666,0.12850000000000006,0.04901428571428571,1200877561.9899988,0.010199999999999987,2.5779700739138267,-49.300060864272716,50.69993913572729,45.50922660096138,0.5486,0.554283464840548,0.5332142857142858,0.5433762044346584,0.5299050000000001,0.5449686274659027,198282.0,21778846.333333325,315119.0,17604309.0
2022-01-07,0.5451,0.5471,0.4943,0.4951,23951142.0,42142.0,11611175.0,0.5363666666666665,0.5393,0.53449,0.522370866210137,0.5316116149944953,0.5402219376761698,37.184942716857606,0.6053299203541972,0.46365007964580285,-0.016519483988324257,-0.02226001380817706,0.005740529819852801,0.052800000000000014,0.052707142857142855,1123128191.9899988,-0.024900000000000033,-13.655388908266486,-94.27875836883752,5.721241631162485,30.83789815378373,-9.172628875435707,0.569,0.63,0.5319,0.545,53798228.0,94699.0,26917976.0,-4.2179261862917246,44.42706296441143,0.6069608105845985,0.46020918941540145,-0.013937667015632371,-0.023695146263140256,0.009757479247507885,0.09809999999999997,0.05235000000000001,1147079333.9899988,-0.02279999999999993,-4.969485614646896,-63.90748630553864,36.09251369446137,42.99252727116558,0.5517666666666666,0.549641732420274,0.5403571428571429,0.5437821533259938,0.533585,0.5449716153262929,265677.0,27595434.666666657,394305.0,21012155.57142857
2022-01-08,0.4959,0.5282,0.4549,0.4737,18001040.0,31523.0,8559681.0,0.5045999999999999,0.5322428571428571,0.534935,0.4980354331050685,0.5171337112458715,0.533886515040344,35.3233830845771,0.6040217730504606,0.46584822694953953,-0.020061141343130418,-0.02182023931516773,0.0017590979720373129,0.07329999999999998,0.055364285714285706,1105127151.9899988,-0.026699999999999946,-16.616792818165827,-90.36391594054332,9.63608405945668,17.149946461693528,-4.476709013914095,0.5451,0.5471,0.4943,0.4951,23951142.0,42142.0,11611175.0,-9.172628875435707,37.184942716857606,0.6053299203541972,0.46365007964580285,-0.016519483988324257,-0.02226001380817706,0.005740529819852801,0.052800000000000014,0.052707142857142855,1123128191.9899988,-0.024900000000000033,-13.655388908266486,-94.27875836883752,5.721241631162485,30.83789815378373,0.5363666666666665,0.522370866210137,0.5393,0.5316116149944953,0.53449,0.5402219376761698,275900.0,27604742.99999999,398854.0,19059773.285714287
2022-01-09,0.4737,0.4889,0.4497,0.4648,14931859.0,22392.0,6917165.0,0.4778666666666666,0.5177714285714285,0.534565,0.48141771655253424,0.5040502834344036,0.5273068469412636,35.36737235367373,0.6051298868996289,0.46400011310037104,-0.023317298628598215,-0.022119651177853826,-0.0011976474507443893,0.03920000000000001,0.05635714285714285,1090195292.9899988,-0.030200000000000005,-16.821760916249108,-92.46130803794308,7.538691962056915,7.632005884225379,-1.878826261346848,0.4959,0.5282,0.4549,0.4737,18001040.0,31523.0,8559681.0,-4.476709013914095,35.3233830845771,0.6040217730504606,0.46584822694953953,-0.020061141343130418,-0.02182023931516773,0.0017590979720373129,0.07329999999999998,0.055364285714285706,1105127151.9899988,-0.026699999999999946,-16.616792818165827,-90.36391594054332,9.63608405945668,17.149946461693528,0.5045999999999999,0.4980354331050685,0.5322428571428571,0.5171337112458715,0.534935,0.533886515040344,168364.0,15696277.333333323,401288.0,17749877.0
2022-01-10,0.4652,0.4781,0.417,0.4508,18024268.9,29909.0,8953471.0,0.4631,0.5056714285714285,0.52893,0.46610885827626714,0.4907377125758027,0.5200204805659052,32.06621704475782,0.6073303786242166,0.45052962137578345,-0.026719503924863885,-0.02303962172725584,-0.003679882197608047,0.06110000000000004,0.057621428571428567,1072171024.0899988,-0.05169999999999997,-20.60584712927087,-85.49356223175965,14.50643776824034,10.560404596584664,-3.0954428202923525,0.4737,0.4889,0.4497,0.4648,14931859.0,22392.0,6917165.0,-1.878826261346848,35.36737235367373,0.6051298868996289,0.46400011310037104,-0.023317298628598215,-0.022119651177853826,-0.0011976474507443893,0.03920000000000001,0.05635714285714285,1090195292.9899988,-0.030200000000000005,-16.821760916249108,-92.46130803794308,7.538691962056915,7.632005884225379,0.4778666666666666,0.48141771655253424,0.5177714285714285,0.5040502834344036,0.534565,0.5273068469412636,96057.0,9029340.333333323,389038.0,17048933.714285713
2022-01-11,0.4508,0.4752,0.4342,0.4697,15818030.0,23928.0,7682198.0,0.46176666666666666,0.4954428571428572,0.5246799999999999,0.46790442913813357,0.48547828443185204,0.5152280538453428,41.540531449714095,0.6063459331152125,0.4430140668847874,-0.02757286130598524,-0.02394626964300172,-0.0036265916629835207,0.041000000000000036,0.055921428571428566,1087989054.0899987,-0.0534,-9.673076923076929,-77.38197424892704,22.618025751072967,14.887718493790095,4.192546583850938,0.4652,0.4781,0.417,0.4508,18024268.9,29909.0,8953471.0,-3.0954428202923525,32.06621704475782,0.6073303786242166,0.45052962137578345,-0.026719503924863885,-0.02303962172725584,-0.003679882197608047,0.06110000000000004,0.057621428571428567,1072171024.0899988,-0.05169999999999997,-20.60584712927087,-85.49356223175965,14.50643776824034,10.560404596584664,0.4631,0.46610885827626714,0.5056714285714285,0.4907377125758027,0.52893,0.5200204805659052,83824.0,8143438.99999999,391643.0,16975399.42857143
2022-01-12,0.4695,0.5185,0.456,0.5124,17288086.0,27986.0,8416816.0,0.4776333333333333,0.4873571428571429,0.521625,0.49015221456906677,0.49220871332388905,0.5149587153838815,51.87265917602997,0.6001107177755051,0.443139282224495,-0.02452095770081275,-0.024061207254563927,-0.00045975044624882444,0.062499999999999944,0.05780714285714285,1105277140.0899987,-0.05370000000000008,2.3980815347721895,-59.05579399141633,40.94420600858368,26.02288984263235,9.137380191693289,0.4508,0.4752,0.4342,0.4697,15818030.0,23928.0,7682198.0,4.192546583850938,41.540531449714095,0.6063459331152125,0.4430140668847874,-0.02757286130598524,-0.02394626964300172,-0.0036265916629835207,0.041000000000000036,0.055921428571428566,1087989054.0899987,-0.0534,-9.673076923076929,-77.38197424892704,22.618025751072967,14.887718493790095,0.46176666666666666,0.46790442913813357,0.4954428571428572,0.48547828443185204,0.5246799999999999,0.5152280538453428,76229.0,7850944.666666657,383652.0,16418106.285714285
2022-01-13,0.5124,0.544,0.4825,0.4861,22180163.0,37502.0,10879497.0,0.4894,0.47894285714285717,0.5172599999999999,0.4881261072845334,0.4906815349929168,0.5122102662997023,48.69616173454438,0.5932937155131601,0.44122628448683976,-0.02394842971726374,-0.02403865174710389,9.022202984014863e-05,0.061500000000000055,0.06012142857142858,1083096977.0899987,-0.0494,-1.7979797979797985,-70.34334763948499,29.65665236051501,31.07296137339057,-5.132708821233409,0.4695,0.5185,0.456,0.5124,17288086.0,27986.0,8416816.0,9.137380191693289,51.87265917602997,0.6001107177755051,0.443139282224495,-0.02452095770081275,-0.024061207254563927,-0.00045975044624882444,0.062499999999999944,0.05780714285714285,1105277140.0899987,-0.05370000000000008,2.3980815347721895,-59.05579399141633,40.94420600858368,26.02288984263235,0.4776333333333333,0.49015221456906677,0.4873571428571429,0.49220871332388905,0.521625,0.5149587153838815,81823.0,8350828.333333324,272579.0,11294068.857142856
2022-01-14,0.4859,0.5093,0.4682,0.5054,15192042.0,23939.0,7493128.0,0.5013,0.4804142857142857,0.5141249999999999,0.4967630536422667,0.4943611512446876,0.5115616695092545,50.410648541489664,0.5864105994976602,0.4418394005023397,-0.021687350189215193,-0.02356839143552615,0.0018810412463109577,0.04109999999999997,0.059185714285714286,1098289019.0899987,-0.03590000000000004,0.5771144278607032,-62.060085836909884,37.93991416309011,36.180257510729625,4.013171434451525,0.5124,0.544,0.4825,0.4861,22180163.0,37502.0,10879497.0,-5.132708821233409,48.69616173454438,0.5932937155131601,0.44122628448683976,-0.02394842971726374,-0.02403865174710389,9.022202984014863e-05,0.061500000000000055,0.06012142857142858,1083096977.0899987,-0.0494,-1.7979797979797985,-70.34334763948499,29.65665236051501,31.07296137339057,0.4894,0.4881261072845334,0.47894285714285717,0.4906815349929168,0.5172599999999999,0.5122102662997023,89416.0,8992836.99999999,215382.0,9002857.57142857
2022-01-15,0.5054,0.5099,0.483,0.497,12343411.0,19675.0,6345056.0,0.4961666666666666,0.4837428571428571,0.511035,0.49688152682113335,0.4950208634335157,0.5101748438417064,46.171897917277796,0.5805084868019471,0.441561513198053,-0.020338785314656216,-0.022922470211352165,0.0025836848966959494,0.026900000000000035,0.05921428571428572,1085945608.0899987,-0.07199999999999995,-4.989485757981271,-65.66523605150213,34.33476394849785,33.97711015736768,-1.6620498614958377,0.4859,0.5093,0.4682,0.5054,15192042.0,23939.0,7493128.0,4.013171434451525,50.410648541489664,0.5864105994976602,0.4418394005023397,-0.021687350189215193,-0.02356839143552615,0.0018810412463109577,0.04109999999999997,0.059185714285714286,1098289019.0899987,-0.03590000000000004,0.5771144278607032,-62.060085836909884,37.93991416309011,36.180257510729625,0.5013,0.4967630536422667,0.4804142857142857,0.4943611512446876,0.5141249999999999,0.5115616695092545,89427.0,8929813.666666657,197179.0,8414565.142857144
2022-01-16,0.4966,0.5084,0.4787,0.4834,12952652.0,20170.0,6374121.0,0.4952666666666666,0.4864,0.506815,0.49014076341056667,0.4921156475751368,0.5076248587139248,36.72552166934189,0.5718841057746685,0.4417458942253315,-0.020135336648666624,-0.02236504349881506,0.0022297068501484357,0.02969999999999995,0.057685714285714285,1072992956.0899987,-0.061600000000000044,-14.608726373432269,-71.50214592274679,28.49785407725322,33.59084406294708,-2.658074909383808,0.5054,0.5099,0.483,0.497,12343411.0,19675.0,6345056.0,-1.6620498614958377,46.171897917277796,0.5805084868019471,0.441561513198053,-0.020338785314656216,-0.022922470211352165,0.0025836848966959494,0.026900000000000035,0.05921428571428572,1085945608.0899987,-0.07199999999999995,-4.989485757981271,-65.66523605150213,34.33476394849785,33.97711015736768,0.4961666666666666,0.49688152682113335,0.4837428571428571,0.4950208634335157,0.511035,0.5101748438417064,81116.0,8239226.99999999,185331.0,8098190.142857143
2022-01-17,0.4834,0.484,0.4494,0.4635,12756153.0,18689.0,6421416.0,0.4813,0.4882142857142857,0.50399,0.47682038170528335,0.48496173568135265,0.5034224912173605,38.03191489361702,0.5715086960462704,0.4364713039537297,-0.02133394140723699,-0.022158823080499445,0.0008248816732624557,0.034599999999999964,0.05682857142857144,1060236803.0899987,-0.03159999999999996,-13.4453781512605,-80.0429184549356,19.95708154506439,27.596566523605176,-4.116673562267268,0.4966,0.5084,0.4787,0.4834,12952652.0,20170.0,6374121.0,-2.658074909383808,36.72552166934189,0.5718841057746685,0.4417458942253315,-0.020135336648666624,-0.02236504349881506,0.0022297068501484357,0.02969999999999995,0.057685714285714285,1072992956.0899987,-0.061600000000000044,-14.608726373432269,-71.50214592274679,28.49785407725322,33.59084406294708,0.4952666666666666,0.49014076341056667,0.4864,0.4921156475751368,0.506815,0.5076248587139248,63784.0,6737434.99999999,183109.0,8020612.428571428
2022-01-18,0.4631,0.4758,0.4378,0.4722,13881608.0,20367.0,6857441.0,0.47303333333333325,0.48857142857142855,0.5025799999999999,0.4745101908526417,0.48177130176101446,0.5004489206252309,38.62364175172868,0.5715760059866106,0.4335839940133892,-0.021335880276119934,-0.021994234519623544,0.0006583542435036095,0.03799999999999998,0.056307142857142854,1074118411.0899987,-0.0015000000000000013,-12.765564382043227,-76.30901287553648,23.69098712446353,24.048640915593733,1.9650183545670477,0.4834,0.484,0.4494,0.4635,12756153.0,18689.0,6421416.0,-4.116673562267268,38.03191489361702,0.5715086960462704,0.4364713039537297,-0.02133394140723699,-0.022158823080499445,0.0008248816732624557,0.034599999999999964,0.05682857142857144,1060236803.0899987,-0.03159999999999996,-13.4453781512605,-80.0429184549356,19.95708154506439,27.596566523605176,0.4813,0.47682038170528335,0.4882142857142857,0.48496173568135265,0.50399,0.5034224912173605,58534.0,6380197.666666657,171889.0,7658890.285714285
2022-01-19,0.4722,0.4875,0.4402,0.4634,16189758.0,25895.0,8194442.0,0.4663666666666666,0.4815714285714286,0.501,0.46895509542632086,0.4771784763207608,0.4969204519942566,31.460674157303373,0.5721408092225639,0.429859190777436,-0.021796249700160697,-0.021954637555730974,0.00015838785557027724,0.04730000000000001,0.05050714285714285,1057928653.0899987,-0.0014000000000000123,-18.558875219683657,-78.21596244131456,21.784037558685444,21.81070207607114,-1.8636171113934836,0.4631,0.4758,0.4378,0.4722,13881608.0,20367.0,6857441.0,1.9650183545670477,38.62364175172868,0.5715760059866106,0.4335839940133892,-0.021335880276119934,-0.021994234519623544,0.0006583542435036095,0.03799999999999998,0.056307142857142854,1074118411.0899987,-0.0015000000000000013,-12.765564382043227,-76.30901287553648,23.69098712446353,24.048640915593733,0.47303333333333325,0.4745101908526417,0.48857142857142855,0.48177130176101446,0.5025799999999999,0.5004489206252309,59226.0,6550992.666666657,168328.0,7541067.857142857
2022-01-20,0.4636,0.5427,0.4537,0.4607,39645628.0,62277.0,19647488.0,0.4654333333333333,0.4779428571428571,0.49890999999999996,0.4648275477131604,0.4730588572405706,0.49347088513766074,34.003795066413645,0.5722861728140765,0.4255338271859235,-0.022123932300760596,-0.0219884965047369,-0.0001354357960236946,0.08899999999999997,0.04985714285714286,1018283025.0899987,0.00990000000000002,-15.467889908256883,-66.41045349730976,33.58954650269024,26.35485706194643,-0.6255392579810211,0.4722,0.4875,0.4402,0.4634,16189758.0,25895.0,8194442.0,-1.8636171113934836,31.460674157303373,0.5721408092225639,0.429859190777436,-0.021796249700160697,-0.021954637555730974,0.00015838785557027724,0.04730000000000001,0.05050714285714285,1057928653.0899987,-0.0014000000000000123,-18.558875219683657,-78.21596244131456,21.784037558685444,21.81070207607114,0.4663666666666666,0.46895509542632086,0.4815714285714286,0.4771784763207608,0.501,0.4969204519942566,64951.0,7157766.333333324,166237.0,7509300.142857143
2022-01-21,0.4603,0.4749,0.3667,0.3771,32875687.1,49130.0,15684818.1,0.4337333333333333,0.4596142857142857,0.49161,0.42096377385658024,0.449069142930428,0.48238794369597876,30.14804845222072,0.5819439045751289,0.4012760954248711,-0.02879748496731882,-0.023350294197253287,-0.005447190770065533,0.10819999999999996,0.0538142857142857,985407337.9899987,-0.09260000000000002,-23.833568975964447,-94.13423575860126,5.865764241398739,20.413116100924828,-18.075168368455355,0.4636,0.5427,0.4537,0.4607,39645628.0,62277.0,19647488.0,-0.6255392579810211,34.003795066413645,0.5722861728140765,0.4255338271859235,-0.022123932300760596,-0.0219884965047369,-0.0001354357960236946,0.08899999999999997,0.04985714285714286,1018283025.0899987,0.00990000000000002,-15.467889908256883,-66.41045349730976,33.58954650269024,26.35485706194643,0.4654333333333333,0.4648275477131604,0.4779428571428571,0.4730588572405706,0.49890999999999996,0.49347088513766074,108539.0,11566456.99999999,191012.0,8761870.285714285
2022-01-22,0.3772,0.3914,0.3111,0.3351,31818431.1,43758.0,16092424.6,0.39096666666666663,0.4364857142857143,0.48005999999999993,0.37803188692829015,0.42057685719782095,0.46836052048683796,28.193832599118934,0.5877042366511528,0.3724157633488471,-0.0370483027548808,-0.02608989590877879,-0.010958406846102012,0.08030000000000004,0.05431428571428571,953588906.8899987,-0.17729999999999996,-29.259024699176695,-89.69514813224559,10.304851867754408,16.586720870614485,-11.161187698833503,0.4603,0.4749,0.3667,0.3771,32875687.1,49130.0,15684818.1,-18.075168368455355,30.14804845222072,0.5819439045751289,0.4012760954248711,-0.02879748496731882,-0.023350294197253287,-0.005447190770065533,0.10819999999999996,0.0538142857142857,985407337.9899987,-0.09260000000000002,-23.833568975964447,-94.13423575860126,5.865764241398739,20.413116100924828,0.4337333333333333,0.42096377385658024,0.4596142857142857,0.449069142930428,0.49161,0.48238794369597876,137302.0,14508916.033333324,216203.0,9932111.728571428
2022-01-23,0.3357,0.3689,0.326,0.3554,19391281.0,26073.0,9703363.0,0.3558666666666666,0.4182,0.47105500000000006,0.36671594346414504,0.4042826428983657,0.45760237567856765,33.383961117861475,0.5888275814753469,0.3532824185246533,-0.04147104258553613,-0.02916612524413026,-0.012304917341405874,0.042899999999999994,0.05457857142857142,972980187.8899987,-0.13069999999999998,-23.537005163511182,-80.97896092743667,19.02103907256333,11.730551727238849,5.868334822758413,0.3772,0.3914,0.3111,0.3351,31818431.1,43758.0,16092424.6,-11.161187698833503,28.193832599118934,0.5877042366511528,0.3724157633488471,-0.0370483027548808,-0.02608989590877879,-0.010958406846102012,0.08030000000000004,0.05431428571428571,953588906.8899987,-0.17729999999999996,-29.259024699176695,-89.69514813224559,10.304851867754408,16.586720870614485,0.39096666666666663,0.37803188692829015,0.4364857142857143,0.42057685719782095,0.48005999999999993,0.46836052048683796,155165.0,17141576.89999999,240286.0,11324592.957142858
2022-01-24,0.3547,0.3547,0.2837,0.3269,34476978.3,32980.0,17129363.0,0.3391333333333333,0.39868571428571425,0.460335,0.34680797173207256,0.38493698217377426,0.44515453037584696,31.975560081466384,0.5896508072317481,0.33101919276825187,-0.04673705193906336,-0.03268031058311688,-0.014056741355946478,0.07100000000000001,0.05528571428571427,938503209.5899987,-0.17849999999999994,-27.484472049689433,-83.40376488666922,16.596235113330778,15.307375351216194,-7.837609247251195,0.3357,0.3689,0.326,0.3554,19391281.0,26073.0,9703363.0,5.868334822758413,33.383961117861475,0.5888275814753469,0.3532824185246533,-0.04147104258553613,-0.02916612524413026,-0.012304917341405874,0.042899999999999994,0.05457857142857142,972980187.8899987,-0.13069999999999998,-23.537005163511182,-80.97896092743667,19.02103907256333,11.730551727238849,0.3558666666666666,0.36671594346414504,0.4182,0.4042826428983657,0.47105500000000006,0.45760237567856765,118961.0,13826868.566666657,246189.0,11800198.957142858
2022-01-25,0.3268,0.3384,0.3129,0.3241,14967440.0,16015.0,7879347.0,0.33546666666666664,0.37752857142857144,0.44809,0.33545398586603625,0.3697277366303307,0.43362552748290917,27.77777777777777,0.5804255686761521,0.3157544313238478,-0.05055358858995723,-0.036254966184484955,-0.014298622405472278,0.025499999999999967,0.05417857142857142,923535769.5899987,-0.1729,-30.998509687034282,-84.47944679216289,15.520553207837107,17.045942464577095,-0.8261933904528704,0.3547,0.3547,0.2837,0.3269,34476978.3,32980.0,17129363.0,-7.837609247251195,31.975560081466384,0.5896508072317481,0.33101919276825187,-0.04673705193906336,-0.03268031058311688,-0.014056741355946478,0.07100000000000001,0.05528571428571427,938503209.5899987,-0.17849999999999994,-27.484472049689433,-83.40376488666922,16.596235113330778,15.307375351216194,0.3391333333333333,0.34680797173207256,0.39868571428571425,0.38493698217377426,0.460335,0.44515453037584696,102811.0,14308383.533333322,260480.0,13329905.671428572
2022-01-26,0.3243,0.3547,0.3078,0.3163,16762340.0,21580.0,8269169.0,0.32243333333333335,0.35651428571428573,0.436655,0.32587699293301814,0.35637080247274805,0.4224516677226321,16.501537410317724,0.5731889437263571,0.30012105627364294,-0.053589865583222096,-0.039721946064232384,-0.013867919518989712,0.0469,0.05306428571428571,906773429.5899987,-0.16709999999999997,-38.27088212334113,-87.47598924318095,12.52401075681906,14.880266359329006,-2.4668516805426925,0.3268,0.3384,0.3129,0.3241,14967440.0,16015.0,7879347.0,-0.8261933904528704,27.77777777777777,0.5804255686761521,0.3157544313238478,-0.05055358858995723,-0.036254966184484955,-0.014298622405472278,0.025499999999999967,0.05417857142857142,923535769.5899987,-0.1729,-30.998509687034282,-84.47944679216289,15.520553207837107,17.045942464577095,0.33546666666666664,0.33545398586603625,0.37752857142857144,0.3697277366303307,0.44809,0.43362552748290917,75068.0,11570690.99999999,256128.0,13475892.242857143
2022-01-27,0.3162,0.3276,0.2977,0.3138,10331634.0,10957.0,5043870.0,0.31806666666666666,0.33552857142857145,0.42759,0.3198384964665091,0.34572810185456104,0.4121038898442862,17.962067683153577,0.5716523096185461,0.283527690381454,-0.05555743455990286,-0.04288904376336648,-0.01266839079653638,0.029899999999999982,0.05080714285714284,896441795.5899987,-0.1497,-35.445381608722485,-88.37837837837837,11.62162162162163,13.222061862092623,-0.7590132827324345,0.3243,0.3547,0.3078,0.3163,16762340.0,21580.0,8269169.0,-2.4668516805426925,16.501537410317724,0.5731889437263571,0.30012105627364294,-0.053589865583222096,-0.039721946064232384,-0.013867919518989712,0.0469,0.05306428571428571,906773429.5899987,-0.16709999999999997,-38.27088212334113,-87.47598924318095,12.52401075681906,14.880266359329006,0.32243333333333335,0.32587699293301814,0.35651428571428573,0.35637080247274805,0.436655,0.4224516677226321,70575.0,11092626.333333323,251813.0,13486567.528571429
2022-01-28,0.3131,0.3206,0.2993,0.3154,9701091.0,9712.0,4663972.0,0.31516666666666665,0.3267142857142857,0.41967499999999996,0.31761924823325455,0.33814607639092076,0.40289399557340183,12.181528662420376,0.5703148825362143,0.2690351174637856,-0.05633820872043732,-0.04557887675478065,-0.01075933196565667,0.021299999999999986,0.04939285714285713,906142886.5899987,-0.1568,-37.59398496240601,-87.76061776061775,12.239382239382243,12.128338205941,0.7345895879910649,0.3162,0.3276,0.2977,0.3138,10331634.0,10957.0,5043870.0,-0.7590132827324345,17.962067683153577,0.5716523096185461,0.283527690381454,-0.05555743455990286,-0.04288904376336648,-0.01266839079653638,0.029899999999999982,0.05080714285714284,896441795.5899987,-0.1497,-35.445381608722485,-88.37837837837837,11.62162162162163,13.222061862092623,0.31806666666666666,0.3198384964665091,0.33552857142857145,0.34572810185456104,0.42759,0.4121038898442862,48552.0,7064128.666666657,200493.0,11400336.385714287
2022-01-29,0.3153,0.3311,0.3112,0.3159,12800463.0,12176.0,6092961.0,0.31503333333333333,0.32397142857142863,0.41223,0.3167596241166273,0.3325845572931906,0.3946088531378397,12.782572955199328,0.5681066057191533,0.25635339428084675,-0.05626800945908472,-0.04771670329564147,-0.008551306163443254,0.01990000000000003,0.048892857142857134,918943349.5899987,-0.14749999999999996,-36.438631790744466,-87.56756756756756,12.432432432432437,12.097812097812126,0.19029495718363126,0.3131,0.3206,0.2993,0.3154,9701091.0,9712.0,4663972.0,0.7345895879910649,12.181528662420376,0.5703148825362143,0.2690351174637856,-0.05633820872043732,-0.04557887675478065,-0.01075933196565667,0.021299999999999986,0.04939285714285713,906142886.5899987,-0.1568,-37.59398496240601,-87.76061776061775,12.239382239382243,12.128338205941,0.31516666666666665,0.31761924823325455,0.3267142857142857,0.33814607639092076,0.41967499999999996,0.40289399557340183,42249.0,5992336.99999999,161075.0,9825929.799999999
2022-01-30,0.3162,0.33,0.3016,0.3107,11421492.0,11636.0,5737725.0,0.314,0.3175857142857143,0.405225,0.31372981205831363,0.3271134179698929,0.38661753379137875,13.239676458067251,0.5663085007395986,0.24414149926040138,-0.05598659397558525,-0.04937068143163023,-0.0066159125439550215,0.028400000000000036,0.048799999999999996,907521857.5899987,-0.15000000000000002,-35.726106743897404,-89.57528957528959,10.424710424710415,11.698841698841724,-1.7394054395951943,0.3153,0.3311,0.3112,0.3159,12800463.0,12176.0,6092961.0,0.19029495718363126,12.782572955199328,0.5681066057191533,0.25635339428084675,-0.05626800945908472,-0.04771670329564147,-0.008551306163443254,0.01990000000000003,0.048892857142857134,918943349.5899987,-0.14749999999999996,-36.438631790744466,-87.56756756756756,12.432432432432437,12.097812097812126,0.31503333333333333,0.3167596241166273,0.32397142857142863,0.3325845572931906,0.41223,0.3946088531378397,32845.0,5266934.333333324,129493.0,8397435.0
2022-01-31,0.3104,0.3325,0.2924,0.3206,11896970.0,11232.0,5717797.0,0.31573333333333325,0.3166857142857143,0.39777,0.3171649060291568,0.3254850634774197,0.3803301496207713,18.230324588706083,0.5600856911051585,0.2354543088948415,-0.054338344306455066,-0.0503642140065952,-0.0039741302998598654,0.040100000000000025,0.04919285714285714,919418827.5899987,-0.056499999999999995,-30.83063646170443,-85.75289575289575,14.247104247104245,12.368082368082389,3.2860824742268,0.3162,0.33,0.3016,0.3107,11421492.0,11636.0,5737725.0,-1.7394054395951943,13.239676458067251,0.5663085007395986,0.24414149926040138,-0.05598659397558525,-0.04937068143163023,-0.0066159125439550215,0.028400000000000036,0.048799999999999996,907521857.5899987,-0.15000000000000002,-35.726106743897404,-89.57528957528959,10.424710424710415,11.698841698841724,0.314,0.31372981205831363,0.3175857142857143,0.3271134179698929,0.405225,0.38661753379137875,33524.0,5498219.333333324,115056.0,7830915.285714285
2022-02-01,0.3204,0.3357,0.3179,0.3256,10283079.0,11701.0,5099872.0,0.3189666666666666,0.3169,0.38843,0.3213824530145784,0.32551379760806476,0.3751177544187931,16.862567811934895,0.5443443368040617,0.23251566319593833,-0.05202887981575244,-0.05069714716842665,-0.0013317326473257854,0.017799999999999983,0.04775000000000001,929701906.5899987,-0.009500000000000008,-31.04616687844134,-83.82239382239382,16.177606177606176,13.616473616473636,1.6229712858926284,0.3104,0.3325,0.2924,0.3206,11896970.0,11232.0,5717797.0,3.2860824742268,18.230324588706083,0.5600856911051585,0.2354543088948415,-0.054338344306455066,-0.0503642140065952,-0.0039741302998598654,0.040100000000000025,0.04919285714285714,919418827.5899987,-0.056499999999999995,-30.83063646170443,-85.75289575289575,14.247104247104245,12.368082368082389,0.31573333333333325,0.3171649060291568,0.3166857142857143,0.3254850634774197,0.39777,0.3803301496207713,35044.0,5849494.333333324,93308.0,6200691.571428572
2022-02-02,0.3258,0.33,0.3,0.3032,10979077.0,14758.0,5383368.0,0.3164666666666666,0.31502857142857144,0.379285,0.31229122650728924,0.3199353482060486,0.36826844447414614,15.885860306643949,0.5325107952036376,0.22605920479636232,-0.05141344319408225,-0.05084040637355777,-0.0005730368205244807,0.030000000000000027,0.046514285714285716,918722829.5899987,-0.05219999999999997,-34.57056538627534,-92.47104247104247,7.5289575289575374,12.651222651222676,-6.9367710251688015,0.3204,0.3357,0.3179,0.3256,10283079.0,11701.0,5099872.0,1.6229712858926284,16.862567811934895,0.5443443368040617,0.23251566319593833,-0.05202887981575244,-0.05069714716842665,-0.0013317326473257854,0.017799999999999983,0.04775000000000001,929701906.5899987,-0.009500000000000008,-31.04616687844134,-83.82239382239382,16.177606177606176,13.616473616473636,0.3189666666666666,0.3213824530145784,0.3169,0.32551379760806476,0.38843,0.3751177544187931,34569.0,5518464.666666657,88994.0,5803623.714285715
2022-02-03,0.3032,0.3154,0.2983,0.3145,9981556.0,11352.0,5109625.0,0.3144333333333333,0.3151285714285715,0.36974,0.3133956132536446,0.31857651115453645,0.3631476402385132,19.967132292522592,0.5133704820308648,0.22610951796913523,-0.049443930818767134,-0.05056111126259964,0.0011171804438325078,0.017100000000000004,0.041378571428571424,928704385.5899987,-0.012400000000000022,-31.734317343173434,-83.89121338912135,16.10878661087866,13.271783439147482,3.726912928759887,0.3258,0.33,0.3,0.3032,10979077.0,14758.0,5383368.0,-6.9367710251688015,15.885860306643949,0.5325107952036376,0.22605920479636232,-0.05141344319408225,-0.05084040637355777,-0.0005730368205244807,0.030000000000000027,0.046514285714285716,918722829.5899987,-0.05219999999999997,-34.57056538627534,-92.47104247104247,7.5289575289575374,12.651222651222676,0.3164666666666666,0.31229122650728924,0.31502857142857144,0.3199353482060486,0.379285,0.36826844447414614,37691.0,5400345.666666657,82172.0,5391366.428571428
2022-02-04,0.3147,0.3375,0.3095,0.3369,12293067.0,16076.0,6075398.0,0.3182,0.31820000000000004,0.36173500000000003,0.3251478066268223,0.32315738336590233,0.3606478649777024,38.9681668496158,0.49279778567721316,0.2306722143227869,-0.045550507381482974,-0.04955899048637631,0.004008483104893337,0.028000000000000025,0.03565000000000001,940997452.5899987,0.012799999999999978,-10.66030230708035,-50.60352831940579,49.3964716805942,24.344738606810157,7.0543374642516685,0.3032,0.3154,0.2983,0.3145,9981556.0,11352.0,5109625.0,3.726912928759887,19.967132292522592,0.5133704820308648,0.22610951796913523,-0.049443930818767134,-0.05056111126259964,0.0011171804438325078,0.017100000000000004,0.041378571428571424,928704385.5899987,-0.012400000000000022,-31.734317343173434,-83.89121338912135,16.10878661087866,13.271783439147482,0.3144333333333333,0.3133956132536446,0.3151285714285715,0.31857651115453645,0.36974,0.3631476402385132,37811.0,5197621.666666657,82567.0,5400760.0
2022-02-05,0.3368,0.3544,0.3331,0.3436,17479006.0,20441.0,8760060.0,0.3316666666666666,0.32215714285714286,0.354745,0.33437390331341116,0.3282680375244268,0.3590242587893498,52.89312457454051,0.47274786303394445,0.2367421369660555,-0.04144653736786735,-0.04793649986267452,0.006489962494807169,0.021299999999999986,0.03143571428571429,958476458.5899987,0.02729999999999999,2.5365562518651075,-29.694835680751165,70.30516431924883,45.270140870240596,2.0190023752969206,0.3147,0.3375,0.3095,0.3369,12293067.0,16076.0,6075398.0,7.0543374642516685,38.9681668496158,0.49279778567721316,0.2306722143227869,-0.045550507381482974,-0.04955899048637631,0.004008483104893337,0.028000000000000025,0.03565000000000001,940997452.5899987,0.012799999999999978,-10.66030230708035,-50.60352831940579,49.3964716805942,24.344738606810157,0.3182,0.3251478066268223,0.31820000000000004,0.32315738336590233,0.36173500000000003,0.3606478649777024,42186.0,5522796.99999999,88931.0,5602392.285714285
2022-02-06,0.3436,0.3555,0.3368,0.3487,10868799.0,13269.0,5516342.0,0.34306666666666663,0.32758571428571426,0.349005,0.3415369516567056,0.3333760281433201,0.35804099604750694,47.456340167046314,0.4553234387632263,0.24268656123677373,-0.037352013427081776,-0.04581960257555598,0.008467589148474203,0.018699999999999994,0.02970714285714286,969345257.5899987,0.03489999999999999,-1.8851997749015137,-9.470752089136456,90.52924791086355,70.0769613035689,1.4842840512223496,0.3368,0.3544,0.3331,0.3436,17479006.0,20441.0,8760060.0,2.0190023752969206,52.89312457454051,0.47274786303394445,0.2367421369660555,-0.04144653736786735,-0.04793649986267452,0.006489962494807169,0.021299999999999986,0.03143571428571429,958476458.5899987,0.02729999999999999,2.5365562518651075,-29.694835680751165,70.30516431924883,45.270140870240596,0.3316666666666666,0.33437390331341116,0.32215714285714286,0.3282680375244268,0.354745,0.3590242587893498,47869.0,6648360.99999999,97196.0,5983406.428571428
2022-02-07,0.3488,0.4241,0.341,0.3897,39833210.0,54371.0,22331198.0,0.36066666666666664,0.33745714285714284,0.34487999999999996,0.36561847582835283,0.3474570211074901,0.3610561392810777,71.77531206657419,0.4364521309017757,0.2533078690982242,-0.030447733833280144,-0.042745228827100815,0.01229749499382067,0.08309999999999995,0.030571428571428572,1009178467.5899987,0.07429999999999998,19.21076781890485,-26.119969627942286,73.88003037205772,78.23814753405672,11.72591743119266,0.3436,0.3555,0.3368,0.3487,10868799.0,13269.0,5516342.0,1.4842840512223496,47.456340167046314,0.4553234387632263,0.24268656123677373,-0.037352013427081776,-0.04581960257555598,0.008467589148474203,0.018699999999999994,0.02970714285714286,969345257.5899987,0.03489999999999999,-1.8851997749015137,-9.470752089136456,90.52924791086355,70.0769613035689,0.34306666666666663,0.3415369516567056,0.32758571428571426,0.3333760281433201,0.349005,0.35804099604750694,49786.0,6783933.333333324,98829.0,5951780.285714285
2022-02-08,0.3897,0.4234,0.3655,0.3868,45088324.0,57522.0,26142220.0,0.37506666666666666,0.3462,0.34104999999999996,0.3762092379141764,0.3572927658306176,0.3635079355400227,71.72557172557173,0.4167889283206137,0.2653110716793862,-0.02492275427878282,-0.03918073391743722,0.014257979638654397,0.05790000000000001,0.03288571428571429,964090143.5899987,0.07089999999999996,19.34588090095648,-28.321943811693245,71.67805618830675,78.69577815707602,-0.7441621760328493,0.3488,0.4241,0.341,0.3897,39833210.0,54371.0,22331198.0,11.72591743119266,71.77531206657419,0.4364521309017757,0.2533078690982242,-0.030447733833280144,-0.042745228827100815,0.01229749499382067,0.08309999999999995,0.030571428571428572,1009178467.5899987,0.07429999999999998,19.21076781890485,-26.119969627942286,73.88003037205772,78.23814753405672,0.36066666666666664,0.36561847582835283,0.33745714285714284,0.3474570211074901,0.34487999999999996,0.3610561392810777,88081.0,12202533.333333323,141968.0,8325123.285714285
2022-02-09,0.3866,0.4338,0.3783,0.4193,16832355.0,27673.0,9035914.0,0.3986,0.36278571428571427,0.33897999999999995,0.3977546189570882,0.3727945743729632,0.36882146548859196,80.47337278106508,0.402174057015691,0.2757859429843089,-0.017717454009261724,-0.03488807793580212,0.017170623926540396,0.055499999999999994,0.0335,980922498.5899987,0.10860000000000003,32.56402149857729,-10.254596888260261,89.74540311173975,78.43449655736809,8.458354888773927,0.3897,0.4234,0.3655,0.3868,45088324.0,57522.0,26142220.0,-0.7441621760328493,71.72557172557173,0.4167889283206137,0.2653110716793862,-0.02492275427878282,-0.03918073391743722,0.014257979638654397,0.05790000000000001,0.03288571428571429,964090143.5899987,0.07089999999999996,19.34588090095648,-28.321943811693245,71.67805618830675,78.69577815707602,0.37506666666666666,0.3762092379141764,0.3462,0.3572927658306176,0.34104999999999996,0.3635079355400227,125162.0,17996586.666666657,187789.0,11331173.0
2022-02-10,0.4193,0.4298,0.3787,0.3951,27731250.0,42243.0,14310085.0,0.4003999999999999,0.37429999999999997,0.33988,0.3964273094785441,0.3783709307797224,0.37132418306110704,71.3162034609334,0.40581328685714546,0.27394671314285457,-0.013800851758106858,-0.030670632700263066,0.016869780942156208,0.051100000000000034,0.03501428571428572,953191248.5899987,0.07450000000000001,25.90822179732313,-27.36916548797737,72.63083451202263,78.0180979373564,-5.77152396851896,0.3866,0.4338,0.3783,0.4193,16832355.0,27673.0,9035914.0,8.458354888773927,80.47337278106508,0.402174057015691,0.2757859429843089,-0.017717454009261724,-0.03488807793580212,0.017170623926540396,0.055499999999999994,0.0335,980922498.5899987,0.10860000000000003,32.56402149857729,-10.254596888260261,89.74540311173975,78.43449655736809,0.3986,0.3977546189570882,0.36278571428571427,0.3727945743729632,0.33897999999999995,0.36882146548859196,139566.0,19169777.333333325,200704.0,11852965.285714285
2022-02-11,0.3951,0.4048,0.35,0.3633,23743971.0,32173.0,13235909.0,0.39256666666666656,0.3780714285714285,0.34129000000000004,0.3798636547392721,0.37460319808479176,0.3705599751505254,60.84200995925758,0.40799449838849206,0.274585501611508,-0.01311176621366239,-0.027158859402942933,0.014047093189280543,0.054800000000000015,0.03740714285714286,929447277.5899987,0.03770000000000001,15.187064045656307,-49.858557284299856,50.141442715700144,70.83922677982086,-8.048595292331054,0.4193,0.4298,0.3787,0.3951,27731250.0,42243.0,14310085.0,-5.77152396851896,71.3162034609334,0.40581328685714546,0.27394671314285457,-0.013800851758106858,-0.030670632700263066,0.016869780942156208,0.051100000000000034,0.03501428571428572,953191248.5899987,0.07450000000000001,25.90822179732313,-27.36916548797737,72.63083451202263,78.0180979373564,0.4003999999999999,0.3964273094785441,0.37429999999999997,0.3783709307797224,0.33988,0.37132418306110704,127438.0,16496072.99999999,231595.0,13167316.714285715
2022-02-12,0.3631,0.3698,0.3418,0.3461,18962633.0,30088.0,12480242.0,0.3681666666666666,0.37842857142857145,0.34082500000000004,0.362981827369636,0.36747739856359385,0.3682304537076182,56.35521885521886,0.40724439713507377,0.2744056028649263,-0.013794542311733993,-0.024485995984701144,0.01069145367296715,0.028000000000000025,0.03798571428571429,910484644.5899987,0.042899999999999994,9.559987337765108,-62.022630834512015,37.97736916548799,53.583215464403615,-4.681905811071319,0.3951,0.4048,0.35,0.3633,23743971.0,32173.0,13235909.0,-8.048595292331054,60.84200995925758,0.40799449838849206,0.274585501611508,-0.01311176621366239,-0.027158859402942933,0.014047093189280543,0.054800000000000015,0.03740714285714286,929447277.5899987,0.03770000000000001,15.187064045656307,-49.858557284299856,50.141442715700144,70.83922677982086,0.39256666666666656,0.3798636547392721,0.3780714285714285,0.37460319808479176,0.34129000000000004,0.3705599751505254,102089.0,12193969.333333323,247692.0,14190246.857142856
2022-02-13,0.3461,0.366,0.3353,0.3355,12831388.0,21347.0,7290392.0,0.3483,0.3765428571428572,0.341255,0.349240913684818,0.35948304892269545,0.365113267640226,55.10288065843623,0.4074056247732545,0.27510437522674547,-0.015017862134305893,-0.022592369214622095,0.007574507080316203,0.030700000000000005,0.03815000000000001,897653256.5899987,0.02100000000000002,7.981976182813022,-69.5190947666195,30.480905233380497,39.53323903818957,-3.0626986420109787,0.3631,0.3698,0.3418,0.3461,18962633.0,30088.0,12480242.0,-4.681905811071319,56.35521885521886,0.40724439713507377,0.2744056028649263,-0.013794542311733993,-0.024485995984701144,0.01069145367296715,0.028000000000000025,0.03798571428571429,910484644.5899987,0.042899999999999994,9.559987337765108,-62.022630834512015,37.97736916548799,53.583215464403615,0.3681666666666666,0.362981827369636,0.37842857142857145,0.36747739856359385,0.34082500000000004,0.3682304537076182,104504.0,13342078.666666657,257339.0,14721701.42857143
2022-02-14,0.3355,0.3507,0.321,0.3441,12064596.0,17995.0,6090596.0,0.34190000000000004,0.3700285714285715,0.34225500000000003,0.34667045684240905,0.3556372866920216,0.3631120040554426,54.861398427803074,0.4079165717143383,0.27659342828566175,-0.015119119976670703,-0.021097719367031816,0.005978599390361113,0.029700000000000004,0.03740714285714286,909717852.5899987,0.00720000000000004,7.330006238303177,-66.19926199261992,33.800738007380076,34.08633746874954,2.563338301043218,0.3461,0.366,0.3353,0.3355,12831388.0,21347.0,7290392.0,-3.0626986420109787,55.10288065843623,0.4074056247732545,0.27510437522674547,-0.015017862134305893,-0.022592369214622095,0.007574507080316203,0.030700000000000005,0.03815000000000001,897653256.5899987,0.02100000000000002,7.981976182813022,-69.5190947666195,30.480905233380497,39.53323903818957,0.3483,0.349240913684818,0.3765428571428572,0.35948304892269545,0.341255,0.365113267640226,83608.0,11002180.99999999,265417.0,14975137.142857144
2022-02-15,0.3439,0.3671,0.3419,0.3597,10624976.0,14551.0,5545062.0,0.3464333333333333,0.36615714285714285,0.34442500000000004,0.35318522842120453,0.3566529650190162,0.3627870512882576,56.75782798256045,0.409339255185691,0.2795107448143091,-0.013781710936054237,-0.0196345176808363,0.0058528067447820645,0.0252,0.03793571428571429,920342828.5899987,0.016100000000000003,10.472972972972983,-54.68634686346863,45.313653136531364,36.531765459097336,4.594358825239906,0.3355,0.3507,0.321,0.3441,12064596.0,17995.0,6090596.0,2.563338301043218,54.861398427803074,0.4079165717143383,0.27659342828566175,-0.015119119976670703,-0.021097719367031816,0.005978599390361113,0.029700000000000004,0.03740714285714286,909717852.5899987,0.00720000000000004,7.330006238303177,-66.19926199261992,33.800738007380076,34.08633746874954,0.34190000000000004,0.34667045684240905,0.3700285714285715,0.3556372866920216,0.34225500000000003,0.3631120040554426,69430.0,8620409.99999999,229041.0,12655051.142857144
2022-02-16,0.3597,0.388,0.3539,0.3725,21474657.0,32760.0,11094889.0,0.3587666666666667,0.3594714285714286,0.34736,0.36284261421060227,0.3606147237642622,0.36371209402270926,64.27688504326328,0.4117500417275953,0.28296995827240473,-0.011555744184163386,-0.01801876298150172,0.006463018797338335,0.03410000000000002,0.03822857142857144,941817485.5899987,0.023799999999999988,22.856200527704473,-45.239852398524,54.76014760147601,44.62484624846251,3.558520989713644,0.3439,0.3671,0.3419,0.3597,10624976.0,14551.0,5545062.0,4.594358825239906,56.75782798256045,0.409339255185691,0.2795107448143091,-0.013781710936054237,-0.0196345176808363,0.0058528067447820645,0.0252,0.03793571428571429,920342828.5899987,0.016100000000000003,10.472972972972983,-54.68634686346863,45.313653136531364,36.531765459097336,0.3464333333333333,0.35318522842120453,0.36615714285714285,0.3566529650190162,0.34442500000000004,0.3627870512882576,53893.0,6308683.333333324,186070.0,9712600.0
2022-02-17,0.3723,0.3773,0.3292,0.3339,17048845.0,25997.0,9720634.0,0.3553666666666666,0.3507285714285714,0.348285,0.3483713071053011,0.3539360428231966,0.36087284697292743,53.59259259259258,0.4112578186977056,0.2853121813022944,-0.01275926602602473,-0.016966863590406323,0.004207597564381594,0.04810000000000003,0.04044285714285715,924768640.5899987,-0.055800000000000016,6.168521462639109,-80.37007240547067,19.62992759452934,39.90124277751226,-10.314262691377934,0.3597,0.388,0.3539,0.3725,21474657.0,32760.0,11094889.0,3.558520989713644,64.27688504326328,0.4117500417275953,0.28296995827240473,-0.011555744184163386,-0.01801876298150172,0.006463018797338335,0.03410000000000002,0.03822857142857144,941817485.5899987,0.023799999999999988,22.856200527704473,-45.239852398524,54.76014760147601,44.62484624846251,0.3587666666666667,0.36284261421060227,0.3594714285714286,0.3606147237642622,0.34736,0.36371209402270926,65306.0,7576848.99999999,191157.0,10006739.285714285
2022-02-18,0.3333,0.3479,0.3248,0.3282,9768575.0,16136.0,5331003.0,0.3448666666666666,0.34571428571428575,0.34890000000000004,0.33828565355265056,0.34750203211739744,0.35776114726122005,48.282668772206875,0.4107717519083451,0.287028248091655,-0.014011492357670796,-0.01637578934385922,0.0023642969861884244,0.02310000000000001,0.040092857142857145,915000065.5899987,-0.058599999999999985,-2.582368655387346,-93.61702127659576,6.382978723404241,26.924351306469887,-1.5301530153015281,0.3723,0.3773,0.3292,0.3339,17048845.0,25997.0,9720634.0,-10.314262691377934,53.59259259259258,0.4112578186977056,0.2853121813022944,-0.01275926602602473,-0.016966863590406323,0.004207597564381594,0.04810000000000003,0.04044285714285715,924768640.5899987,-0.055800000000000016,6.168521462639109,-80.37007240547067,19.62992759452934,39.90124277751226,0.3553666666666666,0.3483713071053011,0.3507285714285714,0.3539360428231966,0.348285,0.36087284697292743,73308.0,8786861.666666657,174911.0,9351103.42857143
2022-02-19,0.3274,0.35,0.3176,0.3342,19959154.0,15463.0,13418215.0,0.3320999999999999,0.3440142857142857,0.350075,0.3362428267763253,0.3441765240880481,0.3555172284744372,48.13935075217735,0.4097456354653559,0.29040436453464413,-0.014354273758730496,-0.015971486226833476,0.0016172124681029798,0.032399999999999984,0.04088571428571429,934959219.5899987,-0.08510000000000001,-2.7357392316647355,-85.71428571428571,14.285714285714285,13.432873534549314,2.076970067196082,0.3333,0.3479,0.3248,0.3282,9768575.0,16136.0,5331003.0,-1.5301530153015281,48.282668772206875,0.4107717519083451,0.287028248091655,-0.014011492357670796,-0.01637578934385922,0.0023642969861884244,0.02310000000000001,0.040092857142857145,915000065.5899987,-0.058599999999999985,-2.582368655387346,-93.61702127659576,6.382978723404241,26.924351306469887,0.3448666666666666,0.33828565355265056,0.34571428571428575,0.34750203211739744,0.34890000000000004,0.35776114726122005,74893.0,8715508.666666657,158874.0,8221831.142857143
2022-02-20,0.3343,0.3409,0.2961,0.3062,16156598.0,19596.0,8521165.0,0.32286666666666664,0.3398285714285714,0.34935499999999997,0.3212214133881627,0.3346823930660361,0.35082034957210984,42.28675136116153,0.4108429526068867,0.28786704739311325,-0.01669287145176901,-0.016115763271820585,-0.000577108179948424,0.044800000000000006,0.04275,918802621.5899987,-0.08889999999999998,-12.188127330083166,-92.66521423384165,7.334785766158351,9.334492925092315,-8.405623691295231,0.3274,0.35,0.3176,0.3342,19959154.0,15463.0,13418215.0,2.076970067196082,48.13935075217735,0.4097456354653559,0.29040436453464413,-0.014354273758730496,-0.015971486226833476,0.0016172124681029798,0.032399999999999984,0.04088571428571429,934959219.5899987,-0.08510000000000001,-2.7357392316647355,-85.71428571428571,14.285714285714285,13.432873534549314,0.3320999999999999,0.3362428267763253,0.3440142857142857,0.3441765240880481,0.350075,0.3555172284744372,57596.0,9489950.666666657,144249.0,8355827.285714285
2022-02-21,0.3065,0.3344,0.2746,0.2758,21860930.0,25384.0,11452440.0,0.30539999999999995,0.3300714285714285,0.34686500000000003,0.2985107066940813,0.3199617947995271,0.34367555437476605,28.501321253303132,0.41596551488876177,0.2777644851112383,-0.02075994518333174,-0.017044599654122815,-0.003715345529208925,0.059799999999999964,0.041085714285714295,896941691.5899987,-0.08750000000000002,-29.227610982807285,-99.2462311557789,0.7537688442210922,7.458089632031267,-10.016313213703102,0.3343,0.3409,0.2961,0.3062,16156598.0,19596.0,8521165.0,-8.405623691295231,42.28675136116153,0.4108429526068867,0.28786704739311325,-0.01669287145176901,-0.016115763271820585,-0.000577108179948424,0.044800000000000006,0.04275,918802621.5899987,-0.08889999999999998,-12.188127330083166,-92.66521423384165,7.334785766158351,9.334492925092315,0.32286666666666664,0.3212214133881627,0.3398285714285714,0.3346823930660361,0.34935499999999997,0.35082034957210984,51195.0,9090127.666666657,142498.0,8531652.0
2022-02-22,0.2757,0.2975,0.2597,0.2924,17581461.8,20618.0,9278414.0,0.2914666666666666,0.32045714285714283,0.346325,0.29545535334704065,0.3130713460996453,0.33879216824383596,33.0581478822685,0.4170128348798238,0.27563716512017616,-0.022385601865515248,-0.018112800096401302,-0.004272801769113946,0.0378,0.039650000000000005,914523153.3899987,-0.053700000000000025,-24.40537745604964,-81.21769098219414,18.782309017805858,8.95695454272846,6.057308668842943,0.3065,0.3344,0.2746,0.2758,21860930.0,25384.0,11452440.0,-10.016313213703102,28.501321253303132,0.41596551488876177,0.2777644851112383,-0.02075994518333174,-0.017044599654122815,-0.003715345529208925,0.059799999999999964,0.041085714285714295,896941691.5899987,-0.08750000000000002,-29.227610982807285,-99.2462311557789,0.7537688442210922,7.458089632031267,0.30539999999999995,0.2985107066940813,0.3300714285714285,0.3199617947995271,0.34686500000000003,0.34367555437476605,60443.0,11130606.666666657,149887.0,9297629.714285715
2022-02-23,0.2921,0.3024,0.2713,0.2717,10543825.0,14027.0,5211620.0,0.27996666666666664,0.30605714285714286,0.344185,0.2835776766735203,0.302728509574734,0.3324024379348992,22.33883058470765,0.4212347112259171,0.26713528877408294,-0.02505543998556775,-0.019501328074234592,-0.005554111911333159,0.031100000000000017,0.03790714285714287,903979328.3899987,-0.06380000000000002,-35.20152635344622,-92.9453262786596,7.054673721340393,8.863583861122473,-6.983909619993163,0.2757,0.2975,0.2597,0.2924,17581461.8,20618.0,9278414.0,6.057308668842943,33.0581478822685,0.4170128348798238,0.27563716512017616,-0.022385601865515248,-0.018112800096401302,-0.004272801769113946,0.0378,0.039650000000000005,914523153.3899987,-0.053700000000000025,-24.40537745604964,-81.21769098219414,18.782309017805858,8.95695454272846,0.2914666666666666,0.29545535334704065,0.32045714285714283,0.3130713460996453,0.346325,0.33879216824383596,65598.0,9750672.99999999,155954.0,9830965.714285715
2022-02-24,0.2719,0.2746,0.2255,0.261,27228849.0,32214.0,12724474.0,0.2750333333333333,0.29564285714285715,0.34039,0.27228883833676015,0.2922963821810505,0.3256022057506231,23.529411764705884,0.4259565428958952,0.25482345710410487,-0.027715222672382966,-0.021144106993864268,-0.0065711156785186985,0.049100000000000005,0.037764285714285716,876750479.3899987,-0.08310000000000001,-33.94077448747153,-80.20078081427773,19.799219185722254,15.212067308289527,-4.008826774549455,0.2921,0.3024,0.2713,0.2717,10543825.0,14027.0,5211620.0,-6.983909619993163,22.33883058470765,0.4212347112259171,0.26713528877408294,-0.02505543998556775,-0.019501328074234592,-0.005554111911333159,0.031100000000000017,0.03790714285714287,903979328.3899987,-0.06380000000000002,-35.20152635344622,-92.9453262786596,7.054673721340393,8.863583861122473,0.27996666666666664,0.2835776766735203,0.30605714285714286,0.302728509574734,0.344185,0.3324024379348992,60029.0,8647491.333333323,137221.0,8990498.714285715
2022-02-25,0.2606,0.2863,0.2569,0.2787,22650644.0,26842.0,11735410.0,0.27046666666666663,0.2885714285714286,0.337145,0.2754944191683801,0.28889728663578784,0.3211353290124685,32.31605351170569,0.4270133358556884,0.24727666414431154,-0.028071289191427595,-0.022529543433376934,-0.005541745758050661,0.02939999999999998,0.03595,899401123.3899987,-0.08100000000000002,-23.286540049545835,-67.26153846153846,32.738461538461536,19.864118148508087,6.945510360706065,0.2719,0.2746,0.2255,0.261,27228849.0,32214.0,12724474.0,-4.008826774549455,23.529411764705884,0.4259565428958952,0.25482345710410487,-0.027715222672382966,-0.021144106993864268,-0.0065711156785186985,0.049100000000000005,0.037764285714285716,876750479.3899987,-0.08310000000000001,-33.94077448747153,-80.20078081427773,19.799219185722254,15.212067308289527,0.2750333333333333,0.27228883833676015,0.29564285714285715,0.2922963821810505,0.34039,0.3256022057506231,66859.0,9071502.666666657,143438.0,9419618.714285715
2022-02-26,0.2783,0.2911,0.2724,0.2756,16791322.0,16472.0,9764682.0,0.27176666666666666,0.2802,0.33348999999999995,0.27554720958419004,0.28557296497684087,0.31679863101128103,34.34029320302086,0.4272417415978427,0.23973825840215726,-0.028277651402172865,-0.023679165027136122,-0.004598486375036744,0.01870000000000005,0.035285714285714295,882609801.3899987,-0.09689999999999999,-20.369835307714535,-69.16923076923077,30.830769230769235,27.789483318317696,-0.9701760689902911,0.2606,0.2863,0.2569,0.2787,22650644.0,26842.0,11735410.0,6.945510360706065,32.31605351170569,0.4270133358556884,0.24727666414431154,-0.028071289191427595,-0.022529543433376934,-0.005541745758050661,0.02939999999999998,0.03595,899401123.3899987,-0.08100000000000002,-23.286540049545835,-67.26153846153846,32.738461538461536,19.864118148508087,0.27046666666666663,0.2754944191683801,0.2885714285714286,0.28889728663578784,0.337145,0.3211353290124685,73083.0,9890501.333333323,154144.0,10334534.0
2022-02-27,0.2755,0.285,0.2505,0.2621,23595576.0,22924.0,12853404.0,0.27213333333333334,0.2739,0.32711,0.268823604792095,0.27970472373263067,0.3115892375816352,33.90350877192982,0.422114130658105,0.23210586934189503,-0.02919400183620774,-0.024782132388950447,-0.0044118694472572925,0.034499999999999975,0.03555714285714286,859014225.3899987,-0.07179999999999997,-21.87779433681073,-77.47692307692307,22.523076923076918,28.697435897435923,-4.863883847549917,0.2783,0.2911,0.2724,0.2756,16791322.0,16472.0,9764682.0,-0.9701760689902911,34.34029320302086,0.4272417415978427,0.23973825840215726,-0.028277651402172865,-0.023679165027136122,-0.004598486375036744,0.01870000000000005,0.035285714285714295,882609801.3899987,-0.09689999999999999,-20.369835307714535,-69.16923076923077,30.830769230769235,27.789483318317696,0.27176666666666666,0.27554720958419004,0.2802,0.28557296497684087,0.33348999999999995,0.31679863101128103,75528.0,11408188.666666657,155153.0,9812600.714285715
2022-02-28,0.2621,0.284,0.2593,0.2836,17234055.0,20227.0,9184264.0,0.27376666666666666,0.2750142857142857,0.32195,0.2762118023960475,0.280678542799473,0.30892359590719376,37.44292237442922,0.41448186080023924,0.22941813919976078,-0.027864145317731237,-0.025398534974706607,-0.0024656103430246296,0.0247,0.0352,876248280.3899987,-0.04459999999999997,-17.582098227259515,-64.24615384615385,35.753846153846155,29.70256410256413,8.202975963372767,0.2755,0.285,0.2505,0.2621,23595576.0,22924.0,12853404.0,-4.863883847549917,33.90350877192982,0.422114130658105,0.23210586934189503,-0.02919400183620774,-0.024782132388950447,-0.0044118694472572925,0.034499999999999975,0.03555714285714286,859014225.3899987,-0.07179999999999997,-21.87779433681073,-77.47692307692307,22.523076923076918,28.697435897435923,0.27213333333333334,0.268823604792095,0.2739,0.27970472373263067,0.32711,0.3115892375816352,66238.0,11451165.333333323,158481.0,10431492.0
2022-03-01,0.2838,0.409,0.2805,0.3657,87248463.0,125954.0,45339678.0,0.30379999999999996,0.2854857142857143,0.31927000000000005,0.32095590119802375,0.30193390709960477,0.314330872487461,50.975927130774245,0.4025748706480068,0.23596512935199332,-0.019955407073138753,-0.024309909394393037,0.004354502321254283,0.12849999999999995,0.042578571428571424,963496743.3899987,0.03150000000000003,1.6680567139282676,-23.596730245231583,76.40326975476842,44.89339761056385,28.858350951374216,0.2621,0.284,0.2593,0.2836,17234055.0,20227.0,9184264.0,8.202975963372767,37.44292237442922,0.41448186080023924,0.22941813919976078,-0.027864145317731237,-0.025398534974706607,-0.0024656103430246296,0.0247,0.0352,876248280.3899987,-0.04459999999999997,-17.582098227259515,-64.24615384615385,35.753846153846155,29.70256410256413,0.27376666666666666,0.2762118023960475,0.2750142857142857,0.280678542799473,0.32195,0.30892359590719376,59623.0,10600783.333333323,153324.0,10107466.857142856
2022-03-02,0.3658,0.43,0.3331,0.34,139306396.0,211206.0,70189855.0,0.3297666666666667,0.29524285714285714,0.316515,0.33047795059901186,0.3114504303247036,0.316775551298179,44.92663128317203,0.3925915895245121,0.2404384104754879,-0.015581832584376676,-0.022564294032389767,0.006982461448013091,0.09689999999999999,0.04706428571428571,824190347.3899987,0.0338,-8.724832214765089,-44.00977995110023,55.990220048899765,56.049111985838145,-7.053034445051938,0.2838,0.409,0.2805,0.3657,87248463.0,125954.0,45339678.0,28.858350951374216,50.975927130774245,0.4025748706480068,0.23596512935199332,-0.019955407073138753,-0.024309909394393037,0.004354502321254283,0.12849999999999995,0.042578571428571424,963496743.3899987,0.03150000000000003,1.6680567139282676,-23.596730245231583,76.40326975476842,44.89339761056385,0.30379999999999996,0.32095590119802375,0.2854857142857143,0.30193390709960477,0.31927000000000005,0.314330872487461,169105.0,22459115.333333325,258660.0,15259076.0
2022-03-03,0.3402,0.3513,0.3135,0.3212,22143545.0,34791.0,10896020.0,0.3423,0.30384285714285714,0.31441,0.3258389752995059,0.31388782274352767,0.3171969273650191,47.88685524126456,0.38729898263434986,0.24152101736565018,-0.013477387243216898,-0.020746912674555196,0.007269525431338297,0.0378,0.04632857142857143,802046802.3899987,0.045399999999999996,-3.803533992213237,-53.202933985330084,46.797066014669916,59.73018527277939,-5.584950029394479,0.3658,0.43,0.3331,0.34,139306396.0,211206.0,70189855.0,-7.053034445051938,44.92663128317203,0.3925915895245121,0.2404384104754879,-0.015581832584376676,-0.022564294032389767,0.006982461448013091,0.09689999999999999,0.04706428571428571,824190347.3899987,0.0338,-8.724832214765089,-44.00977995110023,55.990220048899765,56.049111985838145,0.3297666666666667,0.33047795059901186,0.29524285714285714,0.3114504303247036,0.316515,0.316775551298179,357387.0,41571265.66666666,455839.0,24541681.0
2022-03-04,0.3212,0.3648,0.3077,0.3092,67123523.0,85424.0,35519825.0,0.3234666666666666,0.3082,0.312565,0.3175194876497529,0.31271586705764576,0.3164353152350173,46.90352020860495,0.3839285990064594,0.24120140099354054,-0.012632281779422605,-0.019123986495528676,0.006491704716106071,0.05710000000000004,0.04875714285714285,734923279.3899987,0.01679999999999998,-5.789152955514931,-59.07090464547679,40.92909535452321,47.905460472697655,-3.735990037359904,0.3402,0.3513,0.3135,0.3212,22143545.0,34791.0,10896020.0,-5.584950029394479,47.88685524126456,0.38729898263434986,0.24152101736565018,-0.013477387243216898,-0.020746912674555196,0.007269525431338297,0.0378,0.04632857142857143,802046802.3899987,0.045399999999999996,-3.803533992213237,-53.202933985330084,46.797066014669916,59.73018527277939,0.3423,0.3258389752995059,0.30384285714285714,0.31388782274352767,0.31441,0.3171969273650191,371951.0,42141850.99999999,458416.0,24280473.285714287
2022-03-05,0.3093,0.3581,0.3013,0.343,41220617.0,48801.0,22740266.0,0.3244666666666666,0.31782857142857146,0.31294,0.33025974382487644,0.3202869002932343,0.3189652852126347,51.31500298864315,0.3848874779192726,0.24099252208072738,-0.009129908190644465,-0.017125170834551836,0.007995262643907371,0.05679999999999996,0.050499999999999996,776143896.3899987,0.07130000000000003,2.633153800119703,-42.54278728606356,57.45721271393644,48.39445802770988,10.895570643388298,0.3212,0.3648,0.3077,0.3092,67123523.0,85424.0,35519825.0,-3.735990037359904,46.90352020860495,0.3839285990064594,0.24120140099354054,-0.012632281779422605,-0.019123986495528676,0.006491704716106071,0.05710000000000004,0.04875714285714285,734923279.3899987,0.01679999999999998,-5.789152955514931,-59.07090464547679,40.92909535452321,47.905460472697655,0.3234666666666666,0.3175194876497529,0.3082,0.31271586705764576,0.312565,0.3164353152350173,331421.0,38868566.66666666,516998.0,27678246.85714286
2022-03-06,0.343,0.374,0.3134,0.3154,50438305.0,58554.0,25809750.0,0.3225333333333333,0.3254428571428572,0.31150500000000003,0.3228298719124382,0.3190651752199257,0.31862573424000284,51.37642130460802,0.38196515596735653,0.24104484403264353,-0.008483548163075949,-0.01539684630025666,0.006913298137180711,0.06059999999999999,0.05162857142857142,725705591.3899987,0.054400000000000004,3.0045721750489918,-56.03911980440097,43.96088019559903,47.44906275468626,-8.046647230320703,0.3093,0.3581,0.3013,0.343,41220617.0,48801.0,22740266.0,10.895570643388298,51.31500298864315,0.3848874779192726,0.24099252208072738,-0.009129908190644465,-0.017125170834551836,0.007995262643907371,0.05679999999999996,0.050499999999999996,776143896.3899987,0.07130000000000003,2.633153800119703,-42.54278728606356,57.45721271393644,48.39445802770988,0.3244666666666666,0.33025974382487644,0.31782857142857146,0.3202869002932343,0.31294,0.3189652852126347,169016.0,23052036.99999999,549327.0,29531901.714285713
2022-03-07,0.3157,0.3401,0.3052,0.324,54063605.0,60888.0,29306671.0,0.32746666666666663,0.33121428571428574,0.30972,0.3234149359562191,0.3202988814149443,0.3191375690742883,57.714468629961594,0.376765392321738,0.24267460767826202,-0.00719442223648431,-0.013756361487502191,0.006561939251017881,0.03489999999999999,0.04985,779769196.3899987,0.04530000000000001,17.476432197244396,-51.83374083129584,48.16625916870416,49.861450692746565,2.629078238834346,0.343,0.374,0.3134,0.3154,50438305.0,58554.0,25809750.0,-8.046647230320703,51.37642130460802,0.38196515596735653,0.24104484403264353,-0.008483548163075949,-0.01539684630025666,0.006913298137180711,0.06059999999999999,0.05162857142857142,725705591.3899987,0.054400000000000004,3.0045721750489918,-56.03911980440097,43.96088019559903,47.44906275468626,0.3225333333333333,0.3228298719124382,0.3254428571428572,0.3190651752199257,0.31150500000000003,0.31862573424000284,192779.0,28023280.333333325,584957.0,31382808.285714287
2022-03-08,0.3239,0.3348,0.3147,0.3201,17813814.0,21652.0,9448178.0,0.3198333333333333,0.3247,0.30710000000000004,0.32175746797810956,0.3202491610612082,0.31922922916245133,54.62128795462129,0.3675905908298486,0.24660940917015153,-0.0064135466844654765,-0.012287798526894848,0.0058742518424293715,0.020100000000000007,0.04858571428571428,761955382.3899987,0.044499999999999984,9.473324213406297,-53.74083129584353,46.25916870415648,46.12876935615325,-1.1732016054337835,0.3157,0.3401,0.3052,0.324,54063605.0,60888.0,29306671.0,2.629078238834346,57.714468629961594,0.376765392321738,0.24267460767826202,-0.00719442223648431,-0.013756361487502191,0.006561939251017881,0.03489999999999999,0.04985,779769196.3899987,0.04530000000000001,17.476432197244396,-51.83374083129584,48.16625916870416,49.861450692746565,0.32746666666666663,0.3234149359562191,0.33121428571428574,0.3202988814149443,0.30972,0.3191375690742883,168243.0,25952228.99999999,625618.0,34257437.85714286
2022-03-09,0.3202,0.3734,0.3177,0.3564,37588865.0,45909.0,20459662.0,0.33349999999999996,0.32704285714285714,0.308225,0.33907873398905475,0.3292868707959062,0.32276930257555125,63.43165239454488,0.3715831590309115,0.24486684096908856,-0.002832934252718855,-0.010396825672059651,0.007563891419340796,0.05570000000000003,0.05034285714285714,799544247.3899987,0.0943,31.174089068825907,-35.99022004889976,64.00977995110024,52.81173594132033,11.3054341036852,0.3239,0.3348,0.3147,0.3201,17813814.0,21652.0,9448178.0,-1.1732016054337835,54.62128795462129,0.3675905908298486,0.24660940917015153,-0.0064135466844654765,-0.012287798526894848,0.0058742518424293715,0.020100000000000007,0.04858571428571428,761955382.3899987,0.044499999999999984,9.473324213406297,-53.74083129584353,46.25916870415648,46.12876935615325,0.3198333333333333,0.32175746797810956,0.3247,0.3202491610612082,0.30710000000000004,0.31922922916245133,141094.0,21521532.99999999,521316.0,29130080.714285713
2022-03-10,0.356,0.3603,0.3185,0.3571,22876216.0,32790.0,11536368.0,0.3445333333333333,0.3321714285714285,0.30967,0.34808936699452736,0.3362401530969296,0.32603889280645115,65.73861775302979,0.3761858817600173,0.2431541182399827,6.0513484435531506e-05,-0.008305357840760615,0.008365871325196146,0.041800000000000004,0.049821428571428565,822420463.3899987,0.07349999999999995,36.8199233716475,-40.612813370473546,59.38718662952645,56.552045094927756,0.308988764044941,0.3202,0.3734,0.3177,0.3564,37588865.0,45909.0,20459662.0,11.3054341036852,63.43165239454488,0.3715831590309115,0.24486684096908856,-0.002832934252718855,-0.010396825672059651,0.007563891419340796,0.05570000000000003,0.05034285714285714,799544247.3899987,0.0943,31.174089068825907,-35.99022004889976,64.00977995110024,52.81173594132033,0.33349999999999996,0.33907873398905475,0.32704285714285714,0.3292868707959062,0.308225,0.32276930257555125,128449.0,19738170.333333325,356019.0,22025767.42857143
2022-03-11,0.3566,0.37,0.3362,0.3396,20317335.0,29237.0,10080038.0,0.3510333333333333,0.33651428571428577,0.30994,0.3438446834972637,0.3370801148226972,0.32733042682488434,59.9803343166175,0.3769173693123044,0.24296263068769558,0.0009307587088791536,-0.006458134530832662,0.007388893239711815,0.0338,0.05013571428571428,802103128.3899987,-0.026100000000000012,21.851453175457493,-50.36211699164345,49.63788300835655,57.678283196327776,-4.767246214245643,0.356,0.3603,0.3185,0.3571,22876216.0,32790.0,11536368.0,0.308988764044941,65.73861775302979,0.3761858817600173,0.2431541182399827,6.0513484435531506e-05,-0.008305357840760615,0.008365871325196146,0.041800000000000004,0.049821428571428565,822420463.3899987,0.07349999999999995,36.8199233716475,-40.612813370473546,59.38718662952645,56.552045094927756,0.3445333333333333,0.34808936699452736,0.3321714285714285,0.3362401530969296,0.30967,0.32603889280645115,100351.0,13814735.99999999,354018.0,22117245.714285713
2022-03-12,0.3396,0.356,0.3323,0.3371,12845302.0,18149.0,7057352.0,0.34459999999999996,0.33567142857142857,0.311485,0.34047234174863183,0.33708508611702287,0.32826086236537155,60.09852216748768,0.3795163944556172,0.24345360554438283,0.001402537631632672,-0.004886000098339595,0.006288537729972267,0.0237,0.05049285714285713,789257826.3899987,-0.0029000000000000137,22.314949201741662,-51.75487465181058,48.24512534818942,52.42339832869084,-0.7361601884570089,0.3566,0.37,0.3362,0.3396,20317335.0,29237.0,10080038.0,-4.767246214245643,59.9803343166175,0.3769173693123044,0.24296263068769558,0.0009307587088791536,-0.006458134530832662,0.007388893239711815,0.0338,0.05013571428571428,802103128.3899987,-0.026100000000000012,21.851453175457493,-50.36211699164345,49.63788300835655,57.678283196327776,0.3510333333333333,0.3438446834972637,0.33651428571428577,0.3370801148226972,0.30994,0.32733042682488434,107936.0,14025355.99999999,297831.0,18482990.42857143
2022-03-13,0.3372,0.3454,0.3139,0.3153,14133368.0,19204.0,6619853.0,0.3306666666666666,0.3356571428571428,0.31345999999999996,0.32788617087431593,0.3316388145877671,0.3270264945210504,58.50383631713556,0.37939043862161814,0.24752956137838178,1.715031889953922e-05,-0.0039053700148917684,0.003922520333791308,0.03149999999999997,0.050278571428571416,775124458.3899987,-0.005899999999999961,20.29759633727586,-67.19390743995311,32.80609256004689,43.56303363886432,-6.494661921708178,0.3396,0.356,0.3323,0.3371,12845302.0,18149.0,7057352.0,-0.7361601884570089,60.09852216748768,0.3795163944556172,0.24345360554438283,0.001402537631632672,-0.004886000098339595,0.006288537729972267,0.0237,0.05049285714285713,789257826.3899987,-0.0029000000000000137,22.314949201741662,-51.75487465181058,48.24512534818942,52.42339832869084,0.34459999999999996,0.34047234174863183,0.33567142857142857,0.33708508611702287,0.311485,0.32826086236537155,80176.0,9557919.333333323,267179.0,16242574.142857144
2022-03-14,0.3153,0.339,0.3119,0.3244,14297569.0,22354.0,6829024.0,0.32559999999999995,0.33571428571428574,0.31506,0.326143085437158,0.32982911094082534,0.32677635218571227,56.790945406125175,0.38038891356333193,0.24973108643666808,-0.00034253661066507846,-0.003192803334046431,0.0028502667233813524,0.027100000000000013,0.050449999999999995,789422027.3899987,0.015200000000000047,14.386459802538788,-70.63545150501672,29.36454849498328,36.80525546773989,2.886140183951791,0.3372,0.3454,0.3139,0.3153,14133368.0,19204.0,6619853.0,-6.494661921708178,58.50383631713556,0.37939043862161814,0.24752956137838178,1.715031889953922e-05,-0.0039053700148917684,0.003922520333791308,0.03149999999999997,0.050278571428571416,775124458.3899987,-0.005899999999999961,20.29759633727586,-67.19390743995311,32.80609256004689,43.56303363886432,0.3306666666666666,0.32788617087431593,0.3356571428571428,0.3316388145877671,0.31345999999999996,0.3270264945210504,66590.0,7919080.99999999,227829.0,13501160.285714285
2022-03-15,0.3243,0.3349,0.3152,0.3267,21104916.0,27424.0,10806510.0,0.3221333333333333,0.3366571428571429,0.31781000000000004,0.326421542718579,0.329046833205619,0.32676908054897774,41.160471441523114,0.3800092012133264,0.2556107987866737,-0.00043696327501724364,-0.0026416353222405934,0.0022046720472233498,0.019699999999999995,0.042678571428571434,810526943.3899987,-0.016300000000000037,-10.664479081214118,-80.26418026418027,19.73581973581972,27.302153596949992,0.7400555041628163,0.3153,0.339,0.3119,0.3244,14297569.0,22354.0,6829024.0,2.886140183951791,56.790945406125175,0.38038891356333193,0.24973108643666808,-0.00034253661066507846,-0.003192803334046431,0.0028502667233813524,0.027100000000000013,0.050449999999999995,789422027.3899987,0.015200000000000047,14.386459802538788,-70.63545150501672,29.36454849498328,36.80525546773989,0.32559999999999995,0.326143085437158,0.33571428571428574,0.32982911094082534,0.31506,0.32677635218571227,59707.0,6835409.666666657,189295.0,10290067.857142856
2022-03-16,0.3267,0.336,0.315,0.3296,15399349.0,18162.0,8194033.0,0.32689999999999997,0.3328285714285714,0.32124,0.32801077135928947,0.32918512490421425,0.3270386919252656,47.37108190091,0.3775340550287142,0.2649459449712859,-0.0002746256100508715,-0.0021682333798026493,0.0018936077697517778,0.02100000000000002,0.037257142857142864,825926292.3899987,0.01419999999999999,-3.0588235294117694,-61.0729023383769,38.92709766162311,29.34248863080873,0.8876645240281646,0.3243,0.3349,0.3152,0.3267,21104916.0,27424.0,10806510.0,0.7400555041628163,41.160471441523114,0.3800092012133264,0.2556107987866737,-0.00043696327501724364,-0.0026416353222405934,0.0022046720472233498,0.019699999999999995,0.042678571428571434,810526943.3899987,-0.016300000000000037,-10.664479081214118,-80.26418026418027,19.73581973581972,27.302153596949992,0.3221333333333333,0.326421542718579,0.3366571428571429,0.329046833205619,0.31781000000000004,0.32676908054897774,68982.0,8085128.99999999,195067.0,10484115.285714285
2022-03-17,0.3296,0.3416,0.3231,0.3294,12164158.0,15875.0,6296507.0,0.3285666666666666,0.3288714285714286,0.32377500000000003,0.32870538567964475,0.3292388436781607,0.3272635784085736,52.287946428571445,0.3764532837509381,0.27109671624906195,-0.0001602627601763329,-0.001766639255877386,0.0016063764957010532,0.018500000000000016,0.035878571428571426,813762134.3899987,0.005400000000000016,2.5529265255292755,-61.34800550206325,38.651994497936755,32.43830396512656,-0.060679611650478756,0.3267,0.336,0.315,0.3296,15399349.0,18162.0,8194033.0,0.8876645240281646,47.37108190091,0.3775340550287142,0.2649459449712859,-0.0002746256100508715,-0.0021682333798026493,0.0018936077697517778,0.02100000000000002,0.037257142857142864,825926292.3899987,0.01419999999999999,-3.0588235294117694,-61.0729023383769,38.92709766162311,29.34248863080873,0.32689999999999997,0.32801077135928947,0.3328285714285714,0.32918512490421425,0.32124,0.3270386919252656,67940.0,8609855.666666657,167320.0,8731882.57142857
2022-03-18,0.3292,0.3379,0.3186,0.3307,9287148.0,11196.0,5010439.0,0.32989999999999997,0.3276,0.32653000000000004,0.32970269283982234,0.32960413275862055,0.32759085665537613,56.37982195845697,0.3741172207524708,0.2789427792475293,3.486782317468906e-05,-0.0014063378400669712,0.0014412056632416603,0.019299999999999984,0.033178571428571425,823049282.3899987,0.010599999999999998,6.953428201811129,-59.55983493810181,40.44016506189819,39.33975240715271,0.45565006075334186,0.3296,0.3416,0.3231,0.3294,12164158.0,15875.0,6296507.0,-0.060679611650478756,52.287946428571445,0.3764532837509381,0.27109671624906195,-0.0001602627601763329,-0.001766639255877386,0.0016063764957010532,0.018500000000000016,0.035878571428571426,813762134.3899987,0.005400000000000016,2.5529265255292755,-61.34800550206325,38.651994497936755,32.43830396512656,0.3285666666666666,0.32870538567964475,0.3288714285714286,0.3292388436781607,0.32377500000000003,0.3272635784085736,61461.0,8432349.99999999,150405.0,7983331.0
2022-03-19,0.3309,0.3487,0.3299,0.3435,19586347.0,20783.0,11158380.0,0.33453333333333335,0.32851428571428576,0.3306,0.3366013464199112,0.3330780995689654,0.3291060131643879,50.16949152542374,0.367768294355004,0.293431705644996,0.0012084331768181245,-0.0008833836366899522,0.0020918168135080767,0.018799999999999983,0.030464285714285715,842635629.3899987,-0.012899999999999967,0.1457725947521915,-44.33139534883719,55.66860465116281,44.92025473699928,3.8077969174977335,0.3292,0.3379,0.3186,0.3307,9287148.0,11196.0,5010439.0,0.45565006075334186,56.37982195845697,0.3741172207524708,0.2789427792475293,3.486782317468906e-05,-0.0014063378400669712,0.0014412056632416603,0.019299999999999984,0.033178571428571425,823049282.3899987,0.010599999999999998,6.953428201811129,-59.55983493810181,40.44016506189819,39.33975240715271,0.32989999999999997,0.32970269283982234,0.3276,0.32960413275862055,0.32653000000000004,0.32759085665537613,45233.0,6500326.333333324,132364.0,7259102.571428572
2022-03-20,0.3433,0.3469,0.322,0.3275,9084927.0,11340.0,4563374.0,0.33390000000000003,0.33025714285714286,0.33279500000000006,0.3320506732099556,0.33168357467672405,0.32895305952968434,54.45180279617366,0.36276442125773223,0.3028255787422679,0.000837768617116319,-0.0005391531859286981,0.0013769218030450171,0.024899999999999978,0.027914285714285707,833550702.3899987,-0.02959999999999996,3.8363982244768557,-67.30205278592376,32.69794721407624,42.935572309045774,-4.602388581415666,0.3309,0.3487,0.3299,0.3435,19586347.0,20783.0,11158380.0,3.8077969174977335,50.16949152542374,0.367768294355004,0.293431705644996,0.0012084331768181245,-0.0008833836366899522,0.0020918168135080767,0.018799999999999983,0.030464285714285715,842635629.3899987,-0.012899999999999967,0.1457725947521915,-44.33139534883719,55.66860465116281,44.92025473699928,0.33453333333333335,0.3366013464199112,0.32851428571428576,0.3330780995689654,0.3306,0.3291060131643879,47854.0,7488441.99999999,134998.0,7844963.714285715
2022-03-21,0.3274,0.345,0.3221,0.3401,14381772.0,15793.0,9427802.0,0.3370333333333333,0.3325,0.331515,0.3360753366049778,0.333787681007543,0.33001467290780967,55.75411007862759,0.3574872341619949,0.3055427658380051,0.0015429428952175583,-0.0001227339696994468,0.0016656768649170053,0.022899999999999976,0.02705714285714286,847932474.3899987,0.0005000000000000004,4.969135802469138,-54.14634146341463,45.85365853658537,44.740070133941494,3.8790470372632826,0.3433,0.3469,0.322,0.3275,9084927.0,11340.0,4563374.0,-4.602388581415666,54.45180279617366,0.36276442125773223,0.3028255787422679,0.000837768617116319,-0.0005391531859286981,0.0013769218030450171,0.024899999999999978,0.027914285714285707,833550702.3899987,-0.02959999999999996,3.8363982244768557,-67.30205278592376,32.69794721407624,42.935572309045774,0.33390000000000003,0.3320506732099556,0.33025714285714286,0.33168357467672405,0.33279500000000006,0.32895305952968434,43319.0,6910730.99999999,127134.0,7551181.0
2022-03-22,0.3401,0.425,0.339,0.3754,80073201.0,123113.0,42412199.0,0.3476666666666666,0.33945714285714285,0.333285,0.3557376683024889,0.34419076075565724,0.3343370850118278,66.14127262113253,0.365714309355277,0.300855690644723,0.004893800886377031,0.0008805730015158489,0.004013227884861182,0.08599999999999997,0.03176428571428571,928005675.3899987,0.0383,17.275851296469867,-43.8549955791335,56.145004420866506,44.89887005717606,10.379300205821815,0.3274,0.345,0.3221,0.3401,14381772.0,15793.0,9427802.0,3.8790470372632826,55.75411007862759,0.3574872341619949,0.3055427658380051,0.0015429428952175583,-0.0001227339696994468,0.0016656768649170053,0.022899999999999976,0.02705714285714286,847932474.3899987,0.0005000000000000004,4.969135802469138,-54.14634146341463,45.85365853658537,44.740070133941494,0.3370333333333333,0.3360753366049778,0.3325,0.333787681007543,0.331515,0.33001467290780967,47916.0,8383185.333333324,120573.0,7922435.0
2022-03-23,0.3751,0.46,0.3583,0.3988,86164178.0,131530.0,44848449.0,0.3714333333333333,0.3493428571428572,0.337165,0.37726883415124446,0.3578430705667429,0.3404764102487966,63.383838383838395,0.38030605505868037,0.2940239449413196,0.009330013832312467,0.002570461167675173,0.006759552664637294,0.10170000000000001,0.03504999999999999,1014169853.3899987,0.08349999999999996,11.896745230078555,-41.32343011478732,58.67656988521267,53.558410947554876,6.318315115969075,0.3401,0.425,0.339,0.3754,80073201.0,123113.0,42412199.0,10.379300205821815,66.14127262113253,0.365714309355277,0.300855690644723,0.004893800886377031,0.0008805730015158489,0.004013227884861182,0.08599999999999997,0.03176428571428571,928005675.3899987,0.0383,17.275851296469867,-43.8549955791335,56.145004420866506,44.89887005717606,0.3476666666666666,0.3557376683024889,0.33945714285714285,0.34419076075565724,0.333285,0.3343370850118278,150246.0,18801124.99999999,216262.0,12437533.42857143
2022-03-24,0.3985,0.4543,0.3958,0.4401,73003823.0,122532.0,38131136.0,0.40476666666666655,0.36515714285714285,0.34371,0.4086844170756222,0.37840730292505714,0.3499643711774827,70.85427135678394,0.40492110666328945,0.2824988933367106,0.015993941196423556,0.005255157173424849,0.010738784022998707,0.058499999999999996,0.03624285714285714,1087173676.3899987,0.11569999999999997,23.242789134696174,-13.436866981769095,86.56313301823091,67.12823577477006,10.439146800501874,0.3751,0.46,0.3583,0.3988,86164178.0,131530.0,44848449.0,6.318315115969075,63.383838383838395,0.38030605505868037,0.2940239449413196,0.009330013832312467,0.002570461167675173,0.006759552664637294,0.10170000000000001,0.03504999999999999,1014169853.3899987,0.08349999999999996,11.896745230078555,-41.32343011478732,58.67656988521267,53.558410947554876,0.3714333333333333,0.37726883415124446,0.3493428571428572,0.3578430705667429,0.337165,0.3404764102487966,270436.0,32229483.333333325,329630.0,17673878.57142857
2022-03-25,0.4401,0.4452,0.4021,0.4051,21467645.0,35477.0,10371540.0,0.4146666666666666,0.3757857142857142,0.346815,0.4068922085378111,0.38508047719379285,0.3552153834462939,65.1270207852194,0.4138934387666088,0.2797365612333912,0.01824067698088183,0.007852261134916246,0.010388415845965586,0.04309999999999997,0.03690714285714285,1065706031.3899987,0.07840000000000003,19.287396937573618,-37.069547602970964,62.930452397029036,69.39005176682424,-7.952738014087702,0.3985,0.4543,0.3958,0.4401,73003823.0,122532.0,38131136.0,10.439146800501874,70.85427135678394,0.40492110666328945,0.2824988933367106,0.015993941196423556,0.005255157173424849,0.010738784022998707,0.058499999999999996,0.03624285714285714,1087173676.3899987,0.11569999999999997,23.242789134696174,-13.436866981769095,86.56313301823091,67.12823577477006,0.40476666666666655,0.4086844170756222,0.36515714285714285,0.37840730292505714,0.34371,0.3499643711774827,377175.0,41797261.33333332,436287.0,22221682.714285713
2022-03-26,0.4052,0.4342,0.3979,0.4319,14680963.0,25894.0,8069448.0,0.42569999999999997,0.3884142857142857,0.35264,0.41939610426890556,0.39678535789534464,0.3625186802609326,69.68438538205982,0.42795917767948033,0.2773208223205197,0.021930960835019997,0.010668001074936997,0.011262959760083,0.0363,0.03780714285714285,1080386994.3899987,0.1023,28.122218926134668,-18.973666441593526,81.02633355840648,76.83997299122217,6.5893385982231,0.4401,0.4452,0.4021,0.4051,21467645.0,35477.0,10371540.0,-7.952738014087702,65.1270207852194,0.4138934387666088,0.2797365612333912,0.01824067698088183,0.007852261134916246,0.010388415845965586,0.04309999999999997,0.03690714285714285,1065706031.3899987,0.07840000000000003,19.287396937573618,-37.069547602970964,62.930452397029036,69.39005176682424,0.4146666666666666,0.4068922085378111,0.3757857142857142,0.38508047719379285,0.346815,0.3552153834462939,289539.0,31117041.666666657,460568.0,22987554.285714287
2022-03-27,0.4319,0.4484,0.4148,0.4448,13609297.0,23213.0,6863863.0,0.42726666666666663,0.40517142857142857,0.35868,0.43209805213445274,0.4087890184215085,0.37035499642655806,77.92151789564467,0.44314766058207095,0.27421233941792905,0.025601343218347394,0.013654669503619078,0.011946673714728316,0.03360000000000002,0.037957142857142856,1093996291.3899987,0.11539999999999995,41.07199492546778,-10.263335584064851,89.73666441593515,77.8978167904569,2.98680250057883,0.4052,0.4342,0.3979,0.4319,14680963.0,25894.0,8069448.0,6.5893385982231,69.68438538205982,0.42795917767948033,0.2773208223205197,0.021930960835019997,0.010668001074936997,0.011262959760083,0.0363,0.03780714285714285,1080386994.3899987,0.1023,28.122218926134668,-18.973666441593526,81.02633355840648,76.83997299122217,0.42569999999999997,0.41939610426890556,0.3884142857142857,0.39678535789534464,0.35264,0.3625186802609326,183903.0,18857374.666666657,465679.0,22546278.285714287
2022-03-28,0.445,0.465,0.4276,0.4297,21739903.0,40409.0,10714695.0,0.43546666666666667,0.41797142857142855,0.36416,0.4308990260672264,0.4140167638161314,0.3760069015287906,72.13114754098362,0.45223299365028874,0.27608700634971123,0.02698068732815262,0.016319873068525788,0.010660814259626832,0.037400000000000044,0.03869285714285714,1072256388.3899987,0.09900000000000003,32.45992601726264,-23.533333333333328,76.46666666666667,82.40988821366945,-3.4382022471910063,0.4319,0.4484,0.4148,0.4448,13609297.0,23213.0,6863863.0,2.98680250057883,77.92151789564467,0.44314766058207095,0.27421233941792905,0.025601343218347394,0.013654669503619078,0.011946673714728316,0.03360000000000002,0.037957142857142856,1093996291.3899987,0.11539999999999995,41.07199492546778,-10.263335584064851,89.73666441593515,77.8978167904569,0.42726666666666663,0.43209805213445274,0.40517142857142857,0.4087890184215085,0.35868,0.37035499642655806,84584.0,8434950.333333323,477552.0,22874919.57142857
2022-03-29,0.43,0.496,0.4293,0.4706,27954406.0,49860.0,14264791.0,0.44836666666666664,0.43157142857142855,0.36987000000000003,0.4507495130336132,0.4281625728620986,0.38501576804985815,76.02169981916819,0.46983022577425315,0.2699097742257469,0.031016575877679253,0.01925921363035648,0.011757362247322774,0.06669999999999998,0.04204999999999999,1100210794.3899987,0.1271,44.0465258647077,-14.033149171270706,85.96685082872929,84.05672730377707,9.441860465116285,0.445,0.465,0.4276,0.4297,21739903.0,40409.0,10714695.0,-3.4382022471910063,72.13114754098362,0.45223299365028874,0.27608700634971123,0.02698068732815262,0.016319873068525788,0.010660814259626832,0.037400000000000044,0.03869285714285714,1072256388.3899987,0.09900000000000003,32.45992601726264,-23.533333333333328,76.46666666666667,82.40988821366945,0.43546666666666667,0.4308990260672264,0.41797142857142855,0.4140167638161314,0.36416,0.3760069015287906,89516.0,8549335.333333323,502168.0,23058761.42857143
2022-03-30,0.4706,0.48,0.4502,0.4706,18331681.0,34374.0,9214235.0,0.4569666666666666,0.4418285714285714,0.375545,0.4606747565168066,0.43877192964657397,0.39316664728320505,75.76754385964914,0.48489867007052107,0.26619132992947897,0.03382513156887329,0.022172397218059844,0.011652734350813446,0.029799999999999993,0.04267857142857142,1081879113.3899987,0.1431,42.779126213592235,-14.317925591882737,85.68207440811726,82.70519730117111,0.0,0.43,0.496,0.4293,0.4706,27954406.0,49860.0,14264791.0,9.441860465116285,76.02169981916819,0.46983022577425315,0.2699097742257469,0.031016575877679253,0.01925921363035648,0.011757362247322774,0.06669999999999998,0.04204999999999999,1100210794.3899987,0.1271,44.0465258647077,-14.033149171270706,85.96685082872929,84.05672730377707,0.44836666666666664,0.4507495130336132,0.43157142857142855,0.4281625728620986,0.36987000000000003,0.38501576804985815,113482.0,10614449.666666657,428915.0,19037703.14285714
2022-03-31,0.4706,0.4835,0.4403,0.456,16289448.0,30165.0,8073376.0,0.46573333333333333,0.44410000000000005,0.38136500000000007,0.4583373782584033,0.44307894723493046,0.399150776113376,71.97916666666667,0.49497104644767553,0.2677589535523246,0.03447542298996403,0.024633002372440684,0.00984242061752335,0.04319999999999996,0.04444285714285713,1065589665.3899987,0.1159,38.4335154826958,-22.54791431792558,77.45208568207443,83.03367030630703,-3.1024224394390143,0.4706,0.48,0.4502,0.4706,18331681.0,34374.0,9214235.0,0.0,75.76754385964914,0.48489867007052107,0.26619132992947897,0.03382513156887329,0.022172397218059844,0.011652734350813446,0.029799999999999993,0.04267857142857142,1081879113.3899987,0.1431,42.779126213592235,-14.317925591882737,85.68207440811726,82.70519730117111,0.4569666666666666,0.4606747565168066,0.4418285714285714,0.43877192964657397,0.375545,0.39316664728320505,124643.0,11397906.99999999,331759.0,13947101.142857144
2022-04-01,0.4559,0.4901,0.4291,0.477,34631444.0,43755.0,22269940.0,0.46786666666666665,0.45437142857142854,0.38836,0.4676686891292017,0.45155921042619784,0.4065649879121021,73.77315567110823,0.5075795215381578,0.2691404784618422,0.03626724193252845,0.02695985028445824,0.00930739164807021,0.061,0.047421428571428566,1100221109.3899987,0.10159999999999997,44.23949198669488,-10.919540229885067,89.08045977011493,84.07153995343556,4.6282079403377825,0.4706,0.4835,0.4403,0.456,16289448.0,30165.0,8073376.0,-3.1024224394390143,71.97916666666667,0.49497104644767553,0.2677589535523246,0.03447542298996403,0.024633002372440684,0.00984242061752335,0.04319999999999996,0.04444285714285713,1065589665.3899987,0.1159,38.4335154826958,-22.54791431792558,77.45208568207443,83.03367030630703,0.46573333333333333,0.4583373782584033,0.44410000000000005,0.44307894723493046,0.38136500000000007,0.399150776113376,114399.0,10517467.333333323,239392.0,9653135.42857143
2022-04-02,0.4769,0.4916,0.4589,0.4599,18116731.0,24121.0,9773288.0,0.46429999999999993,0.4583714285714286,0.39559,0.4637843445646008,0.4536444078196484,0.4116445128728543,68.65384615384616,0.5136871036678492,0.27749289633215074,0.03589368421593325,0.028746617070753242,0.00714706714518001,0.03270000000000001,0.0484142857142857,1082104378.3899987,0.06109999999999999,33.88646288209605,-20.747126436781624,79.25287356321837,81.92847300513593,-3.5646886139651954,0.4559,0.4901,0.4291,0.477,34631444.0,43755.0,22269940.0,4.6282079403377825,73.77315567110823,0.5075795215381578,0.2691404784618422,0.03626724193252845,0.02695985028445824,0.00930739164807021,0.061,0.047421428571428566,1100221109.3899987,0.10159999999999997,44.23949198669488,-10.919540229885067,89.08045977011493,84.07153995343556,0.46786666666666665,0.4676686891292017,0.45437142857142854,0.45155921042619784,0.38836,0.4065649879121021,108294.0,13185850.333333323,247670.0,11352906.857142856
2022-04-03,0.4596,0.4775,0.4551,0.4708,9898313.0,15561.0,4972279.0,0.46923333333333334,0.4620857142857143,0.40291000000000005,0.4672921722823004,0.45793330586473624,0.4172783687897253,73.346366894754,0.5205756977247432,0.2852443022752569,0.03606148162639655,0.030209589981881904,0.005851891644514648,0.022399999999999975,0.04823571428571428,1092002691.3899987,0.030700000000000005,43.75572519083968,-14.491086831512364,85.50891316848764,84.61408216727368,2.4369016536118338,0.4769,0.4916,0.4589,0.4599,18116731.0,24121.0,9773288.0,-3.5646886139651954,68.65384615384616,0.5136871036678492,0.27749289633215074,0.03589368421593325,0.028746617070753242,0.00714706714518001,0.03270000000000001,0.0484142857142857,1082104378.3899987,0.06109999999999999,33.88646288209605,-20.747126436781624,79.25287356321837,81.92847300513593,0.46429999999999993,0.4637843445646008,0.4583714285714286,0.4536444078196484,0.39559,0.4116445128728543,98041.0,13372201.333333323,245897.0,11596312.57142857
2022-04-04,0.4714,0.4856,0.4449,0.4791,18074247.0,26313.0,8475354.0,0.46993333333333326,0.46914285714285714,0.41052999999999995,0.4731960861411502,0.4632249793985522,0.42316614319070384,72.9676140118969,0.5271494368560818,0.29391056314391806,0.0364440980405612,0.03145649159361777,0.004987606446943432,0.04069999999999996,0.04950714285714285,1110076938.3899987,0.07400000000000001,40.870332255219054,-10.764331210191067,89.23566878980893,84.66581850717166,1.6334323292320831,0.4596,0.4775,0.4551,0.4708,9898313.0,15561.0,4972279.0,2.4369016536118338,73.346366894754,0.5205756977247432,0.2852443022752569,0.03606148162639655,0.030209589981881904,0.005851891644514648,0.022399999999999975,0.04823571428571428,1092002691.3899987,0.030700000000000005,43.75572519083968,-14.491086831512364,85.50891316848764,84.61408216727368,0.46923333333333334,0.4672921722823004,0.4620857142857143,0.45793330586473624,0.40291000000000005,0.4172783687897253,83437.0,12338502.333333323,238245.0,11326086.285714285
2022-04-05,0.4792,0.54,0.4787,0.5043,59533633.0,87427.0,31617407.0,0.48473333333333324,0.4739571428571429,0.41926499999999994,0.48874804307057507,0.47349373454891414,0.43089317717254155,72.03418803418805,0.5365299590951071,0.3020000409048928,0.038338807789088436,0.032832954832711904,0.005505852956376532,0.06130000000000002,0.047742857142857135,1169610571.3899987,0.07239999999999996,34.33670751198721,-19.6477710511833,80.3522289488167,85.03227030237112,5.237896494156919,0.4714,0.4856,0.4449,0.4791,18074247.0,26313.0,8475354.0,1.6334323292320831,72.9676140118969,0.5271494368560818,0.29391056314391806,0.0364440980405612,0.03145649159361777,0.004987606446943432,0.04069999999999996,0.04950714285714285,1110076938.3899987,0.07400000000000001,40.870332255219054,-10.764331210191067,89.23566878980893,84.66581850717166,0.46993333333333326,0.4731960861411502,0.46914285714285714,0.4632249793985522,0.41052999999999995,0.42316614319070384,65995.0,7740306.99999999,224149.0,11006180.42857143
2022-04-06,0.5048,0.51,0.4386,0.4473,26504069.0,41522.0,12809148.0,0.47689999999999994,0.47062857142857145,0.42516,0.46802402153528755,0.4669453009116856,0.4324557317275376,57.43636921189819,0.5350238468382732,0.31529615316172677,0.03483934895629248,0.033234233657428024,0.0016051152988644582,0.07140000000000002,0.04557857142857142,1143106502.3899987,0.0025000000000000022,12.161484453360071,-64.2857142857143,35.714285714285694,68.43406115097046,-11.390649762282102,0.4792,0.54,0.4787,0.5043,59533633.0,87427.0,31617407.0,5.237896494156919,72.03418803418805,0.5365299590951071,0.3020000409048928,0.038338807789088436,0.032832954832711904,0.005505852956376532,0.06130000000000002,0.047742857142857135,1169610571.3899987,0.07239999999999996,34.33670751198721,-19.6477710511833,80.3522289488167,85.03227030237112,0.48473333333333324,0.48874804307057507,0.4739571428571429,0.47349373454891414,0.41926499999999994,0.43089317717254155,129301.0,15021679.99999999,261716.0,13485125.57142857
2022-04-07,0.4479,0.4667,0.4341,0.4491,15826936.0,23491.0,7968111.0,0.4668999999999999,0.46964285714285714,0.43107999999999996,0.4585620107676438,0.4624839756837642,0.4340409001344388,51.57013258897418,0.5319001233046075,0.3302598766953925,0.03184416783138072,0.032956220492218566,-0.001112052660837845,0.03260000000000002,0.04372857142857143,1158933438.3899987,0.019399999999999973,2.0449897750511203,-63.96903589021815,36.03096410978184,50.69915959096144,0.26791694574681374,0.5048,0.51,0.4386,0.4473,26504069.0,41522.0,12809148.0,-11.390649762282102,57.43636921189819,0.5350238468382732,0.31529615316172677,0.03483934895629248,0.033234233657428024,0.0016051152988644582,0.07140000000000002,0.04557857142857142,1143106502.3899987,0.0025000000000000022,12.161484453360071,-64.2857142857143,35.714285714285694,68.43406115097046,0.47689999999999994,0.46802402153528755,0.47062857142857145,0.4669453009116856,0.42516,0.4324557317275376,155262.0,17633969.666666657,268864.0,13998684.57142857
2022-04-08,0.4491,0.4663,0.3981,0.4014,24090803.0,38793.0,11208301.0,0.43259999999999993,0.45884285714285716,0.43397499999999994,0.4299810053838219,0.44721298176282315,0.43093224297877797,49.381891079184754,0.5272491714121866,0.34070082858781325,0.025329491248257396,0.03143087464342634,-0.006101383395168941,0.06819999999999998,0.04552142857142857,1134842635.3899987,-0.06920000000000004,-0.9133547272278553,-97.53694581280789,2.463054187192119,24.73610133708658,-10.621242484969946,0.4479,0.4667,0.4341,0.4491,15826936.0,23491.0,7968111.0,0.26791694574681374,51.57013258897418,0.5319001233046075,0.3302598766953925,0.03184416783138072,0.032956220492218566,-0.001112052660837845,0.03260000000000002,0.04372857142857143,1158933438.3899987,0.019399999999999973,2.0449897750511203,-63.96903589021815,36.03096410978184,50.69915959096144,0.4668999999999999,0.4585620107676438,0.46964285714285714,0.4624839756837642,0.43107999999999996,0.4340409001344388,152440.0,17464888.666666657,262190.0,13983646.714285715
2022-04-09,0.4012,0.419,0.3908,0.4026,11367058.0,23506.0,5027994.0,0.41769999999999996,0.4506571428571428,0.43773,0.4162905026919109,0.43605973632211736,0.42823393412365623,44.647424187066136,0.518111723505301,0.357348276494699,0.02003247123300972,0.029151193961343014,-0.009118722728333296,0.028200000000000003,0.04494285714285714,1146209693.3899987,-0.068,-6.7839777726325545,-92.09115281501339,7.908847184986614,15.46762182732022,0.34895314057826826,0.4491,0.4663,0.3981,0.4014,24090803.0,38793.0,11208301.0,-10.621242484969946,49.381891079184754,0.5272491714121866,0.34070082858781325,0.025329491248257396,0.03143087464342634,-0.006101383395168941,0.06819999999999998,0.04552142857142857,1134842635.3899987,-0.06920000000000004,-0.9133547272278553,-97.53694581280789,2.463054187192119,24.73610133708658,0.43259999999999993,0.4299810053838219,0.45884285714285716,0.44721298176282315,0.43397499999999994,0.43093224297877797,103806.0,10661853.333333323,257228.0,12403412.57142857
2022-04-10,0.4021,0.414,0.3737,0.3754,14155911.0,23754.0,6468999.0,0.3931333333333333,0.4370285714285714,0.4394950000000001,0.3958452513459555,0.42089480224158804,0.4232021308737842,37.9513888888889,0.5120163718045897,0.36697362819541046,0.013484293486214438,0.0260178138663173,-0.012533520380102862,0.0403,0.045421428571428564,1132053782.3899987,-0.0806,-15.602517985611508,-98.97775105231507,1.0222489476849272,3.7980501066212486,-6.640139268838598,0.4012,0.419,0.3908,0.4026,11367058.0,23506.0,5027994.0,0.34895314057826826,44.647424187066136,0.518111723505301,0.357348276494699,0.02003247123300972,0.029151193961343014,-0.009118722728333296,0.028200000000000003,0.04494285714285714,1146209693.3899987,-0.068,-6.7839777726325545,-92.09115281501339,7.908847184986614,15.46762182732022,0.41769999999999996,0.4162905026919109,0.4506571428571428,0.43605973632211736,0.43773,0.42823393412365623,85790.0,8068135.333333324,256613.0,11725513.42857143
2022-04-11,0.375,0.3791,0.3337,0.3365,25429787.0,33599.0,11966169.0,0.3715,0.41665714285714284,0.43755,0.36617262567297776,0.39979610168119106,0.41494478507628096,35.05452212957023,0.5188629755942952,0.35623702440570476,0.005097153730335369,0.021833681839120916,-0.016736528108785547,0.045399999999999996,0.045992857142857134,1106623995.3899987,-0.14049999999999996,-21.68955084942984,-98.64275327193407,1.357246728065935,3.429447620245854,-10.266666666666662,0.4021,0.414,0.3737,0.3754,14155911.0,23754.0,6468999.0,-6.640139268838598,37.9513888888889,0.5120163718045897,0.36697362819541046,0.013484293486214438,0.0260178138663173,-0.012533520380102862,0.0403,0.045421428571428564,1132053782.3899987,-0.0806,-15.602517985611508,-98.97775105231507,1.0222489476849272,3.7980501066212486,0.3931333333333333,0.3958452513459555,0.4370285714285714,0.42089480224158804,0.4394950000000001,0.4232021308737842,86053.0,7568431.333333324,264806.0,11939330.57142857
2022-04-12,0.3365,0.3724,0.3304,0.3458,26837744.0,40034.0,13771314.0,0.35256666666666664,0.39401428571428576,0.4349,0.35598631283648885,0.38629707626089327,0.4083595674499685,27.730192719486084,0.5245567724274284,0.34524322757257164,-0.0007901740411406788,0.017308910663068597,-0.018099084704209276,0.04199999999999998,0.04422857142857143,1133461739.3899987,-0.11409999999999998,-26.519337016574585,-92.65267175572521,7.347328244274793,3.24227464000858,2.7637444279346135,0.375,0.3791,0.3337,0.3365,25429787.0,33599.0,11966169.0,-10.266666666666662,35.05452212957023,0.5188629755942952,0.35623702440570476,0.005097153730335369,0.021833681839120916,-0.016736528108785547,0.045399999999999996,0.045992857142857134,1106623995.3899987,-0.14049999999999996,-21.68955084942984,-98.64275327193407,1.357246728065935,3.429447620245854,0.3715,0.36617262567297776,0.41665714285714284,0.39979610168119106,0.43755,0.41494478507628096,80859.0,7821053.99999999,272092.0,12438018.42857143
2022-04-13,0.346,0.3629,0.3368,0.3513,12217719.0,19400.0,5468723.0,0.3445333333333333,0.3803,0.43045999999999995,0.3536431564182444,0.37754780719566994,0.40292532293092387,29.12145607280364,0.5275218337913812,0.3333981662086187,-0.004955001508352541,0.01285612822878437,-0.01781112973713691,0.026100000000000012,0.04396428571428571,1145679458.3899987,-0.1195,-25.350616234594135,-90.02862595419849,9.971374045801513,6.225316339380775,1.5317919075144588,0.3365,0.3724,0.3304,0.3458,26837744.0,40034.0,13771314.0,2.7637444279346135,27.730192719486084,0.5245567724274284,0.34524322757257164,-0.0007901740411406788,0.017308910663068597,-0.018099084704209276,0.04199999999999998,0.04422857142857143,1133461739.3899987,-0.11409999999999998,-26.519337016574585,-92.65267175572521,7.347328244274793,3.24227464000858,0.35256666666666664,0.35598631283648885,0.39401428571428576,0.38629707626089327,0.4349,0.4083595674499685,97387.0,10735493.99999999,224699.0,9888576.57142857
2022-04-14,0.3518,0.3577,0.3269,0.3319,33349093.0,28772.0,18524389.0,0.34299999999999997,0.3635571428571428,0.42679999999999996,0.3427715782091222,0.3661358553967524,0.3961610064613121,28.640275387263344,0.5329803629381747,0.32061963706182517,-0.00970915406518974,0.008343071769989548,-0.01805222583517929,0.030799999999999994,0.043078571428571424,1112330365.3899987,-0.14720000000000005,-27.214912280701764,-97.65368371656503,2.346316283434983,6.555006191170459,-5.656623081296199,0.346,0.3629,0.3368,0.3513,12217719.0,19400.0,5468723.0,1.5317919075144588,29.12145607280364,0.5275218337913812,0.3333981662086187,-0.004955001508352541,0.01285612822878437,-0.01781112973713691,0.026100000000000012,0.04396428571428571,1145679458.3899987,-0.1195,-25.350616234594135,-90.02862595419849,9.971374045801513,6.225316339380775,0.3445333333333333,0.3536431564182444,0.3803,0.37754780719566994,0.43045999999999995,0.40292532293092387,93033.0,10402068.666666657,202577.0,8839944.42857143
2022-04-15,0.3319,0.341,0.3277,0.3342,16887163.0,13465.0,10033872.0,0.3391333333333333,0.35395714285714286,0.421915,0.33848578910456106,0.3581518915475643,0.3902599582269014,23.73068432671083,0.5358164028840102,0.30801359711598975,-0.013139796050572805,0.0040464982058770775,-0.017186294256449883,0.013300000000000034,0.03967142857142857,1129217528.3899987,-0.17009999999999997,-29.93710691823899,-96.5743782261849,3.425621773815098,5.2477707010172265,0.6929798131967533,0.3518,0.3577,0.3269,0.3319,33349093.0,28772.0,18524389.0,-5.656623081296199,28.640275387263344,0.5329803629381747,0.32061963706182517,-0.00970915406518974,0.008343071769989548,-0.01805222583517929,0.030799999999999994,0.043078571428571424,1112330365.3899987,-0.14720000000000005,-27.214912280701764,-97.65368371656503,2.346316283434983,6.555006191170459,0.34299999999999997,0.3427715782091222,0.3635571428571428,0.3661358553967524,0.42679999999999996,0.3961610064613121,88206.0,12588141.99999999,207858.0,10347984.142857144
2022-04-16,0.3341,0.3428,0.3285,0.3355,7715093.0,7311.0,4544148.0,0.3338666666666666,0.3443714285714286,0.41645000000000004,0.33699289455228054,0.3524889186606732,0.38504472411005364,25.703125000000014,0.5360728899060371,0.296827110093963,-0.015574175998658457,0.0001223633649699708,-0.01569653936362843,0.01429999999999998,0.03835714285714286,1136932621.3899987,-0.11179999999999995,-27.04935855620786,-95.96433599249178,4.03566400750821,3.2692006882527918,0.4190362167015901,0.3319,0.341,0.3277,0.3342,16887163.0,13465.0,10033872.0,0.6929798131967533,23.73068432671083,0.5358164028840102,0.30801359711598975,-0.013139796050572805,0.0040464982058770775,-0.017186294256449883,0.013300000000000034,0.03967142857142857,1129217528.3899987,-0.17009999999999997,-29.93710691823899,-96.5743782261849,3.425621773815098,5.2477707010172265,0.3391333333333333,0.33848578910456106,0.35395714285714286,0.3581518915475643,0.421915,0.3902599582269014,61637.0,11342327.99999999,182530.0,10180208.57142857
2022-04-17,0.3354,0.3535,0.3274,0.3286,19262400.0,15781.0,12599723.0,0.3327666666666666,0.3376857142857143,0.411395,0.3327964472761403,0.3465166889955049,0.37966903609957237,21.785714285714306,0.5370526548027394,0.2857373451972606,-0.017854397599025684,-0.0034729888278291605,-0.014381408771196523,0.026099999999999957,0.03862142857142857,1117670221.3899987,-0.1205,-30.203908241291423,-99.2022524636321,0.7977475363678926,2.753011105897095,-2.0274299344066704,0.3341,0.3428,0.3285,0.3355,7715093.0,7311.0,4544148.0,0.4190362167015901,25.703125000000014,0.5360728899060371,0.296827110093963,-0.015574175998658457,0.0001223633649699708,-0.01569653936362843,0.01429999999999998,0.03835714285714286,1136932621.3899987,-0.11179999999999995,-27.04935855620786,-95.96433599249178,4.03566400750821,3.2692006882527918,0.3338666666666666,0.33699289455228054,0.3443714285714286,0.3524889186606732,0.41645000000000004,0.38504472411005364,49548.0,11034136.333333323,166335.0,10111087.714285715
2022-04-18,0.3286,0.35,0.3082,0.3433,21220964.0,23349.0,11345028.0,0.33579999999999993,0.3386571428571429,0.40503,0.33804822363807013,0.3457125167466287,0.37620531837580357,23.722910216718276,0.5309566302674869,0.2791033697325131,-0.01826477751271488,-0.006431346564806305,-0.011833430947908575,0.041800000000000004,0.038700000000000005,1138891185.3899987,-0.058099999999999985,-28.344813191400554,-84.8576358930112,15.142364106988786,6.658591883621658,4.473524041387702,0.3354,0.3535,0.3274,0.3286,19262400.0,15781.0,12599723.0,-2.0274299344066704,21.785714285714306,0.5370526548027394,0.2857373451972606,-0.017854397599025684,-0.0034729888278291605,-0.014381408771196523,0.026099999999999957,0.03862142857142857,1117670221.3899987,-0.1205,-30.203908241291423,-99.2022524636321,0.7977475363678926,2.753011105897095,0.3327666666666666,0.3327964472761403,0.3376857142857143,0.3465166889955049,0.411395,0.37966903609957237,36557.0,9059247.666666657,158362.0,10986905.42857143
2022-04-19,0.3431,0.3529,0.3374,0.3482,8140739.0,12447.0,4104407.0,0.34003333333333324,0.339,0.39891,0.34312411181903507,0.34633438755997153,0.3735381451971556,17.219655606887883,0.5233069351458555,0.27451306485414456,-0.017987271433551555,-0.008742531538555356,-0.009244739894996199,0.015500000000000014,0.03542857142857143,1147031924.3899987,-0.054400000000000004,-30.953797342851473,-80.17839444995043,19.82160555004957,11.920572397802111,1.4864470999708521,0.3286,0.35,0.3082,0.3433,21220964.0,23349.0,11345028.0,4.473524041387702,23.722910216718276,0.5309566302674869,0.2791033697325131,-0.01826477751271488,-0.006431346564806305,-0.011833430947908575,0.041800000000000004,0.038700000000000005,1138891185.3899987,-0.058099999999999985,-28.344813191400554,-84.8576358930112,15.142364106988786,6.658591883621658,0.33579999999999993,0.33804822363807013,0.3386571428571429,0.3457125167466287,0.40503,0.37620531837580357,46441.0,9496299.666666657,148112.0,10898171.0
2022-04-20,0.3481,0.3549,0.3288,0.3366,10237756.0,12227.0,4998399.0,0.34269999999999995,0.3369,0.39293999999999996,0.33986205590951757,0.34390079066997864,0.3700202266069503,21.27659574468089,0.5172611359427798,0.2686188640572202,-0.018490225115875947,-0.010692070254019475,-0.0077981548618564715,0.026100000000000012,0.03219285714285714,1136794168.3899987,-0.0388,-24.74849094567404,-82.08201892744478,17.917981072555225,17.627316909864557,-3.3036483769031912,0.3431,0.3529,0.3374,0.3482,8140739.0,12447.0,4104407.0,1.4864470999708521,17.219655606887883,0.5233069351458555,0.27451306485414456,-0.017987271433551555,-0.008742531538555356,-0.009244739894996199,0.015500000000000014,0.03542857142857143,1147031924.3899987,-0.054400000000000004,-30.953797342851473,-80.17839444995043,19.82160555004957,11.920572397802111,0.34003333333333324,0.34312411181903507,0.339,0.34633438755997153,0.39891,0.3735381451971556,51577.0,9349719.333333323,120525.0,9517184.285714285
2022-04-21,0.3363,0.3487,0.3161,0.3235,12588605.0,12984.0,6534970.0,0.3361,0.33570000000000005,0.385265,0.3316810279547588,0.338800593002484,0.36558972883485974,19.21568627450982,0.506653897003751,0.26387610299624914,-0.019718576575065982,-0.012497371518228778,-0.007221205056837205,0.03260000000000002,0.03219285714285714,1124205563.3899987,-0.013000000000000012,-27.96704520151414,-90.32258064516127,9.677419354838731,15.80566865914787,-3.8061254831995175,0.3481,0.3549,0.3288,0.3366,10237756.0,12227.0,4998399.0,-3.3036483769031912,21.27659574468089,0.5172611359427798,0.2686188640572202,-0.018490225115875947,-0.010692070254019475,-0.0077981548618564715,0.026100000000000012,0.03219285714285714,1136794168.3899987,-0.0388,-24.74849094567404,-82.08201892744478,17.917981072555225,17.627316909864557,0.34269999999999995,0.33986205590951757,0.3369,0.34390079066997864,0.39293999999999996,0.3700202266069503,48023.0,6815944.666666657,113352.0,9449995.142857144
2022-04-22,0.3231,0.332,0.3164,0.3216,7135205.0,9733.0,3334717.0,0.3272333333333333,0.3339,0.37835,0.32664051397737937,0.334500444751863,0.3614002308505874,24.778761061946923,0.4975746971942069,0.25912530280579316,-0.020607814025142945,-0.014119460019611613,-0.006488354005531332,0.015600000000000003,0.028435714285714286,1117070358.3899987,-0.0242,-19.880418535127053,-87.90613718411551,12.093862815884496,13.22975441442618,-0.46425255338904403,0.3363,0.3487,0.3161,0.3235,12588605.0,12984.0,6534970.0,-3.8061254831995175,19.21568627450982,0.506653897003751,0.26387610299624914,-0.019718576575065982,-0.012497371518228778,-0.007221205056837205,0.03260000000000002,0.03219285714285714,1124205563.3899987,-0.013000000000000012,-27.96704520151414,-90.32258064516127,9.677419354838731,15.80566865914787,0.3361,0.3316810279547588,0.33570000000000005,0.338800593002484,0.385265,0.36558972883485974,37658.0,5212591.99999999,97564.0,7737221.0
2022-04-23,0.3214,0.3389,0.3142,0.3189,9662118.0,11097.0,4703742.0,0.3213333333333333,0.33152857142857145,0.37075500000000006,0.32277025698868966,0.33060033356389723,0.35735258981719814,23.794614902943025,0.4844050904206819,0.2571049095793182,-0.021285047764945164,-0.015552577568678325,-0.0057324701962668395,0.0247,0.02818571428571429,1107408240.3899987,-0.032399999999999984,-20.78986587183308,-89.88657844990544,10.113421550094557,10.628234573605956,-0.7778469197261985,0.3231,0.332,0.3164,0.3216,7135205.0,9733.0,3334717.0,-0.46425255338904403,24.778761061946923,0.4975746971942069,0.25912530280579316,-0.020607814025142945,-0.014119460019611613,-0.006488354005531332,0.015600000000000003,0.028435714285714286,1117070358.3899987,-0.0242,-19.880418535127053,-87.90613718411551,12.093862815884496,13.22975441442618,0.3272333333333333,0.32664051397737937,0.3339,0.334500444751863,0.37835,0.3614002308505874,34944.0,4956028.666666657,93832.0,6780198.857142857
2022-04-24,0.3188,0.3587,0.3165,0.3435,50945093.0,55754.0,28944819.0,0.328,0.3336571428571428,0.363975,0.33313512849434485,0.33382525017292297,0.3560332955488935,39.8472310630172,0.4659940462093779,0.2619559537906221,-0.01961068619054579,-0.01636419929305182,-0.0032464868974939713,0.042200000000000015,0.028321428571428577,1158353333.3899987,0.011600000000000055,-8.497602557272243,-50.211565585331385,49.78843441466861,23.998572926882577,7.747804265997509,0.3214,0.3389,0.3142,0.3189,9662118.0,11097.0,4703742.0,-0.7778469197261985,23.794614902943025,0.4844050904206819,0.2571049095793182,-0.021285047764945164,-0.015552577568678325,-0.0057324701962668395,0.0247,0.02818571428571429,1107408240.3899987,-0.032399999999999984,-20.78986587183308,-89.88657844990544,10.113421550094557,10.628234573605956,0.3213333333333333,0.32277025698868966,0.33152857142857145,0.33060033356389723,0.37075500000000006,0.35735258981719814,33814.0,4857809.666666657,97618.0,6802998.0
2022-04-25,0.3437,0.3559,0.3197,0.3356,49414004.0,52489.0,25737064.0,0.33266666666666667,0.3325571428571429,0.35554,0.3343675642471724,0.33426893762969223,0.35408726740137986,49.64314036478984,0.43384911488250655,0.2772308851174935,-0.018705580271109856,-0.01683247548866343,-0.0018731047824464275,0.03620000000000001,0.02766428571428572,1108939329.3899987,0.0014000000000000123,-0.26745913818722045,-57.32087227414328,42.67912772585673,34.19366123020666,-2.3567064300261844,0.3188,0.3587,0.3165,0.3435,50945093.0,55754.0,28944819.0,7.747804265997509,39.8472310630172,0.4659940462093779,0.2619559537906221,-0.01961068619054579,-0.01636419929305182,-0.0032464868974939713,0.042200000000000015,0.028321428571428577,1158353333.3899987,0.011600000000000055,-8.497602557272243,-50.211565585331385,49.78843441466861,23.998572926882577,0.328,0.33313512849434485,0.3336571428571428,0.33382525017292297,0.363975,0.3560332955488935,76584.0,12327759.333333323,137591.0,9138011.714285715
2022-04-26,0.3356,0.346,0.2978,0.3033,17403989.0,21590.0,7907698.0,0.32746666666666663,0.3261428571428571,0.34834,0.3188337821235862,0.3265267032222692,0.34925038479172466,35.74782025486253,0.4170128752090007,0.27966712479099926,-0.020359920872450865,-0.017537964565420915,-0.0028219563070299505,0.048199999999999965,0.028107142857142855,1091535340.3899987,-0.032200000000000006,-12.290341237709656,-91.55145929339477,8.44854070660523,33.63870094904355,-9.624553039332536,0.3437,0.3559,0.3197,0.3356,49414004.0,52489.0,25737064.0,-2.3567064300261844,49.64314036478984,0.43384911488250655,0.2772308851174935,-0.018705580271109856,-0.01683247548866343,-0.0018731047824464275,0.03620000000000001,0.02766428571428572,1108939329.3899987,0.0014000000000000123,-0.26745913818722045,-57.32087227414328,42.67912772585673,34.19366123020666,0.33266666666666667,0.3343675642471724,0.3325571428571429,0.33426893762969223,0.35554,0.35408726740137986,119340.0,19795208.333333325,166731.0,11194016.857142856
2022-04-27,0.3033,0.3365,0.3011,0.3129,13320178.0,18425.0,7357151.0,0.31726666666666664,0.32275714285714285,0.34153,0.3158668910617931,0.32312002741670187,0.345788443382989,37.46736292428201,0.3929861069977669,0.2900738930022331,-0.020658222815126026,-0.01816201621536194,-0.0024962065997640864,0.03540000000000004,0.028771428571428576,1104855518.3899987,-0.015699999999999992,-10.93082835183603,-75.20525451559934,24.794745484400657,25.307471305620897,3.1651829871414434,0.3356,0.346,0.2978,0.3033,17403989.0,21590.0,7907698.0,-9.624553039332536,35.74782025486253,0.4170128752090007,0.27966712479099926,-0.020359920872450865,-0.017537964565420915,-0.0028219563070299505,0.048199999999999965,0.028107142857142855,1091535340.3899987,-0.032200000000000006,-12.290341237709656,-91.55145929339477,8.44854070660523,33.63870094904355,0.32746666666666663,0.3188337821235862,0.3261428571428571,0.3265267032222692,0.34834,0.34925038479172466,129833.0,20863193.666666657,175874.0,11737344.142857144
2022-04-28,0.3127,0.3212,0.3029,0.3087,9834383.0,13085.0,4724764.0,0.30829999999999996,0.3206428571428571,0.336895,0.31228344553089654,0.3195150205625264,0.34225621067984713,41.59420289855074,0.3819457304689573,0.2918442695310427,-0.020991556555795987,-0.01872792428344875,-0.0022636322723472366,0.018299999999999983,0.027878571428571437,1095021135.3899987,-0.03460000000000002,-6.990057246158477,-82.10180623973733,17.898193760262664,17.047159983756213,-1.2791813239526715,0.3033,0.3365,0.3011,0.3129,13320178.0,18425.0,7357151.0,3.1651829871414434,37.46736292428201,0.3929861069977669,0.2900738930022331,-0.020658222815126026,-0.01816201621536194,-0.0024962065997640864,0.03540000000000004,0.028771428571428576,1104855518.3899987,-0.015699999999999992,-10.93082835183603,-75.20525451559934,24.794745484400657,25.307471305620897,0.31726666666666664,0.3158668910617931,0.32275714285714285,0.32312002741670187,0.34153,0.345788443382989,92504.0,13667304.333333323,182072.0,12074308.714285715
2022-04-29,0.3087,0.3092,0.2773,0.2848,7623828.0,10487.0,3367642.0,0.3021333333333333,0.31538571428571427,0.331005,0.29854172276544827,0.3108362654218948,0.3367841906150998,34.52380952380953,0.37032380359047773,0.29168619640952226,-0.022920048158249107,-0.019566349058408823,-0.0033536990998402835,0.031899999999999984,0.02920714285714285,1087397307.3899987,-0.06340000000000001,-14.781567923399164,-90.78624078624078,9.21375921375922,17.30223281947421,-7.742144476838347,0.3127,0.3212,0.3029,0.3087,9834383.0,13085.0,4724764.0,-1.2791813239526715,41.59420289855074,0.3819457304689573,0.2918442695310427,-0.020991556555795987,-0.01872792428344875,-0.0022636322723472366,0.018299999999999983,0.027878571428571437,1095021135.3899987,-0.03460000000000002,-6.990057246158477,-82.10180623973733,17.898193760262664,17.047159983756213,0.30829999999999996,0.31228344553089654,0.3206428571428571,0.3195150205625264,0.336895,0.34225621067984713,53100.0,6663204.333333324,182173.0,11815707.857142856
2022-04-30,0.2848,0.2874,0.258,0.2582,7638676.0,9699.0,3635973.0,0.2839,0.3067142857142858,0.32514499999999996,0.27837086138272416,0.2976771990664211,0.32929998198509025,29.096809085992433,0.3709964982823229,0.27929350171767703,-0.026291714819336343,-0.02091142221059433,-0.0053802926087420135,0.02939999999999998,0.03028571428571428,1079758631.3899987,-0.07840000000000003,-23.040238450074526,-99.80139026812316,0.19860973187684006,9.10352090196627,-9.339887640449444,0.3087,0.3092,0.2773,0.2848,7623828.0,10487.0,3367642.0,-7.742144476838347,34.52380952380953,0.37032380359047773,0.29168619640952226,-0.022920048158249107,-0.019566349058408823,-0.0033536990998402835,0.031899999999999984,0.02920714285714285,1087397307.3899987,-0.06340000000000001,-14.781567923399164,-90.78624078624078,9.21375921375922,17.30223281947421,0.3021333333333333,0.29854172276544827,0.31538571428571427,0.3108362654218948,0.331005,0.3367841906150998,41997.0,5149852.333333324,182927.0,11820411.42857143
2022-05-01,0.2583,0.2744,0.2511,0.2704,10952340.0,11161.0,5995382.0,0.2711333333333333,0.2962714285714286,0.32184,0.27438543069136206,0.2908578992998158,0.32369045989127215,34.70031545741324,0.37341687772429094,0.2702631222757091,-0.027660493943329645,-0.022261236557141396,-0.005399257386188249,0.023299999999999987,0.03008571428571429,1090710971.3899987,-0.053100000000000036,-17.711503347535007,-82.06319702602232,17.936802973977674,9.116390639871273,4.6844754161827336,0.2848,0.2874,0.258,0.2582,7638676.0,9699.0,3635973.0,-9.339887640449444,29.096809085992433,0.3709964982823229,0.27929350171767703,-0.026291714819336343,-0.02091142221059433,-0.0053802926087420135,0.02939999999999998,0.03028571428571428,1079758631.3899987,-0.07840000000000003,-23.040238450074526,-99.80139026812316,0.19860973187684006,9.10352090196627,0.2839,0.27837086138272416,0.3067142857142858,0.2976771990664211,0.32514499999999996,0.32929998198509025,33271.0,3909459.6666666567,181529.0,11667873.0
2022-05-02,0.2704,0.2783,0.254,0.2632,13635265.0,11077.0,7957490.0,0.2639333333333333,0.2859285714285714,0.31771,0.26879271534568105,0.28394342447486187,0.317929463711151,28.07881773399015,0.37420267861271084,0.26121732138728915,-0.028992038910067075,-0.02360739702772653,-0.005384641882340543,0.02429999999999999,0.02883571428571428,1077075706.3899987,-0.05840000000000001,-23.33236236527818,-88.7546468401487,11.245353159851296,9.793588621901966,-2.6627218934911188,0.2583,0.2744,0.2511,0.2704,10952340.0,11161.0,5995382.0,4.6844754161827336,34.70031545741324,0.37341687772429094,0.2702631222757091,-0.027660493943329645,-0.022261236557141396,-0.005399257386188249,0.023299999999999987,0.03008571428571429,1090710971.3899987,-0.053100000000000036,-17.711503347535007,-82.06319702602232,17.936802973977674,9.116390639871273,0.2711333333333333,0.27438543069136206,0.2962714285714286,0.2908578992998158,0.32184,0.32369045989127215,31347.0,4332998.99999999,136936.0,8389382.0
2022-05-03,0.2635,0.2919,0.2593,0.2677,15424098.0,16439.0,7571233.0,0.26709999999999995,0.2808428571428571,0.31353,0.26824635767284055,0.2798825683561464,0.31314570526246993,27.921009325287983,0.37189819970531035,0.2551618002946896,-0.02934590418132782,-0.02475509845844679,-0.004590805722881029,0.03260000000000002,0.030057142857142862,1092499804.3899987,-0.05120000000000002,-23.118897185525565,-84.5724907063197,15.427509293680297,14.869888475836452,1.5939278937381334,0.2704,0.2783,0.254,0.2632,13635265.0,11077.0,7957490.0,-2.6627218934911188,28.07881773399015,0.37420267861271084,0.26121732138728915,-0.028992038910067075,-0.02360739702772653,-0.005384641882340543,0.02429999999999999,0.02883571428571428,1077075706.3899987,-0.05840000000000001,-23.33236236527818,-88.7546468401487,11.245353159851296,9.793588621901966,0.2639333333333333,0.26879271534568105,0.2859285714285714,0.28394342447486187,0.31771,0.317929463711151,31937.0,5862948.333333324,95524.0,5849442.857142857
2022-05-04,0.2681,0.305,0.267,0.2887,46162620.0,34321.0,26074597.0,0.27319999999999994,0.2773857142857143,0.31137,0.2784731788364203,0.2820869262671098,0.3108175428565204,37.50652060511216,0.3700722495758043,0.25266775042419565,-0.027613509118283364,-0.025326780590414107,-0.002286728527869257,0.03799999999999998,0.030907142857142855,1138662424.3899987,-0.054800000000000015,-14.230540701128936,-65.05576208178438,34.94423791821563,20.5390334572491,7.683700111898547,0.2635,0.2919,0.2593,0.2677,15424098.0,16439.0,7571233.0,1.5939278937381334,27.921009325287983,0.37189819970531035,0.2551618002946896,-0.02934590418132782,-0.02475509845844679,-0.004590805722881029,0.03260000000000002,0.030057142857142862,1092499804.3899987,-0.05120000000000002,-23.118897185525565,-84.5724907063197,15.427509293680297,14.869888475836452,0.26709999999999995,0.26824635767284055,0.2808428571428571,0.2798825683561464,0.31353,0.31314570526246993,38677.0,7174701.666666657,90373.0,5801376.428571428
2022-05-05,0.2887,0.2964,0.2566,0.2691,24485505.0,18811.0,12584277.0,0.2751666666666666,0.27172857142857143,0.308115,0.27378658941821016,0.2788401947003324,0.3068444435368518,36.27648839556005,0.3686771481576612,0.24755285184233883,-0.02750506843791195,-0.025762438159913675,-0.0017426302779982757,0.0398,0.031421428571428565,1114176919.3899987,-0.0665,-16.816074188562602,-83.271375464684,16.728624535315994,22.366790582403997,-6.789054381711121,0.2681,0.305,0.267,0.2887,46162620.0,34321.0,26074597.0,7.683700111898547,37.50652060511216,0.3700722495758043,0.25266775042419565,-0.027613509118283364,-0.025326780590414107,-0.002286728527869257,0.03799999999999998,0.030907142857142855,1138662424.3899987,-0.054800000000000015,-14.230540701128936,-65.05576208178438,34.94423791821563,20.5390334572491,0.27319999999999994,0.2784731788364203,0.2773857142857143,0.2820869262671098,0.31137,0.3108175428565204,61837.0,13867773.333333323,106269.0,8475297.285714285
2022-05-06,0.2691,0.2701,0.247,0.2599,11701127.0,11311.0,6279405.0,0.2725666666666666,0.26817142857142856,0.304335,0.26684329470910506,0.27410514602524927,0.30237354415238976,34.98783454987834,0.36709755252932896,0.24157244747067108,-0.027840562851433936,-0.026178063098217727,-0.0016624997532162095,0.02310000000000001,0.03195714285714286,1102475792.3899987,-0.043399999999999994,-19.185323383084572,-88.4512085944494,11.5487914055506,21.073884619694102,-3.4188034188034138,0.2887,0.2964,0.2566,0.2691,24485505.0,18811.0,12584277.0,-6.789054381711121,36.27648839556005,0.3686771481576612,0.24755285184233883,-0.02750506843791195,-0.025762438159913675,-0.0017426302779982757,0.0398,0.031421428571428565,1114176919.3899987,-0.0665,-16.816074188562602,-83.271375464684,16.728624535315994,22.366790582403997,0.2751666666666666,0.27378658941821016,0.27172857142857143,0.2788401947003324,0.308115,0.3068444435368518,69571.0,15410035.666666657,111995.0,9598084.857142856
2022-05-07,0.2597,0.27,0.2493,0.2571,8804894.0,8064.0,5516803.0,0.26203333333333334,0.2680142857142857,0.30076,0.26197164735455253,0.2698538595189369,0.29806177804263834,34.97081712062257,0.3658067815458261,0.23571321845417398,-0.028009505051755312,-0.026544351488925245,-0.0014651535628300676,0.020700000000000024,0.031671428571428566,1093670898.3899987,-0.055800000000000016,-19.379115710254002,-90.95792300805729,9.0420769919427,12.439830977603124,-1.0011551790527498,0.2691,0.2701,0.247,0.2599,11701127.0,11311.0,6279405.0,-3.4188034188034138,34.98783454987834,0.36709755252932896,0.24157244747067108,-0.027840562851433936,-0.026178063098217727,-0.0016624997532162095,0.02310000000000001,0.03195714285714286,1102475792.3899987,-0.043399999999999994,-19.185323383084572,-88.4512085944494,11.5487914055506,21.073884619694102,0.2725666666666666,0.26684329470910506,0.26817142857142856,0.27410514602524927,0.304335,0.30237354415238976,64443.0,14979426.333333323,112819.0,10014051.0
2022-05-08,0.257,0.2663,0.2412,0.2428,9210083.0,7830.0,4698981.0,0.2532666666666666,0.26407142857142857,0.29573499999999997,0.25238582367727624,0.2630903946392027,0.2927987515623871,24.219150025601635,0.3624509658946779,0.22901903410532204,-0.028963411276488493,-0.027028163446437898,-0.0019352478300505953,0.025099999999999983,0.03045,1084460815.3899987,-0.06589999999999999,-29.315866084425046,-98.6050566695728,1.394943330427193,7.328603909306858,-5.525291828793781,0.2597,0.27,0.2493,0.2571,8804894.0,8064.0,5516803.0,-1.0011551790527498,34.97081712062257,0.3658067815458261,0.23571321845417398,-0.028009505051755312,-0.026544351488925245,-0.0014651535628300676,0.020700000000000024,0.031671428571428566,1093670898.3899987,-0.055800000000000016,-19.379115710254002,-90.95792300805729,9.0420769919427,12.439830977603124,0.26203333333333334,0.26197164735455253,0.2680142857142857,0.2698538595189369,0.30076,0.29806177804263834,38186.0,8126828.333333324,111184.0,10282741.0
2022-05-09,0.2426,0.247,0.1935,0.1943,27186721.0,16305.0,15070195.0,0.23139999999999997,0.2542285714285714,0.28803999999999996,0.22334291183863814,0.24589279597940203,0.283417918080255,20.050869012293347,0.36412107586817977,0.21195892413182013,-0.033249652207245406,-0.0282724611985994,-0.004977191008646006,0.05349999999999999,0.03168571428571428,1057274094.3899987,-0.0905,-42.103694874851016,-99.47540983606558,0.5245901639344231,3.6538701621014646,-19.90931574608409,0.257,0.2663,0.2412,0.2428,9210083.0,7830.0,4698981.0,-5.525291828793781,24.219150025601635,0.3624509658946779,0.22901903410532204,-0.028963411276488493,-0.027028163446437898,-0.0019352478300505953,0.025099999999999983,0.03045,1084460815.3899987,-0.06589999999999999,-29.315866084425046,-98.6050566695728,1.394943330427193,7.328603909306858,0.2532666666666666,0.25238582367727624,0.26407142857142857,0.2630903946392027,0.29573499999999997,0.2927987515623871,27205.0,5498396.333333324,107853.0,10097540.857142856
2022-05-10,0.1941,0.223,0.1882,0.1979,24739355.3,18328.0,13156888.0,0.21166666666666664,0.24425714285714287,0.281105,0.21062145591931908,0.2338945969845515,0.2752733544535641,24.565637065637063,0.3635668948682338,0.19864310513176617,-0.03594172527598949,-0.029806314014077417,-0.006135411261912072,0.0348,0.03072857142857142,1082013449.6899986,-0.06029999999999999,-34.75107154632377,-93.45920431557654,6.540795684423456,2.8201097262617165,1.9577537351880465,0.2426,0.247,0.1935,0.1943,27186721.0,16305.0,15070195.0,-19.90931574608409,20.050869012293347,0.36412107586817977,0.21195892413182013,-0.033249652207245406,-0.0282724611985994,-0.004977191008646006,0.05349999999999999,0.03168571428571428,1057274094.3899987,-0.0905,-42.103694874851016,-99.47540983606558,0.5245901639344231,3.6538701621014646,0.23139999999999997,0.22334291183863814,0.2542285714285714,0.24589279597940203,0.28803999999999996,0.283417918080255,32199.0,8428659.666666657,113081.0,11113641.57142857
2022-05-11,0.1981,0.202,0.1208,0.133,34940894.6,24728.0,15349822.5,0.17506666666666662,0.22201428571428572,0.27158,0.17181072795965954,0.20867094773841363,0.26172351117227227,15.733333333333334,0.3748151143850852,0.16834488561491476,-0.042818514999068275,-0.032408754211075586,-0.010409760787992689,0.08120000000000001,0.033999999999999996,1047072555.0899986,-0.13739999999999997,-57.494407158836694,-93.9121756487026,6.0878243512974075,4.384403399885122,-32.86219081272084,0.1941,0.223,0.1882,0.1979,24739355.3,18328.0,13156888.0,1.9577537351880465,24.565637065637063,0.3635668948682338,0.19864310513176617,-0.03594172527598949,-0.029806314014077417,-0.006135411261912072,0.0348,0.03072857142857142,1082013449.6899986,-0.06029999999999999,-34.75107154632377,-93.45920431557654,6.540795684423456,2.8201097262617165,0.21166666666666664,0.21062145591931908,0.24425714285714287,0.2338945969845515,0.281105,0.2752733544535641,42463.0,10975354.666666657,114970.0,11911592.285714285
2022-05-12,0.133,0.1845,0.131,0.142,34283630.0,23349.0,16658308.0,0.1576333333333333,0.20385714285714288,0.2626,0.15690536397982977,0.19200321080381022,0.25032127201300824,18.8178077066966,0.3780389699775164,0.14716103002248357,-0.047000404212317326,-0.03532708421132394,-0.011673320000993387,0.05349999999999999,0.036514285714285714,1081356185.0899987,-0.1212,-54.00064787819889,-88.74734607218684,11.252653927813157,7.960424654511367,6.7669172932330675,0.1981,0.202,0.1208,0.133,34940894.6,24728.0,15349822.5,-32.86219081272084,15.733333333333334,0.3748151143850852,0.16834488561491476,-0.042818514999068275,-0.032408754211075586,-0.010409760787992689,0.08120000000000001,0.033999999999999996,1047072555.0899986,-0.13739999999999997,-57.494407158836694,-93.9121756487026,6.0878243512974075,4.384403399885122,0.17506666666666662,0.17181072795965954,0.22201428571428572,0.20867094773841363,0.27158,0.26172351117227227,59361.0,14525635.166666657,105377.0,10379481.642857144
2022-05-13,0.142,0.1871,0.1394,0.1593,15976320.0,12281.0,8064232.0,0.14476666666666663,0.18948571428571429,0.25461999999999996,0.1581026819899149,0.18382740810285766,0.24165257944034077,25.930187955504408,0.3756044113490239,0.13363558865097602,-0.04836113901799885,-0.037933895172658924,-0.010427243845339926,0.04769999999999999,0.03764285714285714,1097332505.0899987,-0.1084,-44.06601123595506,-79.09880564603694,20.90119435396308,12.747224211024573,12.183098591549303,0.133,0.1845,0.131,0.142,34283630.0,23349.0,16658308.0,6.7669172932330675,18.8178077066966,0.3780389699775164,0.14716103002248357,-0.047000404212317326,-0.03532708421132394,-0.011673320000993387,0.05349999999999999,0.036514285714285714,1081356185.0899987,-0.1212,-54.00064787819889,-88.74734607218684,11.252653927813157,7.960424654511367,0.1576333333333333,0.15690536397982977,0.20385714285714288,0.19200321080381022,0.2626,0.25032127201300824,66405.0,15055006.166666657,109915.0,10961486.07142857
2022-05-14,0.159,0.1884,0.1452,0.1724,20778876.0,14702.0,9526060.0,0.15789999999999996,0.17738571428571426,0.24606499999999998,0.16525134099495745,0.18097055607714324,0.23505709568411784,32.64563106796116,0.3647627989420202,0.12736720105797977,-0.047831103449595486,-0.039913336828046236,-0.00791776662154925,0.043200000000000016,0.03862857142857142,1118111381.0899987,-0.11630000000000001,-33.23005422153369,-71.9869706840391,28.013029315960914,20.055625865912408,8.42767295597484,0.142,0.1871,0.1394,0.1593,15976320.0,12281.0,8064232.0,12.183098591549303,25.930187955504408,0.3756044113490239,0.13363558865097602,-0.04836113901799885,-0.037933895172658924,-0.010427243845339926,0.04769999999999999,0.03764285714285714,1097332505.0899987,-0.1084,-44.06601123595506,-79.09880564603694,20.90119435396308,12.747224211024573,0.14476666666666663,0.1581026819899149,0.18948571428571429,0.18382740810285766,0.25461999999999996,0.24165257944034077,60358.0,13357454.166666657,110885.0,11216461.357142856
2022-05-15,0.1724,0.1846,0.1686,0.1814,12471504.0,11205.0,5978753.0,0.1710333333333333,0.1686142857142857,0.23835499999999996,0.1733256704974787,0.18107791705785742,0.22994689609515423,31.762295081967224,0.35251067348787185,0.12419932651212805,-0.0461528008994265,-0.04116122964232229,-0.004991571257104206,0.015999999999999986,0.03810714285714285,1130582885.0899987,-0.0877,-32.91420118343195,-67.10097719869708,32.899022801302934,27.271082157075668,5.220417633410677,0.159,0.1884,0.1452,0.1724,20778876.0,14702.0,9526060.0,8.42767295597484,32.64563106796116,0.3647627989420202,0.12736720105797977,-0.047831103449595486,-0.039913336828046236,-0.00791776662154925,0.043200000000000016,0.03862857142857142,1118111381.0899987,-0.11630000000000001,-33.23005422153369,-71.9869706840391,28.013029315960914,20.055625865912408,0.15789999999999996,0.16525134099495745,0.17738571428571426,0.18097055607714324,0.24606499999999998,0.23505709568411784,50332.0,11416199.99999999,117523.0,11789212.357142856
2022-05-16,0.181,0.1875,0.1671,0.1839,14629350.0,9380.0,8663409.0,0.17923333333333327,0.16712857142857143,0.232385,0.17861283524873936,0.18178343779339307,0.22556147741942525,33.430839949853734,0.3447138269698251,0.12005617303017489,-0.04411250344958559,-0.041751484403774956,-0.002361019045810632,0.0204,0.03782857142857143,1145212235.0899987,-0.07600000000000001,-30.129179331306986,-65.74375678610205,34.25624321389794,31.722765110387286,1.602209944751389,0.1724,0.1846,0.1686,0.1814,12471504.0,11205.0,5978753.0,5.220417633410677,31.762295081967224,0.35251067348787185,0.12419932651212805,-0.0461528008994265,-0.04116122964232229,-0.004991571257104206,0.015999999999999986,0.03810714285714285,1130582885.0899987,-0.0877,-32.91420118343195,-67.10097719869708,32.899022801302934,27.271082157075668,0.1710333333333333,0.1733256704974787,0.1686142857142857,0.18107791705785742,0.23835499999999996,0.22994689609515423,38188.0,7856348.333333324,120898.0,11972036.92857143
2022-05-17,0.1843,0.2008,0.178,0.1898,19450188.0,12599.0,11254597.0,0.1850333333333333,0.16597142857142858,0.22623,0.18420641762436968,0.18378757834504478,0.22215562242709902,33.81803074366431,0.33335267635505317,0.11910732364494683,-0.04154061794387448,-0.041709311111794864,0.00016869316792038347,0.022800000000000015,0.037128571428571434,1164662423.0899987,-0.0673,-29.09973851326111,-62.54071661237786,37.45928338762215,34.8715164676077,2.9842647856755318,0.181,0.1875,0.1671,0.1839,14629350.0,9380.0,8663409.0,1.602209944751389,33.430839949853734,0.3447138269698251,0.12005617303017489,-0.04411250344958559,-0.041751484403774956,-0.002361019045810632,0.0204,0.03782857142857143,1145212235.0899987,-0.07600000000000001,-30.129179331306986,-65.74375678610205,34.25624321389794,31.722765110387286,0.17923333333333327,0.17861283524873936,0.16712857142857143,0.18178343779339307,0.232385,0.22556147741942525,35287.0,8056073.99999999,113973.0,11056781.785714285
2022-05-18,0.1896,0.1926,0.1672,0.1679,10361933.0,8496.0,4870138.0,0.1805333333333333,0.17095714285714286,0.21919,0.17605320881218484,0.1798156837587836,0.21698842029118484,25.0,0.3219081919007734,0.1164718080992266,-0.04079921912380022,-0.04152729271419594,0.0007280735903957211,0.025400000000000006,0.03622857142857143,1154300490.0899987,-0.0749,-41.842743332178735,-73.17767653758544,26.822323462414577,32.84595002131158,-11.445147679324894,0.1843,0.2008,0.178,0.1898,19450188.0,12599.0,11254597.0,2.9842647856755318,33.81803074366431,0.33335267635505317,0.11910732364494683,-0.04154061794387448,-0.041709311111794864,0.00016869316792038347,0.022800000000000015,0.037128571428571434,1164662423.0899987,-0.0673,-29.09973851326111,-62.54071661237786,37.45928338762215,34.8715164676077,0.1850333333333333,0.18420641762436968,0.16597142857142858,0.18378757834504478,0.22623,0.22215562242709902,33184.0,8632252.99999999,108244.0,10785025.92857143
2022-05-19,0.1674,0.1834,0.1611,0.1801,12374194.0,8913.0,6387517.0,0.1792666666666666,0.17639999999999997,0.21395499999999998,0.1780766044060924,0.1798867628190877,0.21347523740631008,30.999146029035018,0.31320760648835605,0.11470239351164391,-0.03878018336307196,-0.04097787084397114,0.0021976874808991853,0.022300000000000014,0.034978571428571435,1166674684.0899987,-0.01419999999999999,-33.07320698625046,-60.28131279303416,39.718687206965846,34.66676468566755,7.586618876941468,0.1896,0.1926,0.1672,0.1679,10361933.0,8496.0,4870138.0,-11.445147679324894,25.0,0.3219081919007734,0.1164718080992266,-0.04079921912380022,-0.04152729271419594,0.0007280735903957211,0.025400000000000006,0.03622857142857143,1154300490.0899987,-0.0749,-41.842743332178735,-73.17767653758544,26.822323462414577,32.84595002131158,0.1805333333333333,0.17605320881218484,0.17095714285714286,0.1798156837587836,0.21919,0.21698842029118484,30475.0,8262714.666666657,92012.0,9287928.142857144
2022-05-20,0.18,0.1827,0.1657,0.1681,9829116.0,6505.0,4781287.0,0.1720333333333333,0.17765714285714282,0.20945,0.17308830220304622,0.17694007211431578,0.20915378622475675,30.632911392405063,0.3084255844427556,0.11047441555724444,-0.03771364328428978,-0.04032502533203487,0.002611382047745095,0.017000000000000015,0.034542857142857146,1156845568.0899987,-0.029799999999999993,-35.32127741439015,-68.29758713136731,31.702412868632706,32.7478078460044,-6.611111111111108,0.1674,0.1834,0.1611,0.1801,12374194.0,8913.0,6387517.0,7.586618876941468,30.999146029035018,0.31320760648835605,0.11470239351164391,-0.03878018336307196,-0.04097787084397114,0.0021976874808991853,0.022300000000000014,0.034978571428571435,1166674684.0899987,-0.01419999999999999,-33.07320698625046,-60.28131279303416,39.718687206965846,34.66676468566755,0.1792666666666666,0.1780766044060924,0.17639999999999997,0.1798867628190877,0.21395499999999998,0.21347523740631008,30008.0,7504083.99999999,77576.0,7820672.285714285
2022-05-21,0.1676,0.1738,0.1647,0.1732,4734782.0,3682.0,2177826.0,0.17379999999999995,0.17777142857142855,0.20459,0.1731441511015231,0.17600505408573686,0.20572961610811324,32.46970330129544,0.300461139392502,0.10871886060749798,-0.0360414122449671,-0.039468302714621324,0.003426890469654227,0.009099999999999997,0.03371428571428572,1161580350.0899987,0.040199999999999986,-32.63321664721899,-63.98625429553265,36.013745704467354,35.81161526002199,3.3412887828162257,0.18,0.1827,0.1657,0.1681,9829116.0,6505.0,4781287.0,-6.611111111111108,30.632911392405063,0.3084255844427556,0.11047441555724444,-0.03771364328428978,-0.04032502533203487,0.002611382047745095,0.017000000000000015,0.034542857142857146,1156845568.0899987,-0.029799999999999993,-35.32127741439015,-68.29758713136731,31.702412868632706,32.7478078460044,0.1720333333333333,0.17308830220304622,0.17765714285714282,0.17694007211431578,0.20945,0.20915378622475675,23914.0,5346313.99999999,71800.0,7351680.142857143
2022-05-22,0.173,0.1758,0.1675,0.1735,8080741.0,4277.0,4303391.0,0.17159999999999997,0.17664285714285713,0.20010499999999998,0.17332207555076154,0.17537879056430264,0.2026601288597215,34.62050599201065,0.29277045316633243,0.1074395468336675,-0.034296599752677626,-0.03843396212223259,0.004137362369554962,0.008300000000000002,0.03251428571428572,1169661091.0899987,0.0315,-28.542009884678755,-58.240887480190196,41.75911251980982,36.491757030969985,0.2890173410404627,0.1676,0.1738,0.1647,0.1732,4734782.0,3682.0,2177826.0,3.3412887828162257,32.46970330129544,0.300461139392502,0.10871886060749798,-0.0360414122449671,-0.039468302714621324,0.003426890469654227,0.009099999999999997,0.03371428571428572,1161580350.0899987,0.040199999999999986,-32.63321664721899,-63.98625429553265,36.013745704467354,35.81161526002199,0.17379999999999995,0.1731441511015231,0.17777142857142855,0.17600505408573686,0.20459,0.20572961610811324,19100.0,4448876.666666657,60780.0,6301932.428571428
2022-05-23,0.1733,0.1794,0.1624,0.1644,12394199.0,7332.0,5947964.0,0.17036666666666664,0.17385714285714288,0.19494,0.16886103777538075,0.17263409292322698,0.19901630706355755,41.95804195804195,0.283150189171544,0.10672981082845598,-0.033264662902562775,-0.037400102278298625,0.00413543937573585,0.017000000000000015,0.02990714285714286,1157266892.0899987,0.005099999999999993,-15.38857436953166,-57.338551859099816,42.661448140900184,40.144768788392476,-5.135603000577045,0.173,0.1758,0.1675,0.1735,8080741.0,4277.0,4303391.0,0.2890173410404627,34.62050599201065,0.29277045316633243,0.1074395468336675,-0.034296599752677626,-0.03843396212223259,0.004137362369554962,0.008300000000000002,0.03251428571428572,1169661091.0899987,0.0315,-28.542009884678755,-58.240887480190196,41.75911251980982,36.491757030969985,0.17159999999999997,0.17332207555076154,0.17664285714285713,0.17537879056430264,0.20010499999999998,0.2026601288597215,14464.0,3754167.99999999,53852.0,6062595.0
2022-05-24,0.1646,0.1683,0.1534,0.1637,7338002.0,5477.0,3446747.0,0.16719999999999993,0.17012857142857143,0.18869,0.16628051888769038,0.17040056969242023,0.19565284924798063,40.65573770491803,0.2659641912385645,0.1114158087614355,-0.03213292134873988,-0.036346666092386876,0.004213744743646997,0.014899999999999997,0.028485714285714288,1149928890.0899987,-0.008699999999999986,-17.281455280444657,-47.16748768472906,52.83251231527094,45.751024325327,-0.5467800729040001,0.1733,0.1794,0.1624,0.1644,12394199.0,7332.0,5947964.0,-5.135603000577045,41.95804195804195,0.283150189171544,0.10672981082845598,-0.033264662902562775,-0.037400102278298625,0.00413543937573585,0.017000000000000015,0.02990714285714286,1157266892.0899987,0.005099999999999993,-15.38857436953166,-57.338551859099816,42.661448140900184,40.144768788392476,0.17036666666666664,0.16886103777538075,0.17385714285714288,0.17263409292322698,0.19494,0.19901630706355755,15291.0,4143060.3333333232,51804.0,5674674.285714285
2022-05-25,0.1635,0.1661,0.1572,0.1592,5605866.0,4615.0,2624384.0,0.1624333333333333,0.16888571428571428,0.183195,0.16274025944384518,0.16760042726931518,0.19218114931960154,60.685154975530175,0.25150338663155314,0.11488661336844688,-0.03123901646926336,-0.03532513616776217,0.0040861196984988135,0.008899999999999991,0.023321428571428573,1144323024.0899987,-0.022199999999999998,19.69924812030075,-59.59885386819484,40.40114613180516,45.29836886265878,-2.629969418960244,0.1646,0.1683,0.1534,0.1637,7338002.0,5477.0,3446747.0,-0.5467800729040001,40.65573770491803,0.2659641912385645,0.1114158087614355,-0.03213292134873988,-0.036346666092386876,0.004213744743646997,0.014899999999999997,0.028485714285714288,1149928890.0899987,-0.008699999999999986,-17.281455280444657,-47.16748768472906,52.83251231527094,45.751024325327,0.16719999999999993,0.16628051888769038,0.17012857142857143,0.17040056969242023,0.18869,0.19565284924798063,17086.0,4566033.99999999,44682.0,4559267.142857143
2022-05-26,0.1592,0.1625,0.1392,0.1438,10415678.0,6961.0,4907746.0,0.15556666666666663,0.16369999999999998,0.17739,0.1532701297219226,0.16165032045198638,0.18757342081297282,50.697674418604656,0.237491699774504,0.117288300225496,-0.03141115348426879,-0.0345423396310635,0.0031311861467947094,0.023300000000000015,0.02116428571428572,1133907346.0899987,-0.0401,1.2676056338028374,-92.53246753246749,7.467532467532499,33.56706363820289,-9.673366834170851,0.1635,0.1661,0.1572,0.1592,5605866.0,4615.0,2624384.0,-2.629969418960244,60.685154975530175,0.25150338663155314,0.11488661336844688,-0.03123901646926336,-0.03532513616776217,0.0040861196984988135,0.008899999999999991,0.023321428571428573,1144323024.0899987,-0.022199999999999998,19.69924812030075,-59.59885386819484,40.40114613180516,45.29836886265878,0.1624333333333333,0.16274025944384518,0.16888571428571428,0.16760042726931518,0.183195,0.19218114931960154,17424.0,4006364.99999999,40801.0,4238445.142857143
2022-05-27,0.1437,0.152,0.135,0.1396,29309410.0,7939.0,20484613.0,0.1475333333333333,0.15962857142857143,0.17151500000000003,0.1464350648609613,0.1561377403389898,0.18300452359268968,41.501294219154445,0.2208091877645173,0.12222081223548276,-0.031523099538939475,-0.0339384916126387,0.0024153920736992227,0.016999999999999987,0.018971428571428577,1104597936.0899987,-0.050199999999999995,-12.366603892027616,-93.00911854103344,6.990881458966555,18.286520019434764,-2.8531663187195493,0.1592,0.1625,0.1392,0.1438,10415678.0,6961.0,4907746.0,-9.673366834170851,50.697674418604656,0.237491699774504,0.117288300225496,-0.03141115348426879,-0.0345423396310635,0.0031311861467947094,0.023300000000000015,0.02116428571428572,1133907346.0899987,-0.0401,1.2676056338028374,-92.53246753246749,7.467532467532499,33.56706363820289,0.15556666666666663,0.1532701297219226,0.16369999999999998,0.16165032045198638,0.17739,0.18757342081297282,17053.0,3659625.6666666567,38849.0,4027049.285714286
2022-05-28,0.1397,0.168,0.1385,0.1567,45324657.0,21315.0,27325222.0,0.14669999999999997,0.15727142857142856,0.16721,0.15156753243048066,0.15627830525424236,0.1804993308695764,43.452877397831536,0.20365571449784137,0.13076428550215863,-0.029887466396143703,-0.0331282865693397,0.0032408201731959976,0.0295,0.017992857142857147,1149922593.0899987,-0.011199999999999988,-9.10672853828306,-67.02127659574468,32.97872340425532,15.812379110251483,12.16893342877596,0.1437,0.152,0.135,0.1396,29309410.0,7939.0,20484613.0,-2.8531663187195493,41.501294219154445,0.2208091877645173,0.12222081223548276,-0.031523099538939475,-0.0339384916126387,0.0024153920736992227,0.016999999999999987,0.018971428571428577,1104597936.0899987,-0.050199999999999995,-12.366603892027616,-93.00911854103344,6.990881458966555,18.286520019434764,0.1475333333333333,0.1464350648609613,0.15962857142857143,0.1561377403389898,0.17151500000000003,0.18300452359268968,19515.0,9338914.333333323,40283.0,6270381.571428572
2022-05-29,0.1567,0.1706,0.1546,0.1591,33868099.0,18261.0,18181341.0,0.15179999999999996,0.15521428571428572,0.16545,0.1553337662152403,0.15698372894068177,0.17846129935818816,40.15887025595763,0.19972237647827573,0.1311776235217243,-0.028073936539011468,-0.032117416563274055,0.004043480024262587,0.016000000000000014,0.017992857142857147,1183790692.0899987,-0.02100000000000002,-12.293274531422282,-63.37386018237085,36.62613981762915,25.53191489361703,1.531589023611988,0.1397,0.168,0.1385,0.1567,45324657.0,21315.0,27325222.0,12.16893342877596,43.452877397831536,0.20365571449784137,0.13076428550215863,-0.029887466396143703,-0.0331282865693397,0.0032408201731959976,0.0295,0.017992857142857147,1149922593.0899987,-0.011199999999999988,-9.10672853828306,-67.02127659574468,32.97872340425532,15.812379110251483,0.14669999999999997,0.15156753243048066,0.15727142857142856,0.15627830525424236,0.16721,0.1804993308695764,36215.0,17572526.99999999,57916.0,9862866.714285715
2022-05-30,0.1591,0.1743,0.158,0.1673,18871166.0,13962.0,9587260.0,0.16103333333333328,0.15562857142857145,0.16392,0.16131688310762016,0.15956279670551132,0.17739831846693213,43.02521008403361,0.1946409237798882,0.13319907622011182,-0.025679017858477537,-0.030829736822314754,0.005150718963837217,0.01630000000000001,0.017700000000000004,1202661858.0899987,-0.0007999999999999952,-9.026644915715066,-50.911854103343465,49.088145896656535,39.56433637284703,5.153991200502837,0.1567,0.1706,0.1546,0.1591,33868099.0,18261.0,18181341.0,1.531589023611988,40.15887025595763,0.19972237647827573,0.1311776235217243,-0.028073936539011468,-0.032117416563274055,0.004043480024262587,0.016000000000000014,0.017992857142857147,1183790692.0899987,-0.02100000000000002,-12.293274531422282,-63.37386018237085,36.62613981762915,25.53191489361703,0.15179999999999996,0.1553337662152403,0.15521428571428572,0.15698372894068177,0.16545,0.17846129935818816,47515.0,21997058.666666657,71900.0,11845431.0
2022-05-31,0.167,0.1745,0.162,0.1694,19393055.0,11939.0,10655699.0,0.16526666666666665,0.15644285714285713,0.16574,0.16535844155381008,0.1620220975291335,0.17663657385103385,41.145833333333336,0.19284862360355462,0.13863137639644538,-0.023342497321210465,-0.029332288922093896,0.005989791600883431,0.012499999999999983,0.016964285714285716,1222054913.0899987,-0.003799999999999998,-10.748155953635408,-40.277777777777786,59.72222222222221,48.47883597883598,1.4371257485029851,0.1591,0.1743,0.158,0.1673,18871166.0,13962.0,9587260.0,5.153991200502837,43.02521008403361,0.1946409237798882,0.13319907622011182,-0.025679017858477537,-0.030829736822314754,0.005150718963837217,0.01630000000000001,0.017700000000000004,1202661858.0899987,-0.0007999999999999952,-9.026644915715066,-50.911854103343465,49.088145896656535,39.56433637284703,0.16103333333333328,0.16131688310762016,0.15562857142857145,0.15956279670551132,0.16392,0.17739831846693213,53538.0,18364607.666666657,78530.0,12365330.42857143
2022-06-01,0.1695,0.1739,0.15,0.1531,20039357.0,10247.0,12267631.0,0.16326666666666664,0.15557142857142855,0.166295,0.15922922077690504,0.1597915731468501,0.17439499538903064,43.24817518248176,0.19176196311932991,0.14082803688067008,-0.022546163597468916,-0.0279750638571689,0.005428900259699984,0.023900000000000005,0.01685714285714286,1202015556.0899987,-0.020399999999999974,-8.814770696843343,-62.60330578512395,37.39669421487604,48.735687444584954,-9.675516224188788,0.167,0.1745,0.162,0.1694,19393055.0,11939.0,10655699.0,1.4371257485029851,41.145833333333336,0.19284862360355462,0.13863137639644538,-0.023342497321210465,-0.029332288922093896,0.005989791600883431,0.012499999999999983,0.016964285714285716,1222054913.0899987,-0.003799999999999998,-10.748155953635408,-40.277777777777786,59.72222222222221,48.47883597883598,0.16526666666666665,0.16535844155381008,0.15644285714285713,0.1620220975291335,0.16574,0.17663657385103385,44162.0,12808099.99999999,84992.0,13395180.714285715
2022-06-02,0.1531,0.165,0.15,0.1636,21961102.0,7032.0,16208913.0,0.16203333333333328,0.1584,0.16651,0.1614146103884525,0.16074367986013757,0.17336690059007534,42.354031510658004,0.19180030602706036,0.14121969397293963,-0.0208277122344524,-0.026545593532625603,0.0057178812981732025,0.015000000000000013,0.016335714285714287,1223976658.0899987,-0.0007999999999999952,-9.161576901721268,-40.041928721174024,59.958071278825976,52.3589959053081,6.858262573481372,0.1695,0.1739,0.15,0.1531,20039357.0,10247.0,12267631.0,-9.675516224188788,43.24817518248176,0.19176196311932991,0.14082803688067008,-0.022546163597468916,-0.0279750638571689,0.005428900259699984,0.023900000000000005,0.01685714285714286,1202015556.0899987,-0.020399999999999974,-8.814770696843343,-62.60330578512395,37.39669421487604,48.735687444584954,0.16326666666666664,0.15922922077690504,0.15557142857142855,0.1597915731468501,0.166295,0.17439499538903064,36148.0,10836863.333333323,90624.0,14772787.42857143
2022-06-03,0.1633,0.1659,0.1513,0.1533,26559785.0,6510.0,19160407.0,0.15666666666666662,0.16035714285714286,0.16555499999999998,0.15735730519422625,0.15888275989510317,0.17145576720054437,43.03201506591336,0.19134634697805356,0.1397636530219464,-0.020065646782123775,-0.02524960418252524,0.005183957400401465,0.014600000000000002,0.016164285714285714,1197416873.0899987,-0.01040000000000002,-8.804283164782866,-58.78378378378382,41.21621621621618,46.190327236639426,-6.123698714023275,0.1531,0.165,0.15,0.1636,21961102.0,7032.0,16208913.0,6.858262573481372,42.354031510658004,0.19180030602706036,0.14121969397293963,-0.0208277122344524,-0.026545593532625603,0.0057178812981732025,0.015000000000000013,0.016335714285714287,1223976658.0899987,-0.0007999999999999952,-9.161576901721268,-40.041928721174024,59.958071278825976,52.3589959053081,0.16203333333333328,0.1614146103884525,0.1584,0.16074367986013757,0.16651,0.17336690059007534,29218.0,13044080.99999999,90695.0,16387239.857142856
2022-06-04,0.1532,0.1544,0.1491,0.1529,17077953.0,4576.0,12865390.0,0.15659999999999996,0.15981428571428571,0.16413,0.15512865259711311,0.1573870699213274,0.16968855127668298,39.99999999999999,0.1893788332194249,0.1388811667805751,-0.01927182744731218,-0.02405404883548263,0.00478222138817045,0.005299999999999999,0.015892857142857146,1180338920.0899987,-0.0063,-11.720554272517314,-59.68468468468468,40.31531531531532,47.16320093678585,-0.19582245430809056,0.1633,0.1659,0.1513,0.1533,26559785.0,6510.0,19160407.0,-6.123698714023275,43.03201506591336,0.19134634697805356,0.1397636530219464,-0.020065646782123775,-0.02524960418252524,0.005183957400401465,0.014600000000000002,0.016164285714285714,1197416873.0899987,-0.01040000000000002,-8.804283164782866,-58.78378378378382,41.21621621621618,46.190327236639426,0.15666666666666662,0.15735730519422625,0.16035714285714286,0.15888275989510317,0.16555499999999998,0.17145576720054437,23789.0,15878983.666666657,89266.0,16198067.57142857
2022-06-05,0.153,0.1537,0.1439,0.1469,22378162.0,6330.0,16022552.0,0.15103333333333332,0.15807142857142858,0.16228,0.15101432629855654,0.15476530244099554,0.16751821305985604,37.593283582089555,0.1868423245941549,0.13771767540584512,-0.01890889973545337,-0.02302501901547678,0.004116119280023409,0.009800000000000003,0.016000000000000004,1157960758.0899987,0.0030999999999999917,-15.33141210374639,-73.1981981981982,26.80180180180179,36.11111111111112,-3.9869281045751594,0.1532,0.1544,0.1491,0.1529,17077953.0,4576.0,12865390.0,-0.19582245430809056,39.99999999999999,0.1893788332194249,0.1388811667805751,-0.01927182744731218,-0.02405404883548263,0.00478222138817045,0.005299999999999999,0.015892857142857146,1180338920.0899987,-0.0063,-11.720554272517314,-59.68468468468468,40.31531531531532,47.16320093678585,0.15659999999999996,0.15512865259711311,0.15981428571428571,0.1573870699213274,0.16413,0.16968855127668298,18118.0,16078236.666666657,72527.0,14132377.285714285
2022-06-06,0.1469,0.1573,0.1468,0.149,24030152.0,7697.0,15154327.0,0.14959999999999998,0.15545714285714288,0.16024,0.15000716314927826,0.15332397683074667,0.16575457372082214,42.315369261477045,0.1817683802895074,0.1387116197104926,-0.01824154725766708,-0.022068324663914844,0.0038267774062477646,0.010499999999999982,0.015535714285714288,1181990910.0899987,0.009399999999999992,-9.36739659367396,-64.55696202531648,35.44303797468352,34.186718363933565,1.4295439074200074,0.153,0.1537,0.1439,0.1469,22378162.0,6330.0,16022552.0,-3.9869281045751594,37.593283582089555,0.1868423245941549,0.13771767540584512,-0.01890889973545337,-0.02302501901547678,0.004116119280023409,0.009800000000000003,0.016000000000000004,1157960758.0899987,0.0030999999999999917,-15.33141210374639,-73.1981981981982,26.80180180180179,36.11111111111112,0.15103333333333332,0.15101432629855654,0.15807142857142858,0.15476530244099554,0.16228,0.16751821305985604,17416.0,16016116.333333323,60596.0,13823978.857142856
2022-06-07,0.1488,0.1649,0.1391,0.1526,52582158.0,23647.0,30023353.0,0.14949999999999997,0.15305714285714284,0.159475,0.15130358157463913,0.15314298262306,0.16450175717598195,44.61687681862269,0.18094457455502674,0.13800542544497327,-0.01722363238467023,-0.021099386208065923,0.0038757538233956945,0.02579999999999999,0.016314285714285715,1234573068.0899987,-0.0040999999999999925,-6.7806963958460535,-55.443037974683506,44.55696202531649,35.60060060060062,2.5537634408602328,0.1469,0.1573,0.1468,0.149,24030152.0,7697.0,15154327.0,1.4295439074200074,42.315369261477045,0.1817683802895074,0.1387116197104926,-0.01824154725766708,-0.022068324663914844,0.0038267774062477646,0.010499999999999982,0.015535714285714288,1181990910.0899987,0.009399999999999992,-9.36739659367396,-64.55696202531648,35.44303797468352,34.186718363933565,0.14959999999999998,0.15000716314927826,0.15545714285714288,0.15332397683074667,0.16024,0.16575457372082214,18603.0,14680756.333333323,54331.0,14619274.142857144
2022-06-08,0.1529,0.1741,0.1492,0.1503,37193733.0,21720.0,19680197.0,0.15063333333333329,0.15265714285714285,0.157985,0.15080179078731956,0.152432236967295,0.16314920887350748,45.589692765113966,0.1774724615558215,0.13849753844417848,-0.01641331580457675,-0.020162172127368087,0.003748856322791337,0.024900000000000005,0.01745714285714286,1197379335.0899987,-0.008800000000000002,-5.590452261306544,-61.265822784810155,38.73417721518984,39.578059071729975,-1.7004578155657417,0.1488,0.1649,0.1391,0.1526,52582158.0,23647.0,30023353.0,2.5537634408602328,44.61687681862269,0.18094457455502674,0.13800542544497327,-0.01722363238467023,-0.021099386208065923,0.0038757538233956945,0.02579999999999999,0.016314285714285715,1234573068.0899987,-0.0040999999999999925,-6.7806963958460535,-55.443037974683506,44.55696202531649,35.60060060060062,0.14949999999999997,0.15130358157463913,0.15305714285714284,0.15314298262306,0.159475,0.16450175717598195,37674.0,20400077.333333325,66039.0,17386081.85714286
2022-06-09,0.1502,0.1678,0.1491,0.1544,31216411.0,17095.0,17658732.0,0.1524333333333333,0.15134285714285714,0.15730000000000002,0.15260089539365979,0.15292417772547123,0.1623159508855544,55.91517857142856,0.17624601749556473,0.1383539825044353,-0.015264340526103759,-0.019182605807115224,0.003918265281011465,0.018699999999999994,0.017128571428571427,1228595746.0899987,-0.012899999999999995,7.371349095966617,-50.88607594936706,49.11392405063294,44.13502109704644,2.796271637816251,0.1529,0.1741,0.1492,0.1503,37193733.0,21720.0,19680197.0,-1.7004578155657417,45.589692765113966,0.1774724615558215,0.13849753844417848,-0.01641331580457675,-0.020162172127368087,0.003748856322791337,0.024900000000000005,0.01745714285714286,1197379335.0899987,-0.008800000000000002,-5.590452261306544,-61.265822784810155,38.73417721518984,39.578059071729975,0.15063333333333329,0.15080179078731956,0.15265714285714285,0.152432236967295,0.157985,0.16314920887350748,53064.0,21619292.333333325,77512.0,18445019.85714286
2022-06-10,0.1544,0.1679,0.1435,0.1441,37802988.0,21767.0,17807917.0,0.14959999999999996,0.15002857142857143,0.155845,0.1483504476968299,0.15071813329410344,0.1605810984202635,52.35109717868339,0.17410689302446386,0.13758310697553616,-0.015011846042672194,-0.01834845385422662,0.003336607811554426,0.024400000000000005,0.01765714285714286,1190792758.0899987,-0.02529999999999999,3.2234957020057298,-84.44444444444446,15.555555555555548,34.46788560712613,-6.670984455958551,0.1502,0.1678,0.1491,0.1544,31216411.0,17095.0,17658732.0,2.796271637816251,55.91517857142856,0.17624601749556473,0.1383539825044353,-0.015264340526103759,-0.019182605807115224,0.003918265281011465,0.018699999999999994,0.017128571428571427,1228595746.0899987,-0.012899999999999995,7.371349095966617,-50.88607594936706,49.11392405063294,44.13502109704644,0.1524333333333333,0.15260089539365979,0.15134285714285714,0.15292417772547123,0.15730000000000002,0.1623159508855544,62462.0,22454093.99999999,87575.0,18652136.85714286
2022-06-11,0.1443,0.1501,0.1338,0.1363,21182798.0,10271.0,12237266.0,0.1449333333333333,0.14765714285714285,0.15398499999999998,0.14232522384841495,0.14711359997057757,0.15826861285642888,38.19444444444444,0.1722533246140788,0.13571667538592116,-0.015265169783087063,-0.01773179703999871,0.0024666272569116472,0.01630000000000001,0.016714285714285713,1169609960.0899987,-0.01680000000000001,-13.018506700701982,-93.85749385749385,6.14250614250615,23.603995249564903,-5.5440055440055485,0.1544,0.1679,0.1435,0.1441,37802988.0,21767.0,17807917.0,-6.670984455958551,52.35109717868339,0.17410689302446386,0.13758310697553616,-0.015011846042672194,-0.01834845385422662,0.003336607811554426,0.024400000000000005,0.01765714285714286,1190792758.0899987,-0.02529999999999999,3.2234957020057298,-84.44444444444446,15.555555555555548,34.46788560712613,0.14959999999999996,0.1483504476968299,0.15002857142857143,0.15071813329410344,0.155845,0.1605810984202635,60582.0,18382281.99999999,102832.0,18458924.0
2022-06-12,0.1361,0.1383,0.1132,0.1135,53623322.0,20414.0,27256149.0,0.13129999999999994,0.14288571428571428,0.15144,0.12791261192420747,0.13871019997793319,0.15400493544153088,28.651685393258433,0.17651356754569403,0.12636643245430595,-0.017108484169074928,-0.017607134465813953,0.0004986502967390255,0.02510000000000001,0.017364285714285714,1115986638.0899987,-0.05009999999999999,-28.661219358893774,-99.510603588907,0.4893964110929994,7.395819369718256,-16.605437178545184,0.1443,0.1501,0.1338,0.1363,21182798.0,10271.0,12237266.0,-5.5440055440055485,38.19444444444444,0.1722533246140788,0.13571667538592116,-0.015265169783087063,-0.01773179703999871,0.0024666272569116472,0.01630000000000001,0.016714285714285713,1169609960.0899987,-0.01680000000000001,-13.018506700701982,-93.85749385749385,6.14250614250615,23.603995249564903,0.1449333333333333,0.14232522384841495,0.14765714285714285,0.14711359997057757,0.15398499999999998,0.15826861285642888,49133.0,15901304.99999999,108527.0,18369192.0
2022-06-13,0.1136,0.1179,0.1036,0.1098,44535874.0,25083.0,22793501.4,0.11986666666666664,0.1372857142857143,0.148745,0.11885630596210373,0.13148264998344988,0.14979494158995652,21.896383186705762,0.1792652935075047,0.11822470649249527,-0.018652864566426397,-0.017816280485936444,-0.0008365840804899528,0.014300000000000007,0.017221428571428575,1071450764.0899987,-0.0435,-34.36939629408249,-91.25528913963329,8.74471086036671,5.12553780465531,-3.3450704225352212,0.1361,0.1383,0.1132,0.1135,53623322.0,20414.0,27256149.0,-16.605437178545184,28.651685393258433,0.17651356754569403,0.12636643245430595,-0.017108484169074928,-0.017607134465813953,0.0004986502967390255,0.02510000000000001,0.017364285714285714,1115986638.0899987,-0.05009999999999999,-28.661219358893774,-99.510603588907,0.4893964110929994,7.395819369718256,0.13129999999999994,0.12791261192420747,0.14288571428571428,0.13871019997793319,0.15144,0.15400493544153088,52452.0,19100443.99999999,122611.0,19973991.57142857
2022-06-14,0.1099,0.1147,0.1019,0.1093,24935223.0,18983.0,11970981.0,0.11086666666666663,0.1311,0.14625000000000002,0.11407815298105187,0.12593698748758742,0.14593828048615115,20.15888778550149,0.18103254250558207,0.11146745749441797,-0.01969016699094478,-0.018191057786938112,-0.0014991092040066677,0.012799999999999992,0.017242857142857143,1046515541.0899987,-0.043600000000000014,-35.47815820543093,-89.75069252077563,10.249307479224361,6.49447158356138,-0.545950864422205,0.1136,0.1179,0.1036,0.1098,44535874.0,25083.0,22793501.4,-3.3450704225352212,21.896383186705762,0.1792652935075047,0.11822470649249527,-0.018652864566426397,-0.017816280485936444,-0.0008365840804899528,0.014300000000000007,0.017221428571428575,1071450764.0899987,-0.0435,-34.36939629408249,-91.25528913963329,8.74471086036671,5.12553780465531,0.11986666666666664,0.11885630596210373,0.1372857142857143,0.13148264998344988,0.148745,0.14979494158995652,55768.0,20762305.466666657,139997.0,21065302.2
2022-06-15,0.1093,0.1098,0.0852,0.1079,115517011.0,40716.0,68606942.0,0.10899999999999997,0.12504285714285715,0.144455,0.11098907649052593,0.12142774061569056,0.1423155871065177,23.659673659673658,0.1832444437619712,0.10566555623802881,-0.020390159864958374,-0.018630878202542167,-0.0017592816624162066,0.024599999999999997,0.017292857142857145,930998530.0899987,-0.03900000000000001,-29.523187459177013,-74.46569178852643,25.53430821147356,14.84277551702157,-1.2808783165599256,0.1099,0.1147,0.1019,0.1093,24935223.0,18983.0,11970981.0,-0.545950864422205,20.15888778550149,0.18103254250558207,0.11146745749441797,-0.01969016699094478,-0.018191057786938112,-0.0014991092040066677,0.012799999999999992,0.017242857142857143,1046515541.0899987,-0.043600000000000014,-35.47815820543093,-89.75069252077563,10.249307479224361,6.49447158356138,0.11086666666666663,0.11407815298105187,0.1311,0.12593698748758742,0.14625000000000002,0.14593828048615115,64480.0,20673543.79999999,135333.0,18486391.914285716
2022-06-16,0.1076,0.1091,0.0808,0.0828,83752966.0,25175.0,45886031.0,0.09999999999999996,0.11481428571428572,0.141615,0.09689453824526296,0.11177080546176792,0.136647435953516,9.76095617529883,0.18921731197387184,0.09401268802612814,-0.022708500038445295,-0.019446402569722795,-0.0032620974687225003,0.028300000000000006,0.018242857142857144,847245564.0899987,-0.0662,-49.38875305623471,-97.85637727759914,2.1436227224008593,12.642412804366286,-23.04832713754647,0.1093,0.1098,0.0852,0.1079,115517011.0,40716.0,68606942.0,-1.2808783165599256,23.659673659673658,0.1832444437619712,0.10566555623802881,-0.020390159864958374,-0.018630878202542167,-0.0017592816624162066,0.024599999999999997,0.017292857142857145,930998530.0899987,-0.03900000000000001,-29.523187459177013,-74.46569178852643,25.53430821147356,14.84277551702157,0.10899999999999997,0.11098907649052593,0.12504285714285715,0.12142774061569056,0.144455,0.1423155871065177,84782.0,34457141.46666666,154329.0,25475926.914285716
2022-06-17,0.0828,0.0848,0.0761,0.08,83889930.0,23189.0,48008624.0,0.09023333333333329,0.10565714285714285,0.13777999999999999,0.08844726912263148,0.10382810409632594,0.13125244205318115,10.548977395048468,0.19214351717829353,0.08341648282170645,-0.024489438920368686,-0.020455009839851972,-0.004034429080516714,0.0087,0.01782142857142857,763355634.0899987,-0.07260000000000001,-47.81474233529027,-96.0204081632653,3.9795918367346945,10.552507590203062,-3.381642512077291,0.1076,0.1091,0.0808,0.0828,83752966.0,25175.0,45886031.0,-23.04832713754647,9.76095617529883,0.18921731197387184,0.09401268802612814,-0.022708500038445295,-0.019446402569722795,-0.0032620974687225003,0.028300000000000006,0.018242857142857144,847245564.0899987,-0.0662,-49.38875305623471,-97.85637727759914,2.1436227224008593,12.642412804366286,0.09999999999999996,0.09689453824526296,0.11481428571428572,0.11177080546176792,0.141615,0.136647435953516,84874.0,42154651.33333332,162409.0,29508398.2
2022-06-18,0.08,0.091,0.0662,0.075,103778997.0,29456.0,51868023.0,0.07926666666666662,0.0969,0.133575,0.08172363456131573,0.09662107807224446,0.12589506661954486,10.051282051282072,0.1936998831927508,0.0734501168072492,-0.026004539880048083,-0.021564915847891195,-0.004439624032156888,0.024800000000000003,0.019214285714285715,659576637.0899987,-0.07529999999999999,-50.94833224329627,-91.84430027803522,8.155699721964783,4.759638093700137,-6.250000000000005,0.0828,0.0848,0.0761,0.08,83889930.0,23189.0,48008624.0,-3.381642512077291,10.548977395048468,0.19214351717829353,0.08341648282170645,-0.024489438920368686,-0.020455009839851972,-0.004034429080516714,0.0087,0.01782142857142857,763355634.0899987,-0.07260000000000001,-47.81474233529027,-96.0204081632653,3.9795918367346945,10.552507590203062,0.09023333333333329,0.08844726912263148,0.10565714285714285,0.10382810409632594,0.13777999999999999,0.13125244205318115,89080.0,54167198.99999999,163831.0,33822784.91428571
2022-06-19,0.075,0.0807,0.0706,0.0792,34594670.0,10719.0,15603367.0,0.07806666666666663,0.09199999999999998,0.12917,0.08046181728065788,0.09226580855418334,0.12144791741768345,14.629049111807774,0.19175037694790492,0.06658962305209509,-0.02656019402361398,-0.022563971483035752,-0.003996222540578229,0.010099999999999998,0.019235714285714283,694171307.0899987,-0.0752,-46.0857726344452,-87.95180722891565,12.048192771084347,8.0611614432613,5.600000000000013,0.08,0.091,0.0662,0.075,103778997.0,29456.0,51868023.0,-6.250000000000005,10.051282051282072,0.1936998831927508,0.0734501168072492,-0.026004539880048083,-0.021564915847891195,-0.004439624032156888,0.024800000000000003,0.019214285714285715,659576637.0899987,-0.07529999999999999,-50.94833224329627,-91.84430027803522,8.155699721964783,4.759638093700137,0.07926666666666662,0.08172363456131573,0.0969,0.09662107807224446,0.133575,0.12589506661954486,77820.0,48587559.33333332,183016.0,39484321.62857143
2022-06-20,0.0791,0.0828,0.0743,0.0801,49345642.0,11965.0,28086390.0,0.07809999999999996,0.08775714285714287,0.124705,0.08028090864032894,0.08922435641563752,0.11751002052076122,13.544973544973573,0.1879391172069462,0.061470882793053794,-0.026621060443517627,-0.02337538927513213,-0.0032456711683854986,0.008499999999999994,0.01909285714285714,743516949.0899987,-0.064,-46.24161073825503,-87.11770157553289,12.882298424467105,11.02873030583877,1.2642225031605574,0.075,0.0807,0.0706,0.0792,34594670.0,10719.0,15603367.0,5.600000000000013,14.629049111807774,0.19175037694790492,0.06658962305209509,-0.02656019402361398,-0.022563971483035752,-0.003996222540578229,0.010099999999999998,0.019235714285714283,694171307.0899987,-0.0752,-46.0857726344452,-87.95180722891565,12.048192771084347,8.0611614432613,0.07806666666666663,0.08046181728065788,0.09199999999999998,0.09226580855418334,0.12917,0.12144791741768345,63364.0,38493337.99999999,173321.0,37819638.48571429
2022-06-21,0.0802,0.0876,0.0799,0.0814,51606891.0,13077.0,29750615.0,0.08023333333333331,0.08377142857142858,0.12112,0.08084045432016447,0.08726826731172813,0.1140709709473554,11.388286334056417,0.18569167702389808,0.056548322976101933,-0.026261670197647052,-0.023952645459635116,-0.002309024738011936,0.0076999999999999985,0.0178,795123840.0899987,-0.054900000000000004,-46.65792922673657,-85.91288229842446,14.087117701575536,13.005869632375687,1.496259351620956,0.0791,0.0828,0.0743,0.0801,49345642.0,11965.0,28086390.0,1.2642225031605574,13.544973544973573,0.1879391172069462,0.061470882793053794,-0.026621060443517627,-0.02337538927513213,-0.0032456711683854986,0.008499999999999994,0.01909285714285714,743516949.0899987,-0.064,-46.24161073825503,-87.11770157553289,12.882298424467105,11.02873030583877,0.07809999999999996,0.08028090864032894,0.08775714285714287,0.08922435641563752,0.124705,0.11751002052076122,52140.0,31852593.333333325,160203.0,38575765.428571425
2022-06-22,0.0814,0.088,0.0789,0.0814,51972525.0,14687.0,27622056.0,0.08096666666666663,0.07998571428571428,0.11700999999999999,0.08112022716008224,0.08580120048379611,0.11095944990475012,11.679644048943288,0.18065443664440603,0.05336556335559395,-0.025680818350339377,-0.02429828003777597,-0.0013825383125634083,0.009099999999999997,0.01667142857142857,743151315.0899987,-0.032100000000000004,-45.8416500332668,-85.05408062930186,14.945919370698139,13.97177849891362,0.0,0.0802,0.0876,0.0799,0.0814,51606891.0,13077.0,29750615.0,1.496259351620956,11.388286334056417,0.18569167702389808,0.056548322976101933,-0.026261670197647052,-0.023952645459635116,-0.002309024738011936,0.0076999999999999985,0.0178,795123840.0899987,-0.054900000000000004,-46.65792922673657,-85.91288229842446,14.087117701575536,13.005869632375687,0.08023333333333331,0.08084045432016447,0.08377142857142858,0.08726826731172813,0.12112,0.1140709709473554,35761.0,24480123.99999999,154297.0,41115713.14285714
2022-06-23,0.0816,0.0844,0.0795,0.0819,65262577.0,16360.0,36504346.0,0.08156666666666663,0.07985714285714286,0.11344000000000001,0.08151011358004112,0.08482590036284707,0.10819188324715488,7.995365005793744,0.17652101390897082,0.050358986091029206,-0.02489319005572123,-0.02441726204136502,-0.00047592801435620766,0.004900000000000002,0.015685714285714285,808413892.0899987,-0.027899999999999994,-46.9559585492228,-84.56243854473942,15.437561455260576,14.82353284251144,0.3676470588235229,0.0814,0.088,0.0789,0.0814,51972525.0,14687.0,27622056.0,0.0,11.679644048943288,0.18065443664440603,0.05336556335559395,-0.025680818350339377,-0.02429828003777597,-0.0013825383125634083,0.009099999999999997,0.01667142857142857,743151315.0899987,-0.032100000000000004,-45.8416500332668,-85.05408062930186,14.945919370698139,13.97177849891362,0.08096666666666663,0.08112022716008224,0.07998571428571428,0.08580120048379611,0.11700999999999999,0.11095944990475012,39729.0,28486353.666666657,128268.0,35260729.428571425
2022-06-24,0.0818,0.0913,0.0818,0.09,68706183.0,18872.0,32455758.0,0.08443333333333329,0.08128571428571428,0.11029499999999999,0.08575505679002056,0.08611942527213529,0.10645932293790203,17.835909631391203,0.17133129550042586,0.04925870449957413,-0.02334626543679566,-0.02420306272045115,0.0008567972836554909,0.009500000000000008,0.014621428571428575,877120075.0899987,-0.019299999999999998,-37.54337265787648,-71.63289630512514,28.367103694874846,19.58352817361121,10.02444987775061,0.0816,0.0844,0.0795,0.0819,65262577.0,16360.0,36504346.0,0.3676470588235229,7.995365005793744,0.17652101390897082,0.050358986091029206,-0.02489319005572123,-0.02441726204136502,-0.00047592801435620766,0.004900000000000002,0.015685714285714285,808413892.0899987,-0.027899999999999994,-46.9559585492228,-84.56243854473942,15.437561455260576,14.82353284251144,0.08156666666666663,0.08151011358004112,0.07985714285714286,0.08482590036284707,0.11344000000000001,0.10819188324715488,44124.0,31292338.99999999,119453.0,33920488.71428572
2022-06-25,0.09,0.0957,0.0864,0.0887,79057335.0,20732.0,37798082.0,0.08686666666666663,0.08324285714285715,0.107385,0.08722752839501027,0.08676456895410146,0.10476795884857804,19.329896907216508,0.16659532182415943,0.04817467817584055,-0.021971936855736632,-0.02375683754750825,0.0017849006917716181,0.009299999999999989,0.014121428571428571,798062740.0899987,-0.019199999999999995,-34.92296404988995,-68.79334257975034,31.206657420249655,25.003774190128382,-1.4444444444444398,0.0818,0.0913,0.0818,0.09,68706183.0,18872.0,32455758.0,10.02444987775061,17.835909631391203,0.17133129550042586,0.04925870449957413,-0.02334626543679566,-0.02420306272045115,0.0008567972836554909,0.009500000000000008,0.014621428571428575,877120075.0899987,-0.019299999999999998,-37.54337265787648,-71.63289630512514,28.367103694874846,19.58352817361121,0.08443333333333329,0.08575505679002056,0.08128571428571428,0.08611942527213529,0.11029499999999999,0.10645932293790203,49919.0,32194053.333333325,115136.0,31698650.714285713
2022-06-26,0.0886,0.0946,0.0819,0.0824,57245485.0,16656.0,27184921.0,0.0870333333333333,0.0837,0.10405499999999998,0.08481376419750514,0.0856734267155761,0.10263767705347536,24.54991816693945,0.16085290489088636,0.04725709510911361,-0.021147355353701963,-0.023234941108746993,0.0020875857550450294,0.012700000000000003,0.013235714285714283,740817255.0899987,-0.0003999999999999976,-27.400881057268723,-68.66537717601547,31.33462282398453,30.302794646369705,-6.997742663656882,0.09,0.0957,0.0864,0.0887,79057335.0,20732.0,37798082.0,-1.4444444444444398,19.329896907216508,0.16659532182415943,0.04817467817584055,-0.021971936855736632,-0.02375683754750825,0.0017849006917716181,0.009299999999999989,0.014121428571428571,798062740.0899987,-0.019199999999999995,-34.92296404988995,-68.79334257975034,31.206657420249655,25.003774190128382,0.08686666666666663,0.08722752839501027,0.08324285714285715,0.08676456895410146,0.107385,0.10476795884857804,55964.0,35586061.99999999,106412.0,29688659.14285714
2022-06-27,0.0823,0.086,0.0785,0.0823,66400078.0,17143.0,34714257.0,0.08446666666666663,0.08401428571428572,0.10054,0.08355688209875256,0.08483007003668207,0.10070075542933485,26.08695652173914,0.15324187852433846,0.04783812147566154,-0.020268297420726625,-0.02264161237114292,0.0023733149504162956,0.007499999999999993,0.01275,674417177.0899987,0.0022999999999999965,-25.045537340619305,-66.8041237113402,33.1958762886598,31.912385510964686,0.0,0.0886,0.0946,0.0819,0.0824,57245485.0,16656.0,27184921.0,-6.997742663656882,24.54991816693945,0.16085290489088636,0.04725709510911361,-0.021147355353701963,-0.023234941108746993,0.0020875857550450294,0.012700000000000003,0.013235714285714283,740817255.0899987,-0.0003999999999999976,-27.400881057268723,-68.66537717601547,31.33462282398453,30.302794646369705,0.0870333333333333,0.08481376419750514,0.0837,0.0856734267155761,0.10405499999999998,0.10263767705347536,56260.0,32479586.99999999,112349.0,31343166.85714286
2022-06-28,0.0822,0.0847,0.0754,0.0761,38182491.0,10587.0,17002666.0,0.08026666666666664,0.08325714285714285,0.09683,0.07982844104937628,0.08264755252751155,0.09835782634082677,23.734177215189874,0.14503797488071182,0.04862202511928817,-0.0198431859641707,-0.022081927089748477,0.0022387411255777763,0.009300000000000003,0.012499999999999999,636234686.0899987,0.0011000000000000038,-30.375114364135403,-77.29357798165137,22.706422018348636,29.078973710331013,-7.42092457420924,0.0823,0.086,0.0785,0.0823,66400078.0,17143.0,34714257.0,0.0,26.08695652173914,0.15324187852433846,0.04783812147566154,-0.020268297420726625,-0.02264161237114292,0.0023733149504162956,0.007499999999999993,0.01275,674417177.0899987,0.0022999999999999965,-25.045537340619305,-66.8041237113402,33.1958762886598,31.912385510964686,0.08446666666666663,0.08355688209875256,0.08401428571428572,0.08483007003668207,0.10054,0.10070075542933485,54531.0,33232419.99999999,117527.0,32290005.0
2022-06-29,0.076,0.0802,0.0727,0.0767,37197668.0,10850.0,17512589.0,0.07836666666666663,0.08258571428571428,0.092945,0.07826422052468815,0.08116066439563366,0.09629517621312898,25.000000000000014,0.13354079833060672,0.052349201669393275,-0.019236125011436914,-0.021512766674086164,0.002276641662649251,0.007499999999999993,0.011278571428571428,673432354.0899987,-0.0025000000000000022,-28.915662650602403,-75.5244755244755,24.475524475524495,26.792607594177667,0.9210526315789554,0.0822,0.0847,0.0754,0.0761,38182491.0,10587.0,17002666.0,-7.42092457420924,23.734177215189874,0.14503797488071182,0.04862202511928817,-0.0198431859641707,-0.022081927089748477,0.0022387411255777763,0.009300000000000003,0.012499999999999999,636234686.0899987,0.0011000000000000038,-30.375114364135403,-77.29357798165137,22.706422018348636,29.078973710331013,0.08026666666666664,0.07982844104937628,0.08325714285714285,0.08264755252751155,0.09683,0.09835782634082677,44386.0,26300614.666666657,115037.0,30468869.42857143
2022-06-30,0.0769,0.077,0.0688,0.0746,27925702.0,9124.0,12552548.0,0.07579999999999996,0.08154285714285714,0.08947,0.07643211026234407,0.07952049829672525,0.09422896895473575,39.59390862944163,0.12289322545766615,0.05604677454233383,-0.018708813723552167,-0.020951976083979366,0.0022431623604271984,0.008199999999999999,0.009842857142857141,645506652.0899987,-0.005500000000000005,-9.903381642512077,-71.52542372881354,28.474576271186457,25.218840921686553,-2.99089726918075,0.076,0.0802,0.0727,0.0767,37197668.0,10850.0,17512589.0,0.9210526315789554,25.000000000000014,0.13354079833060672,0.052349201669393275,-0.019236125011436914,-0.021512766674086164,0.002276641662649251,0.007499999999999993,0.011278571428571428,673432354.0899987,-0.0025000000000000022,-28.915662650602403,-75.5244755244755,24.475524475524495,26.792607594177667,0.07836666666666663,0.07826422052468815,0.08258571428571428,0.08116066439563366,0.092945,0.09629517621312898,38580.0,23076503.99999999,111200.0,29024659.85714286
2022-07-01,0.0745,0.0782,0.0727,0.0739,21977725.0,8253.0,10053883.0,0.07506666666666663,0.07924285714285714,0.08635,0.07516605513117203,0.07811537372254393,0.09229287667333233,41.82305630026809,0.11214665420970316,0.06055334579029684,-0.018138312700582054,-0.020389243407299903,0.002250930706717849,0.005500000000000005,0.009614285714285714,623528927.0899987,-0.007500000000000007,-7.625000000000015,-73.89830508474576,26.10169491525423,26.35059855398842,-0.8053691275167829,0.0769,0.077,0.0688,0.0746,27925702.0,9124.0,12552548.0,-2.99089726918075,39.59390862944163,0.12289322545766615,0.05604677454233383,-0.018708813723552167,-0.020951976083979366,0.0022431623604271984,0.008199999999999999,0.009842857142857141,645506652.0899987,-0.005500000000000005,-9.903381642512077,-71.52542372881354,28.474576271186457,25.218840921686553,0.07579999999999996,0.07643211026234407,0.08154285714285714,0.07952049829672525,0.08947,0.09422896895473575,30561.0,15689267.666666657,103964.0,25602974.42857143
2022-07-02,0.0739,0.0831,0.0723,0.0762,31759053.0,9039.0,15730835.0,0.07489999999999997,0.07745714285714286,0.084485,0.07568302756558601,0.07763653029190795,0.09076022175206258,51.73410404624278,0.10722983399979277,0.061740166000207236,-0.017301158762920765,-0.019771626478424075,0.00247046771550331,0.01079999999999999,0.008614285714285711,655287980.0899987,-0.005199999999999996,1.6000000000000014,-72.49070631970258,27.509293680297418,27.361854955579393,3.1123139377537354,0.0745,0.0782,0.0727,0.0739,21977725.0,8253.0,10053883.0,-0.8053691275167829,41.82305630026809,0.11214665420970316,0.06055334579029684,-0.018138312700582054,-0.020389243407299903,0.002250930706717849,0.005500000000000005,0.009614285714285714,623528927.0899987,-0.007500000000000007,-7.625000000000015,-73.89830508474576,26.10169491525423,26.35059855398842,0.07506666666666663,0.07516605513117203,0.07924285714285714,0.07811537372254393,0.08635,0.09229287667333233,28227.0,13373006.666666657,93345.0,22402706.57142857
2022-07-03,0.0762,0.0784,0.0712,0.0741,32733138.0,8348.0,17424440.0,0.0747333333333333,0.07627142857142857,0.08270000000000001,0.074891513782793,0.07675239771893097,0.08917353396615187,42.153846153846146,0.10249143887203441,0.06290856112796561,-0.016615626090816668,-0.019140426400902594,0.0025248003100859263,0.007199999999999998,0.008407142857142854,622554842.0899987,-0.007800000000000001,-6.439393939393945,-80.29739776951673,19.702602230483272,24.437863608678327,-2.7559055118110294,0.0739,0.0831,0.0723,0.0762,31759053.0,9039.0,15730835.0,3.1123139377537354,51.73410404624278,0.10722983399979277,0.061740166000207236,-0.017301158762920765,-0.019771626478424075,0.00247046771550331,0.01079999999999999,0.008614285714285711,655287980.0899987,-0.005199999999999996,1.6000000000000014,-72.49070631970258,27.509293680297418,27.361854955579393,0.07489999999999997,0.07568302756558601,0.07745714285714286,0.07763653029190795,0.084485,0.09076022175206258,26416.0,12779088.666666657,81652.0,19250242.714285713
2022-07-04,0.0739,0.0775,0.0725,0.077,15652859.0,4947.0,7891530.0,0.07576666666666663,0.07551428571428571,0.081085,0.0759457568913965,0.07681429828919822,0.0880141497788993,45.50724637681159,0.09653165182573406,0.06563834817426595,-0.01565783694781983,-0.018443908510286044,0.0027860715624662136,0.0050000000000000044,0.008157142857142856,638207701.0899987,-0.012999999999999998,-3.8701622971285987,-69.51672862453532,30.48327137546469,25.89838909541515,4.194857916102849,0.0762,0.0784,0.0712,0.0741,32733138.0,8348.0,17424440.0,-2.7559055118110294,42.153846153846146,0.10249143887203441,0.06290856112796561,-0.016615626090816668,-0.019140426400902594,0.0025248003100859263,0.007199999999999998,0.008407142857142854,622554842.0899987,-0.007800000000000001,-6.439393939393945,-80.29739776951673,19.702602230483272,24.437863608678327,0.0747333333333333,0.074891513782793,0.07627142857142857,0.07675239771893097,0.08270000000000001,0.08917353396615187,25640.0,14403052.666666657,73344.0,17855888.285714287
2022-07-05,0.0771,0.0778,0.0716,0.0744,22909911.0,6863.0,11038321.0,0.07516666666666662,0.07527142857142857,0.07941000000000001,0.07517287844569825,0.07621072371689866,0.0867175640856708,40.22346368715084,0.08861958310926636,0.07020041689073366,-0.014936402867718954,-0.01774240738177263,0.0028060045140536755,0.006199999999999997,0.008049999999999998,615297790.0899987,-0.014300000000000007,-8.59950859950861,-79.18215613382901,20.817843866170985,23.667905824039675,-3.5019455252918394,0.0739,0.0775,0.0725,0.077,15652859.0,4947.0,7891530.0,4.194857916102849,45.50724637681159,0.09653165182573406,0.06563834817426595,-0.01565783694781983,-0.018443908510286044,0.0027860715624662136,0.0050000000000000044,0.008157142857142856,638207701.0899987,-0.012999999999999998,-3.8701622971285987,-69.51672862453532,30.48327137546469,25.89838909541515,0.07576666666666663,0.0759457568913965,0.07551428571428571,0.07681429828919822,0.081085,0.0880141497788993,22334.0,13682268.333333323,61148.0,14024070.142857144
2022-07-06,0.0741,0.0788,0.0731,0.0755,29238615.0,7607.0,14771906.0,0.07563333333333329,0.07509999999999999,0.079045,0.07533643922284913,0.07603304278767399,0.08564922464894024,42.00542005420054,0.08826750679440222,0.06982249320559779,-0.014113212031540562,-0.017016568311726217,0.0029033562801856552,0.005699999999999997,0.007807142857142855,644536405.0899987,-0.006900000000000003,-7.24815724815725,-75.09293680297398,24.90706319702602,25.402726146220587,1.8893387314439927,0.0771,0.0778,0.0716,0.0744,22909911.0,6863.0,11038321.0,-3.5019455252918394,40.22346368715084,0.08861958310926636,0.07020041689073366,-0.014936402867718954,-0.01774240738177263,0.0028060045140536755,0.006199999999999997,0.008049999999999998,615297790.0899987,-0.014300000000000007,-8.59950859950861,-79.18215613382901,20.817843866170985,23.667905824039675,0.07516666666666662,0.07517287844569825,0.07527142857142857,0.07621072371689866,0.07941000000000001,0.0867175640856708,20158.0,12118096.99999999,57424.0,13172020.857142856
2022-07-07,0.0757,0.0829,0.075,0.0813,46181838.0,12583.0,21708455.0,0.07706666666666662,0.07605714285714285,0.07910999999999999,0.07831821961142457,0.07734978209075549,0.08523501277761261,49.289099526066344,0.08837905434307626,0.06984094565692371,-0.012844749558391794,-0.016182204561059333,0.0033374550026675394,0.007900000000000004,0.00802142857142857,690718243.0899987,-0.0010000000000000009,-0.7326007326007411,-53.53159851301115,46.468401486988846,30.731102850061973,7.397622192866571,0.0741,0.0788,0.0731,0.0755,29238615.0,7607.0,14771906.0,1.8893387314439927,42.00542005420054,0.08826750679440222,0.06982249320559779,-0.014113212031540562,-0.017016568311726217,0.0029033562801856552,0.005699999999999997,0.007807142857142855,644536405.0899987,-0.006900000000000003,-7.24815724815725,-75.09293680297398,24.90706319702602,25.402726146220587,0.07563333333333329,0.07533643922284913,0.07509999999999999,0.07603304278767399,0.079045,0.08564922464894024,19417.0,11233918.99999999,54181.0,12780494.714285715
2022-07-08,0.0814,0.0835,0.0761,0.0789,31457006.0,9439.0,14762162.0,0.07856666666666663,0.07677142857142857,0.079305,0.07860910980571229,0.07773733656806661,0.08463167822736378,34.794520547945226,0.08837188015710612,0.07023811984289388,-0.011896014007538563,-0.01532496645035518,0.0034289524428166174,0.007400000000000004,0.00787142857142857,659261237.0899987,0.002799999999999997,-12.333333333333329,-62.45353159851301,37.54646840148699,36.30731102850064,-3.071253071253074,0.0757,0.0829,0.075,0.0813,46181838.0,12583.0,21708455.0,7.397622192866571,49.289099526066344,0.08837905434307626,0.06984094565692371,-0.012844749558391794,-0.016182204561059333,0.0033374550026675394,0.007900000000000004,0.00802142857142857,690718243.0899987,-0.0010000000000000009,-0.7326007326007411,-53.53159851301115,46.468401486988846,30.731102850061973,0.07706666666666662,0.07831821961142457,0.07605714285714285,0.07734978209075549,0.07910999999999999,0.08523501277761261,27053.0,15839560.666666657,57640.0,14088481.42857143
2022-07-09,0.0791,0.084,0.079,0.0818,21402359.0,7906.0,9841536.0,0.08066666666666662,0.07757142857142856,0.079435,0.08020455490285613,0.07875300242604996,0.08436199458666248,40.94488188976378,0.08856984364479795,0.07030015635520206,-0.01078579653598645,-0.014417132467481436,0.0036313359314949865,0.0050000000000000044,0.0075642857142857135,680663596.0899987,0.005099999999999993,-7.779030439684331,-49.61240310077521,50.387596899224796,44.800822262566896,3.413400758533494,0.0814,0.0835,0.0761,0.0789,31457006.0,9439.0,14762162.0,-3.071253071253074,34.794520547945226,0.08837188015710612,0.07023811984289388,-0.011896014007538563,-0.01532496645035518,0.0034289524428166174,0.007400000000000004,0.00787142857142857,659261237.0899987,0.002799999999999997,-12.333333333333329,-62.45353159851301,37.54646840148699,36.30731102850064,0.07856666666666663,0.07860910980571229,0.07677142857142857,0.07773733656806661,0.079305,0.08463167822736378,29629.0,17080840.99999999,58826.0,14761092.714285715
2022-07-10,0.0818,0.0821,0.0766,0.077,32094249.0,9338.0,13830344.0,0.07923333333333331,0.0779857142857143,0.07927999999999999,0.07860227745142806,0.07831475181953747,0.08366085224507558,42.622950819672134,0.08847235380166055,0.07008764619833943,-0.010175958955300463,-0.013568897765045242,0.0033929388097447798,0.005500000000000005,0.00705,648569347.0899987,0.0023999999999999994,-6.553398058252425,-52.32558139534882,47.67441860465117,45.20282796845435,-5.867970660146698,0.0791,0.084,0.079,0.0818,21402359.0,7906.0,9841536.0,3.413400758533494,40.94488188976378,0.08856984364479795,0.07030015635520206,-0.01078579653598645,-0.014417132467481436,0.0036313359314949865,0.0050000000000000044,0.0075642857142857135,680663596.0899987,0.005099999999999993,-7.779030439684331,-49.61240310077521,50.387596899224796,44.800822262566896,0.08066666666666662,0.08020455490285613,0.07757142857142856,0.07875300242604996,0.079435,0.08436199458666248,29928.0,15437384.333333323,57693.0,13919764.285714285
2022-07-11,0.077,0.0774,0.0717,0.072,18220451.0,6059.0,8925569.0,0.07693333333333328,0.07727142857142856,0.07881,0.07530113872571403,0.0767360638646531,0.08255029488840171,37.59036144578314,0.08849404004394819,0.06912595995605182,-0.009981061033619981,-0.01285133041876019,0.0028702693851402096,0.005699999999999997,0.006921428571428571,630348896.0899987,-0.001899999999999999,-12.515188335358452,-79.87421383647802,20.12578616352198,39.39593388913267,-6.4935064935065,0.0818,0.0821,0.0766,0.077,32094249.0,9338.0,13830344.0,-5.867970660146698,42.622950819672134,0.08847235380166055,0.07008764619833943,-0.010175958955300463,-0.013568897765045242,0.0033929388097447798,0.005500000000000005,0.00705,648569347.0899987,0.0023999999999999994,-6.553398058252425,-52.32558139534882,47.67441860465117,45.20282796845435,0.07923333333333331,0.07860227745142806,0.0779857142857143,0.07831475181953747,0.07927999999999999,0.08366085224507558,26683.0,12811347.333333323,58683.0,13406322.0
2022-07-12,0.0719,0.0749,0.0682,0.0686,27549258.0,7818.0,12850458.0,0.0725333333333333,0.07644285714285713,0.07816999999999999,0.07195056936285701,0.07470204789848983,0.0812216953752206,40.310077519379846,0.08878083854983565,0.06755916145016433,-0.00998584401767523,-0.012278233138543199,0.002292389120867969,0.006699999999999998,0.006735714285714285,602799638.0899987,-0.0076000000000000095,-9.855453350854148,-97.46835443037976,2.5316455696202365,23.44395011259782,-4.589707927677345,0.077,0.0774,0.0717,0.072,18220451.0,6059.0,8925569.0,-6.4935064935065,37.59036144578314,0.08849404004394819,0.06912595995605182,-0.009981061033619981,-0.01285133041876019,0.0028702693851402096,0.005699999999999997,0.006921428571428571,630348896.0899987,-0.001899999999999999,-12.515188335358452,-79.87421383647802,20.12578616352198,39.39593388913267,0.07693333333333328,0.07530113872571403,0.07727142857142856,0.0767360638646531,0.07881,0.08255029488840171,23303.0,10865816.333333323,59795.0,13554041.857142856
2022-07-13,0.0686,0.0746,0.0662,0.0741,27050353.0,8735.0,12715754.0,0.07156666666666663,0.07624285714285714,0.07778,0.0730252846814285,0.07455153592386737,0.08054343867281864,47.01834862385321,0.08838696891046238,0.06717303108953762,-0.009437046138884617,-0.011709995738611484,0.002272949599726867,0.008400000000000005,0.0068000000000000005,629849991.0899987,0.0,-3.3898305084745783,-55.61797752808989,44.38202247191011,22.34648473501747,8.01749271137027,0.0719,0.0749,0.0682,0.0686,27549258.0,7818.0,12850458.0,-4.589707927677345,40.310077519379846,0.08878083854983565,0.06755916145016433,-0.00998584401767523,-0.012278233138543199,0.002292389120867969,0.006699999999999998,0.006735714285714285,602799638.0899987,-0.0076000000000000095,-9.855453350854148,-97.46835443037976,2.5316455696202365,23.44395011259782,0.0725333333333333,0.07195056936285701,0.07644285714285713,0.07470204789848983,0.07816999999999999,0.0812216953752206,23215.0,11868790.333333323,60750.0,13812918.57142857
2022-07-14,0.0741,0.0809,0.0737,0.0769,41818131.0,12141.0,19808117.0,0.07319999999999996,0.07561428571428572,0.077125,0.07496264234071426,0.07513865194290054,0.08019644451350258,52.595936794582386,0.0860371738144566,0.0682128261855434,-0.008676169782124057,-0.011103230547313998,0.002427060765189941,0.007199999999999998,0.006728571428571429,671668122.0899987,-0.00010000000000000286,3.0831099195710365,-39.88764044943823,60.11235955056177,35.6753425306974,3.7786774628879853,0.0686,0.0746,0.0662,0.0741,27050353.0,8735.0,12715754.0,8.01749271137027,47.01834862385321,0.08838696891046238,0.06717303108953762,-0.009437046138884617,-0.011709995738611484,0.002272949599726867,0.008400000000000005,0.0068000000000000005,629849991.0899987,0.0,-3.3898305084745783,-55.61797752808989,44.38202247191011,22.34648473501747,0.07156666666666663,0.0730252846814285,0.07624285714285714,0.07455153592386737,0.07778,0.08054343867281864,22612.0,11497260.333333323,61878.0,13519182.57142857
2022-07-15,0.0768,0.08,0.0752,0.0767,32314486.0,9779.0,14120576.0,0.07589999999999997,0.0753,0.076525,0.07583132117035712,0.0755289889571754,0.07986344979793092,53.196347031963484,0.08357784563653296,0.06947215436346703,-0.007997122268626464,-0.01048200889157649,0.002484886622950027,0.004799999999999999,0.006678571428571429,639353636.0899987,0.0023000000000000104,3.7889039242219313,-41.011235955056165,58.98876404494384,54.49438202247194,-0.13020833333331902,0.0741,0.0809,0.0737,0.0769,41818131.0,12141.0,19808117.0,3.7786774628879853,52.595936794582386,0.0860371738144566,0.0682128261855434,-0.008676169782124057,-0.011103230547313998,0.002427060765189941,0.007199999999999998,0.006728571428571429,671668122.0899987,-0.00010000000000000286,3.0831099195710365,-39.88764044943823,60.11235955056177,35.6753425306974,0.07319999999999996,0.07496264234071426,0.07561428571428572,0.07513865194290054,0.077125,0.08019644451350258,28694.0,15124776.333333323,61436.0,13247705.714285715
2022-07-16,0.0767,0.0826,0.0761,0.0812,58103589.0,15003.0,28595875.0,0.07826666666666664,0.0752142857142857,0.07646499999999999,0.07851566058517856,0.07694674171788154,0.07999074029336606,55.43478260869564,0.08332519026850785,0.06960480973149213,-0.007014995330488744,-0.009788606179358943,0.002773610848870199,0.006500000000000006,0.006371428571428572,697457225.0899987,0.005699999999999997,6.5616797900262425,-15.730337078651738,84.26966292134827,67.79026217228466,5.8670143415905995,0.0768,0.08,0.0752,0.0767,32314486.0,9779.0,14120576.0,-0.13020833333331902,53.196347031963484,0.08357784563653296,0.06947215436346703,-0.007997122268626464,-0.01048200889157649,0.002484886622950027,0.004799999999999999,0.006678571428571429,639353636.0899987,0.0023000000000000104,3.7889039242219313,-41.011235955056165,58.98876404494384,54.49438202247194,0.07589999999999997,0.07583132117035712,0.0753,0.0755289889571754,0.076525,0.07986344979793092,30655.0,15548148.99999999,61776.0,13156050.57142857
2022-07-17,0.0811,0.0829,0.0787,0.0794,26666393.0,8132.0,12831947.0,0.07909999999999996,0.07555714285714286,0.07632,0.07895783029258928,0.07756005628841116,0.07993447931304548,55.79868708971553,0.08277130749653624,0.06986869250346375,-0.006309169435019163,-0.009092718830490988,0.002783549395471825,0.004199999999999995,0.006157142857142858,670790832.0899987,-0.001899999999999999,7.1524966261808265,-25.842696629213506,74.1573033707865,72.47191011235957,-2.096177558569676,0.0767,0.0826,0.0761,0.0812,58103589.0,15003.0,28595875.0,5.8670143415905995,55.43478260869564,0.08332519026850785,0.06960480973149213,-0.007014995330488744,-0.009788606179358943,0.002773610848870199,0.006500000000000006,0.006371428571428572,697457225.0899987,0.005699999999999997,6.5616797900262425,-15.730337078651738,84.26966292134827,67.79026217228466,0.07826666666666664,0.07851566058517856,0.0752142857142857,0.07694674171788154,0.07646499999999999,0.07999074029336606,36923.0,20841522.666666657,68873.0,15835241.857142856
2022-07-18,0.0794,0.0859,0.0794,0.0846,37483658.0,12062.0,18192636.0,0.0817333333333333,0.07735714285714286,0.076745,0.08177891514629464,0.07932004221630837,0.08037881461656496,57.91666666666666,0.08418018661459264,0.06930981338540734,-0.005269457756972976,-0.008328066615787385,0.0030586088588144093,0.006500000000000006,0.006264285714285715,708274490.0899987,0.005699999999999997,9.870129870129873,-6.598984771573649,93.40101522842636,83.94266050685373,6.549118387909315,0.0811,0.0829,0.0787,0.0794,26666393.0,8132.0,12831947.0,-2.096177558569676,55.79868708971553,0.08277130749653624,0.06986869250346375,-0.006309169435019163,-0.009092718830490988,0.002783549395471825,0.004199999999999995,0.006157142857142858,670790832.0899987,-0.001899999999999999,7.1524966261808265,-25.842696629213506,74.1573033707865,72.47191011235957,0.07909999999999996,0.07895783029258928,0.07555714285714286,0.07756005628841116,0.07632,0.07993447931304548,32914.0,18516132.666666657,67667.0,15692613.714285715
2022-07-19,0.0844,0.0913,0.0831,0.0875,58896091.0,17026.0,29300817.0,0.08383333333333327,0.08005714285714285,0.077285,0.08463945757314731,0.08136503166223127,0.08105702274832068,63.56107660455488,0.08613968059361135,0.06843031940638866,-0.004163479003438497,-0.007495149093317608,0.003331670089879111,0.008200000000000013,0.0064071428571428595,767170581.0899987,0.005699999999999997,17.607526881720425,-15.139442231075737,84.86055776892427,84.13962545604574,3.672985781990511,0.0794,0.0859,0.0794,0.0846,37483658.0,12062.0,18192636.0,6.549118387909315,57.91666666666666,0.08418018661459264,0.06930981338540734,-0.005269457756972976,-0.008328066615787385,0.0030586088588144093,0.006500000000000006,0.006264285714285715,708274490.0899987,0.005699999999999997,9.870129870129873,-6.598984771573649,93.40101522842636,83.94266050685373,0.0817333333333333,0.08177891514629464,0.07735714285714286,0.07932004221630837,0.076745,0.08037881461656496,35197.0,19873485.99999999,73670.0,17016480.42857143
2022-07-20,0.0876,0.0934,0.0797,0.0835,68639045.0,19965.0,30477816.0,0.08519999999999996,0.0814,0.07773,0.08406972878657365,0.08189877374667345,0.08128968724848061,57.812500000000014,0.08690527570181716,0.06855472429818282,-0.0035686126979235927,-0.006709841814238806,0.0031412291163152133,0.013700000000000004,0.006978571428571431,698531536.0899987,0.006500000000000006,10.596026490066235,-36.397058823529385,63.602941176470615,80.6215047246071,-4.680365296803644,0.0844,0.0913,0.0831,0.0875,58896091.0,17026.0,29300817.0,3.672985781990511,63.56107660455488,0.08613968059361135,0.06843031940638866,-0.004163479003438497,-0.007495149093317608,0.003331670089879111,0.008200000000000013,0.0064071428571428595,767170581.0899987,0.005699999999999997,17.607526881720425,-15.139442231075737,84.86055776892427,84.13962545604574,0.08383333333333327,0.08463945757314731,0.08005714285714285,0.08136503166223127,0.077285,0.08105702274832068,37220.0,20108466.666666657,82878.0,19366531.714285713
2022-07-21,0.0836,0.0869,0.0799,0.0852,29086946.0,9138.0,14547263.0,0.08539999999999996,0.08258571428571429,0.078295,0.08463486439328682,0.08272408031000508,0.08166209798672056,54.140127388535035,0.08786061275414486,0.06872938724585514,-0.0029262688665609438,-0.005953127224703233,0.0030268583581422896,0.007000000000000006,0.006914285714285717,727618482.0899987,0.013200000000000003,4.797047970479706,-30.147058823529406,69.8529411764706,72.77214670728851,1.9138755980861295,0.0876,0.0934,0.0797,0.0835,68639045.0,19965.0,30477816.0,-4.680365296803644,57.812500000000014,0.08690527570181716,0.06855472429818282,-0.0035686126979235927,-0.006709841814238806,0.0031412291163152133,0.013700000000000004,0.006978571428571431,698531536.0899987,0.006500000000000006,10.596026490066235,-36.397058823529385,63.602941176470615,80.6215047246071,0.08519999999999996,0.08406972878657365,0.0814,0.08189877374667345,0.07773,0.08128968724848061,49053.0,25990422.99999999,94108.0,21903969.14285714
2022-07-22,0.0851,0.089,0.0817,0.0822,24222428.0,8112.0,11715183.0,0.0836333333333333,0.08337142857142857,0.078595,0.08341743219664341,0.08259306023250382,0.08171332674989001,53.459119496855344,0.08825979776215287,0.06893020223784713,-0.002628976475988365,-0.005288297074960259,0.0026593205989718944,0.007300000000000001,0.00690714285714286,703396054.0899987,0.013600000000000001,4.1825095057034245,-41.1764705882353,58.82352941176471,64.09313725490199,-3.4077555816686247,0.0836,0.0869,0.0799,0.0852,29086946.0,9138.0,14547263.0,1.9138755980861295,54.140127388535035,0.08786061275414486,0.06872938724585514,-0.0029262688665609438,-0.005953127224703233,0.0030268583581422896,0.007000000000000006,0.006914285714285717,727618482.0899987,0.013200000000000003,4.797047970479706,-30.147058823529406,69.8529411764706,72.77214670728851,0.08539999999999996,0.08463486439328682,0.08258571428571429,0.08272408031000508,0.078295,0.08166209798672056,46129.0,24775298.666666657,91105.0,21152418.57142857
2022-07-23,0.0823,0.085,0.0805,0.0833,15103383.0,4978.0,7278642.0,0.08356666666666662,0.08367142857142858,0.079055,0.08335871609832171,0.08276979517437787,0.08186443848799572,51.63398692810458,0.08869471499874376,0.06941528500125624,-0.002278345953733621,-0.004686306850714932,0.002407960896981311,0.004500000000000004,0.006871428571428574,718499437.0899987,0.0092,1.833740831295838,-37.132352941176464,62.867647058823536,63.8480392156863,1.2150668286755781,0.0851,0.089,0.0817,0.0822,24222428.0,8112.0,11715183.0,-3.4077555816686247,53.459119496855344,0.08825979776215287,0.06893020223784713,-0.002628976475988365,-0.005288297074960259,0.0026593205989718944,0.007300000000000001,0.00690714285714286,703396054.0899987,0.013600000000000001,4.1825095057034245,-41.1764705882353,58.82352941176471,64.09313725490199,0.0836333333333333,0.08341743219664341,0.08337142857142857,0.08259306023250382,0.078595,0.08171332674989001,37215.0,18913420.666666657,89438.0,20808791.0
2022-07-24,0.0835,0.0876,0.0821,0.0844,18810304.0,6408.0,9087749.0,0.08329999999999996,0.08438571428571429,0.079425,0.08387935804916086,0.08317734638078339,0.08210592053675803,58.76777251184835,0.08929784953235836,0.06955215046764163,-0.0018899220863974747,-0.004127029897851441,0.002237107811453966,0.005499999999999991,0.006871428571428573,737309741.0899987,0.007500000000000007,9.610389610389625,-33.088235294117624,66.91176470588238,62.86764705882356,1.0778443113772431,0.0823,0.085,0.0805,0.0833,15103383.0,4978.0,7278642.0,1.2150668286755781,51.63398692810458,0.08869471499874376,0.06941528500125624,-0.002278345953733621,-0.004686306850714932,0.002407960896981311,0.004500000000000004,0.006871428571428574,718499437.0899987,0.0092,1.833740831295838,-37.132352941176464,62.867647058823536,63.8480392156863,0.08356666666666662,0.08335871609832171,0.08367142857142858,0.08276979517437787,0.079055,0.08186443848799572,22228.0,11180362.666666657,79413.0,17763472.0
2022-07-25,0.0844,0.0849,0.0764,0.0766,18917579.0,6598.0,8387488.0,0.0814333333333333,0.08324285714285715,0.079535,0.08023967902458043,0.08153300978558754,0.08158154715230488,55.11111111111112,0.0892193389576411,0.06985066104235889,-0.002186286041203661,-0.003738881126521885,0.0015525950853182238,0.008500000000000008,0.007071428571428574,718392162.0899987,-0.00010000000000000286,6.388888888888888,-61.76470588235292,38.23529411764708,56.00490196078436,-9.241706161137442,0.0835,0.0876,0.0821,0.0844,18810304.0,6408.0,9087749.0,1.0778443113772431,58.76777251184835,0.08929784953235836,0.06955215046764163,-0.0018899220863974747,-0.004127029897851441,0.002237107811453966,0.005499999999999991,0.006871428571428573,737309741.0899987,0.007500000000000007,9.610389610389625,-33.088235294117624,66.91176470588238,62.86764705882356,0.08329999999999996,0.08387935804916086,0.08438571428571429,0.08317734638078339,0.079425,0.08210592053675803,19498.0,9360524.666666657,77689.0,17228586.57142857
2022-07-26,0.0765,0.0768,0.0734,0.0763,14493869.0,4998.0,7246279.0,0.07909999999999996,0.08164285714285714,0.07957499999999999,0.07826983951229022,0.08022475733919066,0.08107854266160919,59.18854415274465,0.08919556459630872,0.06995443540369127,-0.002417496706180536,-0.0034746042424536154,0.0010571075362730796,0.0033999999999999864,0.006835714285714287,703898293.0899987,-0.004899999999999988,11.224489795918391,-62.867647058823486,37.132352941176514,47.42647058823534,-0.2614379084967214,0.0844,0.0849,0.0764,0.0766,18917579.0,6598.0,8387488.0,-9.241706161137442,55.11111111111112,0.0892193389576411,0.06985066104235889,-0.002186286041203661,-0.003738881126521885,0.0015525950853182238,0.008500000000000008,0.007071428571428574,718392162.0899987,-0.00010000000000000286,6.388888888888888,-61.76470588235292,38.23529411764708,56.00490196078436,0.0814333333333333,0.08023967902458043,0.08324285714285715,0.08153300978558754,0.079535,0.08158154715230488,17984.0,8251292.99999999,72225.0,15827851.142857144
2022-07-27,0.0765,0.0813,0.0751,0.0812,27083436.0,9337.0,13734625.0,0.0780333333333333,0.08131428571428571,0.07957,0.0797349197561451,0.08046856800439299,0.08109011002717022,58.595641646489106,0.08918689303116144,0.06995310696883857,-0.0021802116521746073,-0.003215725724397814,0.0010355140722232065,0.006199999999999997,0.0066785714285714295,730981729.0899987,0.001799999999999996,9.581646423751678,-61.00000000000004,38.99999999999996,38.12254901960787,6.143790849673198,0.0765,0.0768,0.0734,0.0763,14493869.0,4998.0,7246279.0,-0.2614379084967214,59.18854415274465,0.08919556459630872,0.06995443540369127,-0.002417496706180536,-0.0034746042424536154,0.0010571075362730796,0.0033999999999999864,0.006835714285714287,703898293.0899987,-0.004899999999999988,11.224489795918391,-62.867647058823486,37.132352941176514,47.42647058823534,0.07909999999999996,0.07826983951229022,0.08164285714285714,0.08022475733919066,0.07957499999999999,0.08107854266160919,18004.0,8240505.333333324,60197.0,12677202.857142856
2022-07-28,0.0812,0.0926,0.0797,0.0871,43735884.0,16124.0,24902768.0,0.08153333333333329,0.08158571428571429,0.07998,0.08341745987807256,0.08212642600329474,0.08166248050077306,61.4864864864865,0.0901593599216705,0.06980064007832949,-0.0014988035710910563,-0.0028723412937364627,0.0013735377226454064,0.012900000000000009,0.007085714285714287,774717613.0899987,0.0025000000000000022,13.263979193758125,-31.500000000000018,68.49999999999999,48.210784313725505,7.266009852216753,0.0765,0.0813,0.0751,0.0812,27083436.0,9337.0,13734625.0,6.143790849673198,58.595641646489106,0.08918689303116144,0.06995310696883857,-0.0021802116521746073,-0.003215725724397814,0.0010355140722232065,0.006199999999999997,0.0066785714285714295,730981729.0899987,0.001799999999999996,9.581646423751678,-61.00000000000004,38.99999999999996,38.12254901960787,0.0780333333333333,0.0797349197561451,0.08131428571428571,0.08046856800439299,0.07957,0.08109011002717022,20933.0,9789463.99999999,49569.0,10285318.42857143
2022-07-29,0.087,0.0902,0.0836,0.086,43044221.0,16297.0,21579721.0,0.08476666666666662,0.08212857142857143,0.08019,0.08470872993903628,0.08309481950247105,0.08207557759593753,60.264900662251655,0.09069551734712307,0.06968448265287693,-0.001035605746070145,-0.002504994184203199,0.001469388438133054,0.006600000000000009,0.0072142857142857165,731673392.0899987,-0.0015000000000000013,12.125162972620585,-37.000000000000036,62.999999999999964,56.83333333333332,-1.1494252873563229,0.0812,0.0926,0.0797,0.0871,43735884.0,16124.0,24902768.0,7.266009852216753,61.4864864864865,0.0901593599216705,0.06980064007832949,-0.0014988035710910563,-0.0028723412937364627,0.0013735377226454064,0.012900000000000009,0.007085714285714287,774717613.0899987,0.0025000000000000022,13.263979193758125,-31.500000000000018,68.49999999999999,48.210784313725505,0.08153333333333329,0.08341745987807256,0.08158571428571429,0.08212642600329474,0.07998,0.08166248050077306,30459.0,15294557.333333323,56555.0,11764676.285714285
2022-07-30,0.086,0.0943,0.0859,0.0873,44656163.0,15962.0,22857486.0,0.08679999999999995,0.0827,0.080705,0.08600436496951813,0.08414611462685329,0.08257314163441967,57.244655581947754,0.09155623810516204,0.06985376189483795,-0.0005571959886199046,-0.0021154345450865404,0.0015582385564666358,0.00839999999999999,0.0073500000000000015,776329555.0899987,0.003799999999999998,7.512315270935965,-33.492822966507156,66.50717703349284,66.00239234449761,1.5116279069767553,0.087,0.0902,0.0836,0.086,43044221.0,16297.0,21579721.0,-1.1494252873563229,60.264900662251655,0.09069551734712307,0.06968448265287693,-0.001035605746070145,-0.002504994184203199,0.001469388438133054,0.006600000000000009,0.0072142857142857165,731673392.0899987,-0.0015000000000000013,12.125162972620585,-37.000000000000036,62.999999999999964,56.83333333333332,0.08476666666666662,0.08470872993903628,0.08212857142857143,0.08309481950247105,0.08019,0.08207557759593753,41758.0,20072371.333333325,64740.0,13173896.0
2022-07-31,0.0872,0.1054,0.087,0.0957,91425264.0,36484.0,47298779.0,0.08966666666666662,0.0843142857142857,0.08188999999999999,0.09085218248475907,0.08703458597013997,0.08382331862161779,66.73511293634498,0.09385748225705098,0.069922517742949,0.0004940617528424729,-0.0015935352855007377,0.0020875970383432106,0.0184,0.008364285714285716,867754819.0899987,0.010499999999999995,20.528967254408048,-30.312500000000014,69.68749999999999,66.39822567783095,9.747706422018341,0.086,0.0943,0.0859,0.0873,44656163.0,15962.0,22857486.0,1.5116279069767553,57.244655581947754,0.09155623810516204,0.06985376189483795,-0.0005571959886199046,-0.0021154345450865404,0.0015582385564666358,0.00839999999999999,0.0073500000000000015,776329555.0899987,0.003799999999999998,7.512315270935965,-33.492822966507156,66.50717703349284,66.00239234449761,0.08679999999999995,0.08600436496951813,0.0827,0.08414611462685329,0.080705,0.08257314163441967,48383.0,23113324.99999999,75724.0,15399445.142857144
2022-08-01,0.0958,0.1065,0.0905,0.0948,51402656.0,22503.0,23432611.0,0.09259999999999996,0.08691428571428571,0.0832,0.09282609124237953,0.08897593947760497,0.08486871684813038,61.486486486486484,0.09477147127042714,0.07162852872957286,0.0012402715303091033,-0.0010267739223387695,0.002267045452647873,0.016,0.009042857142857144,816352163.0899987,0.0126,12.056737588652489,-35.3474320241692,64.6525679758308,66.94908166977456,-1.0438413361169112,0.0872,0.1054,0.087,0.0957,91425264.0,36484.0,47298779.0,9.747706422018341,66.73511293634498,0.09385748225705098,0.069922517742949,0.0004940617528424729,-0.0015935352855007377,0.0020875970383432106,0.0184,0.008364285714285716,867754819.0899987,0.010499999999999995,20.528967254408048,-30.312500000000014,69.68749999999999,66.39822567783095,0.08966666666666662,0.09085218248475907,0.0843142857142857,0.08703458597013997,0.08188999999999999,0.08382331862161779,68743.0,30578661.99999999,105800.0,20858163.714285713
2022-08-02,0.0948,0.0973,0.091,0.0925,37855046.0,15692.0,19856051.0,0.09433333333333328,0.08922857142857142,0.08412,0.09266304562118977,0.08985695460820373,0.08559550571973701,55.70776255707762,0.0955703229094534,0.0726696770905466,0.0016272988883777179,-0.0004959593601954721,0.00212325824857319,0.0063,0.008907142857142858,778497117.0899987,0.0092,5.714285714285716,-42.29607250755288,57.70392749244713,64.01466515609266,-2.426160337552739,0.0958,0.1065,0.0905,0.0948,51402656.0,22503.0,23432611.0,-1.0438413361169112,61.486486486486484,0.09477147127042714,0.07162852872957286,0.0012402715303091033,-0.0010267739223387695,0.002267045452647873,0.016,0.009042857142857144,816352163.0899987,0.0126,12.056737588652489,-35.3474320241692,64.6525679758308,66.94908166977456,0.09259999999999996,0.09282609124237953,0.08691428571428571,0.08897593947760497,0.0832,0.08486871684813038,74949.0,31196291.99999999,121705.0,23007467.0
2022-08-03,0.0926,0.0981,0.0907,0.0956,29649911.0,11406.0,15379721.0,0.09429999999999995,0.09128571428571429,0.08505499999999999,0.09413152281059489,0.09129271595615279,0.08654831469880968,64.1025641025641,0.09706332605864634,0.07304667394135364,0.0021592741815838756,3.508734816039743e-05,0.0021241868334234784,0.007400000000000004,0.008457142857142858,808147028.0899987,0.011200000000000002,14.491017964071862,-32.93051359516615,67.06948640483384,63.14199395770394,3.2397408207343443,0.0948,0.0973,0.091,0.0925,37855046.0,15692.0,19856051.0,-2.426160337552739,55.70776255707762,0.0955703229094534,0.0726696770905466,0.0016272988883777179,-0.0004959593601954721,0.00212325824857319,0.0063,0.008907142857142858,778497117.0899987,0.0092,5.714285714285716,-42.29607250755288,57.70392749244713,64.01466515609266,0.09433333333333328,0.09266304562118977,0.08922857142857142,0.08985695460820373,0.08412,0.08559550571973701,74679.0,30195813.666666657,132399.0,24808863.0
2022-08-04,0.0956,0.106,0.0924,0.0964,79568087.0,31056.0,39813358.0,0.09483333333333328,0.09261428571428572,0.08603999999999999,0.09526576140529744,0.09256953696711459,0.08748657044178018,63.333333333333336,0.09838971126848672,0.07369028873151326,0.002615274491855543,0.0005511247768994266,0.0020641497149561164,0.013600000000000001,0.008928571428571428,887715115.0899987,0.019799999999999998,13.145539906103298,-30.513595166163142,69.48640483383686,64.75327291037263,0.8368200836820032,0.0926,0.0981,0.0907,0.0956,29649911.0,11406.0,15379721.0,3.2397408207343443,64.1025641025641,0.09706332605864634,0.07304667394135364,0.0021592741815838756,3.508734816039743e-05,0.0021241868334234784,0.007400000000000004,0.008457142857142858,808147028.0899987,0.011200000000000002,14.491017964071862,-32.93051359516615,67.06948640483384,63.14199395770394,0.09429999999999995,0.09413152281059489,0.09128571428571429,0.09129271595615279,0.08505499999999999,0.08654831469880968,49601.0,19556127.666666657,134468.0,25043876.714285713
2022-08-05,0.0964,0.1015,0.0964,0.1008,32523050.0,13685.0,18643495.0,0.09759999999999996,0.09472857142857143,0.08702,0.09803288070264872,0.09462715272533595,0.08875451611399159,71.42857142857143,0.1007824355247498,0.0732575644752502,0.0032937331452951024,0.0010996464505785618,0.002194086694716541,0.005100000000000007,0.008771428571428572,920238165.0899987,0.024499999999999994,22.62773722627738,-17.22054380664652,82.77945619335348,73.11178247734142,4.564315352697097,0.0956,0.106,0.0924,0.0964,79568087.0,31056.0,39813358.0,0.8368200836820032,63.333333333333336,0.09838971126848672,0.07369028873151326,0.002615274491855543,0.0005511247768994266,0.0020641497149561164,0.013600000000000001,0.008928571428571428,887715115.0899987,0.019799999999999998,13.145539906103298,-30.513595166163142,69.48640483383686,64.75327291037263,0.09483333333333328,0.09526576140529744,0.09261428571428572,0.09256953696711459,0.08603999999999999,0.08748657044178018,58154.0,25016376.666666657,149400.0,27173961.0
2022-08-06,0.101,0.104,0.1,0.1017,24823674.0,10130.0,13854635.0,0.0996333333333333,0.09678571428571428,0.08813499999999999,0.09986644035132436,0.09639536454400197,0.08998741934123049,71.2962962962963,0.10287660242644012,0.07339339757355987,0.003859548521690251,0.0016516268648008997,0.002207921656889351,0.00399999999999999,0.008735714285714286,945061839.0899987,0.020500000000000004,22.08883553421368,-14.501510574018129,85.49848942598187,79.25478348439076,0.6930693069306854,0.0964,0.1015,0.0964,0.1008,32523050.0,13685.0,18643495.0,4.564315352697097,71.42857142857143,0.1007824355247498,0.0732575644752502,0.0032937331452951024,0.0010996464505785618,0.002194086694716541,0.005100000000000007,0.008771428571428572,920238165.0899987,0.024499999999999994,22.62773722627738,-17.22054380664652,82.77945619335348,73.11178247734142,0.09759999999999996,0.09803288070264872,0.09472857142857143,0.09462715272533595,0.08702,0.08875451611399159,56147.0,24612191.333333325,146788.0,26754500.14285714
2022-08-07,0.1017,0.1055,0.1,0.1043,30890940.0,10879.0,16417997.0,0.10226666666666663,0.09801428571428572,0.08912,0.10208322017566218,0.09837152340800147,0.0913505222611133,72.25950782997764,0.1054175748920628,0.07282242510793721,0.00446627511548485,0.00221455651493769,0.0022517186005471595,0.005499999999999991,0.008735714285714286,975952779.0899987,0.017200000000000007,23.578199052132696,-6.64652567975829,93.35347432024172,87.21047331319238,2.5565388397246855,0.101,0.104,0.1,0.1017,24823674.0,10130.0,13854635.0,0.6930693069306854,71.2962962962963,0.10287660242644012,0.07339339757355987,0.003859548521690251,0.0016516268648008997,0.002207921656889351,0.00399999999999999,0.008735714285714286,945061839.0899987,0.020500000000000004,22.08883553421368,-14.501510574018129,85.49848942598187,79.25478348439076,0.0996333333333333,0.09986644035132436,0.09678571428571428,0.09639536454400197,0.08813499999999999,0.08998741934123049,54871.0,24103829.333333325,140956.0,25468378.57142857
2022-08-08,0.1041,0.1055,0.1008,0.1017,41100946.0,13582.0,22909649.0,0.10256666666666664,0.099,0.08983,0.1018916100878311,0.0992036425560011,0.09233618680767394,81.77215189873418,0.10704200315551803,0.07261799684448196,0.0046833255793924805,0.002708310327828648,0.0019750152515638324,0.004699999999999996,0.008464285714285712,934851833.0899987,0.015700000000000006,32.76762402088773,-14.501510574018129,85.49848942598187,88.11681772406853,-2.305475504322766,0.1017,0.1055,0.1,0.1043,30890940.0,10879.0,16417997.0,2.5565388397246855,72.25950782997764,0.1054175748920628,0.07282242510793721,0.00446627511548485,0.00221455651493769,0.0022517186005471595,0.005499999999999991,0.008735714285714286,975952779.0899987,0.017200000000000007,23.578199052132696,-6.64652567975829,93.35347432024172,87.21047331319238,0.10226666666666663,0.10208322017566218,0.09801428571428572,0.09837152340800147,0.08912,0.0913505222611133,34694.0,16305375.666666657,115351.0,21056838.285714287
2022-08-09,0.1017,0.1028,0.0935,0.0957,29946055.0,12967.0,15505796.0,0.10056666666666662,0.09945714285714287,0.09043999999999999,0.09879580504391555,0.09832773191700082,0.09265654996884785,71.46017699115043,0.1075719830171307,0.07330801698286929,0.00432137565134981,0.003030923392532881,0.001290452258816929,0.009300000000000003,0.008885714285714285,904905778.0899987,0.00839999999999999,25.425950196592375,-34.39490445859874,65.60509554140125,81.48568642920831,-5.899705014749268,0.1041,0.1055,0.1008,0.1017,41100946.0,13582.0,22909649.0,-2.305475504322766,81.77215189873418,0.10704200315551803,0.07261799684448196,0.0046833255793924805,0.002708310327828648,0.0019750152515638324,0.004699999999999996,0.008464285714285712,934851833.0899987,0.015700000000000006,32.76762402088773,-14.501510574018129,85.49848942598187,88.11681772406853,0.10256666666666664,0.1018916100878311,0.099,0.0992036425560011,0.08983,0.09233618680767394,34591.0,17727426.99999999,106430.0,20982129.42857143
2022-08-10,0.0957,0.0999,0.092,0.0999,33947531.0,14149.0,18569884.0,0.09909999999999997,0.10007142857142858,0.09117499999999999,0.09934790252195777,0.09872079893775061,0.0933464023527671,71.01123595505618,0.10861891011195599,0.073731089888044,0.004323592936771092,0.0032894573013805234,0.001034135635390569,0.007900000000000004,0.009007142857142856,938853309.0899987,0.004200000000000009,23.029556650246306,-24.626865671641767,75.37313432835823,75.49223976524713,4.388714733542329,0.1017,0.1028,0.0935,0.0957,29946055.0,12967.0,15505796.0,-5.899705014749268,71.46017699115043,0.1075719830171307,0.07330801698286929,0.00432137565134981,0.003030923392532881,0.001290452258816929,0.009300000000000003,0.008885714285714285,904905778.0899987,0.00839999999999999,25.425950196592375,-34.39490445859874,65.60509554140125,81.48568642920831,0.10056666666666662,0.09879580504391555,0.09945714285714287,0.09832773191700082,0.09043999999999999,0.09265654996884785,37428.0,18277813.99999999,103705.0,20360664.42857143
2022-08-11,0.1,0.1032,0.0964,0.097,30035577.0,14120.0,14984591.0,0.09753333333333329,0.10015714285714285,0.091915,0.09817395126097889,0.09829059920331296,0.09369436403345595,61.92771084337349,0.10900796869889424,0.07482203130110575,0.004044719380485534,0.003440509717201526,0.0006042096632840081,0.0068000000000000005,0.008571428571428572,908817732.0899987,0.0022000000000000075,11.366245694603915,-41.484716157205206,58.51528384279479,66.49783790418479,-3.0000000000000027,0.0957,0.0999,0.092,0.0999,33947531.0,14149.0,18569884.0,4.388714733542329,71.01123595505618,0.10861891011195599,0.073731089888044,0.004323592936771092,0.0032894573013805234,0.001034135635390569,0.007900000000000004,0.009007142857142856,938853309.0899987,0.004200000000000009,23.029556650246306,-24.626865671641767,75.37313432835823,75.49223976524713,0.09909999999999997,0.09934790252195777,0.10007142857142858,0.09872079893775061,0.09117499999999999,0.0933464023527671,40698.0,18995109.666666657,106448.0,20816402.0
2022-08-12,0.097,0.1051,0.0946,0.1037,27538069.0,12443.0,15795005.0,0.10019999999999996,0.10057142857142856,0.09293499999999999,0.10093697563048945,0.09964294940248472,0.09464728174455539,68.78980891719746,0.11029596953375351,0.07557403046624647,0.004314607968803272,0.0036153293675218754,0.0006992786012813964,0.010499999999999995,0.008849999999999998,936355801.0899987,0.011200000000000002,20.581395348837226,-13.592233009708726,86.40776699029126,73.43206172048144,6.9072164948453585,0.1,0.1032,0.0964,0.097,30035577.0,14120.0,14984591.0,-3.0000000000000027,61.92771084337349,0.10900796869889424,0.07482203130110575,0.004044719380485534,0.003440509717201526,0.0006042096632840081,0.0068000000000000005,0.008571428571428572,908817732.0899987,0.0022000000000000075,11.366245694603915,-41.484716157205206,58.51528384279479,66.49783790418479,0.09753333333333329,0.09817395126097889,0.10015714285714285,0.09829059920331296,0.091915,0.09369436403345595,41236.0,16353423.666666657,89512.0,17269435.285714287
2022-08-13,0.1037,0.1057,0.1001,0.1005,25713901.0,9870.0,12290086.0,0.10039999999999998,0.10040000000000002,0.09373999999999999,0.10071848781524473,0.09985721205186354,0.09520468348316916,63.46938775510205,0.11092682481910066,0.07655317518089932,0.0042216191651342355,0.0037365873270443477,0.00048503183808988777,0.005600000000000008,0.00865,910641900.0899987,0.004900000000000002,15.12027491408936,-30.76923076923072,69.23076923076928,71.3846066879518,-3.0858244937319137,0.097,0.1051,0.0946,0.1037,27538069.0,12443.0,15795005.0,6.9072164948453585,68.78980891719746,0.11029596953375351,0.07557403046624647,0.004314607968803272,0.0036153293675218754,0.0006992786012813964,0.010499999999999995,0.008849999999999998,936355801.0899987,0.011200000000000002,20.581395348837226,-13.592233009708726,86.40776699029126,73.43206172048144,0.10019999999999996,0.10093697563048945,0.10057142857142856,0.09964294940248472,0.09293499999999999,0.09464728174455539,40712.0,16449826.666666657,88270.0,16862508.14285714
2022-08-14,0.1005,0.1054,0.0966,0.0995,29974013.0,9748.0,14968834.0,0.10123333333333329,0.09971428571428571,0.09488500000000001,0.10010924390762237,0.09976790903889765,0.09561376124667685,54.56730769230771,0.11021481614866736,0.07955518385133266,0.004020882989437591,0.0037934464595229967,0.0002274365299145941,0.008799999999999988,0.007964285714285714,880667887.0899987,0.0031000000000000055,3.970741901776398,-43.74999999999995,56.25000000000004,70.62951207368688,-0.9950248756218913,0.1037,0.1057,0.1001,0.1005,25713901.0,9870.0,12290086.0,-3.0858244937319137,63.46938775510205,0.11092682481910066,0.07655317518089932,0.0042216191651342355,0.0037365873270443477,0.00048503183808988777,0.005600000000000008,0.00865,910641900.0899987,0.004900000000000002,15.12027491408936,-30.76923076923072,69.23076923076928,71.3846066879518,0.10039999999999998,0.10071848781524473,0.10040000000000002,0.09985721205186354,0.09373999999999999,0.09520468348316916,36433.0,14356560.666666657,88010.0,16639001.142857144
2022-08-15,0.0994,0.105,0.0954,0.1003,30371857.0,10622.0,16611705.0,0.10009999999999997,0.09951428571428571,0.096085,0.10020462195381119,0.09990093177917324,0.09606006969937429,56.62650602409639,0.1088285060859437,0.0833414939140563,0.0038816066923597348,0.0038110785060903444,7.052818626939036e-05,0.009599999999999997,0.007507142857142856,911039744.0899987,-0.0005000000000000004,5.8016877637130815,-37.25490196078431,62.7450980392157,62.741955756661696,0.9054325955734386,0.1005,0.1054,0.0966,0.0995,29974013.0,9748.0,14968834.0,-0.9950248756218913,54.56730769230771,0.11021481614866736,0.07955518385133266,0.004020882989437591,0.0037934464595229967,0.0002274365299145941,0.008799999999999988,0.007964285714285714,880667887.0899987,0.0031000000000000055,3.970741901776398,-43.74999999999995,56.25000000000004,70.62951207368688,0.10123333333333329,0.10010924390762237,0.09971428571428571,0.09976790903889765,0.09488500000000001,0.09561376124667685,32061.0,14351308.333333323,86879.0,16431977.857142856
2022-08-16,0.1004,0.1179,0.1004,0.1076,152803445.0,56854.0,79874197.0,0.10246666666666664,0.10121428571428571,0.09740499999999999,0.1039023109769056,0.10182569883437992,0.09715911068038627,66.23655913978494,0.1090810618809045,0.08572893811909549,0.004310588434622273,0.003910980491796731,0.0003996079428255422,0.0175,0.008307142857142857,1063843189.0899987,0.0059000000000000025,16.324324324324337,-37.867647058823536,62.132352941176464,60.37581699346409,7.171314741035855,0.0994,0.105,0.0954,0.1003,30371857.0,10622.0,16611705.0,0.9054325955734386,56.62650602409639,0.1088285060859437,0.0833414939140563,0.0038816066923597348,0.0038110785060903444,7.052818626939036e-05,0.009599999999999997,0.007507142857142856,911039744.0899987,-0.0005000000000000004,5.8016877637130815,-37.25490196078431,62.7450980392157,62.741955756661696,0.10009999999999997,0.10020462195381119,0.09951428571428571,0.09990093177917324,0.096085,0.09606006969937429,30240.0,14623541.666666657,83919.0,15532271.57142857
2022-08-17,0.1075,0.1133,0.0985,0.1019,42869023.0,15580.0,19367277.0,0.10326666666666663,0.1015,0.098145,0.1029011554884528,0.10184427412578494,0.09761062394892092,56.41547861507129,0.10891170794598277,0.08737829205401722,0.004142860871612891,0.003957356567759963,0.00018550430385292846,0.014799999999999994,0.008835714285714284,1020974166.0899987,-0.0023999999999999994,6.589958158995812,-61.776061776061766,38.223938223938234,54.367129734776825,-5.20930232558139,0.1004,0.1179,0.1004,0.1076,152803445.0,56854.0,79874197.0,7.171314741035855,66.23655913978494,0.1090810618809045,0.08572893811909549,0.004310588434622273,0.003910980491796731,0.0003996079428255422,0.0175,0.008307142857142857,1063843189.0899987,0.0059000000000000025,16.324324324324337,-37.867647058823536,62.132352941176464,60.37581699346409,0.10246666666666664,0.1039023109769056,0.10121428571428571,0.10182569883437992,0.09740499999999999,0.09715911068038627,77224.0,37151578.66666666,127806.0,24727757.42857143
2022-08-18,0.1021,0.1028,0.094,0.0944,24765521.0,8429.0,11019132.0,0.10129999999999996,0.10112857142857143,0.098565,0.09865057774422639,0.0999832055943387,0.09730485023949988,48.20788530465949,0.10789661575643109,0.08923338424356891,0.003365947699778049,0.0038390747941635804,-0.00047312709438553134,0.008800000000000002,0.00849285714285714,996208645.0899987,-0.007300000000000001,-2.0746887966805017,-90.73359073359075,9.266409266409262,36.54090014384135,-7.541625857002937,0.1075,0.1133,0.0985,0.1019,42869023.0,15580.0,19367277.0,-5.20930232558139,56.41547861507129,0.10891170794598277,0.08737829205401722,0.004142860871612891,0.003957356567759963,0.00018550430385292846,0.014799999999999994,0.008835714285714284,1020974166.0899987,-0.0023999999999999994,6.589958158995812,-61.776061776061766,38.223938223938234,54.367129734776825,0.10326666666666663,0.1029011554884528,0.1015,0.10184427412578494,0.098145,0.09761062394892092,83056.0,38617726.33333332,129237.0,24841670.714285713
2022-08-19,0.0944,0.0944,0.0832,0.0842,31487627.0,11346.0,15184730.0,0.09349999999999996,0.09834285714285715,0.09841,0.0914252888721132,0.09603740419575402,0.09605676926430941,36.52597402597403,0.10859355743830981,0.08822644256169018,0.001905221451761821,0.003452304125683229,-0.0015470826739214078,0.011200000000000002,0.008928571428571426,964721018.0899987,-0.011499999999999996,-16.468253968253975,-97.11815561959654,2.8818443804034604,16.790730623583674,-10.805084745762713,0.1021,0.1028,0.094,0.0944,24765521.0,8429.0,11019132.0,-7.541625857002937,48.20788530465949,0.10789661575643109,0.08923338424356891,0.003365947699778049,0.0038390747941635804,-0.00047312709438553134,0.008800000000000002,0.00849285714285714,996208645.0899987,-0.007300000000000001,-2.0746887966805017,-90.73359073359075,9.266409266409262,36.54090014384135,0.10129999999999996,0.09865057774422639,0.10112857142857143,0.0999832055943387,0.098565,0.09730485023949988,80863.0,36753535.33333332,123546.0,24275176.57142857
2022-08-20,0.0842,0.0884,0.0822,0.0853,20382038.0,5624.0,13173318.0,0.08796666666666664,0.09617142857142857,0.09789,0.0883626444360566,0.09335305314681551,0.09503231504866089,36.731391585760534,0.10960340213037058,0.08617659786962943,0.0008268151725267514,0.0029272063350519336,-0.002100391162525182,0.006200000000000011,0.009085714285714284,985103056.0899987,-0.014600000000000002,-16.12586037364798,-91.31652661064425,8.683473389355756,6.943909012056184,1.3064133016627124,0.0944,0.0944,0.0832,0.0842,31487627.0,11346.0,15184730.0,-10.805084745762713,36.52597402597403,0.10859355743830981,0.08822644256169018,0.001905221451761821,0.003452304125683229,-0.0015470826739214078,0.011200000000000002,0.008928571428571426,964721018.0899987,-0.011499999999999996,-16.468253968253975,-97.11815561959654,2.8818443804034604,16.790730623583674,0.09349999999999996,0.0914252888721132,0.09834285714285715,0.09603740419575402,0.09841,0.09605676926430941,35355.0,15190379.666666657,122449.0,24187994.42857143
2022-08-21,0.0853,0.0954,0.085,0.0888,31578244.0,12398.0,16089330.0,0.08609999999999995,0.09464285714285715,0.09759,0.08858132221802831,0.09221478986011163,0.0944387612345027,37.63955342902712,0.10992734595677853,0.08525265404322147,0.000251689852071621,0.002392103038455871,-0.00214041318638425,0.010399999999999993,0.009435714285714285,1016681300.0899987,-0.008199999999999999,-14.860977948226273,-81.51260504201679,18.487394957983213,10.017570909247501,4.103165298944904,0.0842,0.0884,0.0822,0.0853,20382038.0,5624.0,13173318.0,1.3064133016627124,36.731391585760534,0.10960340213037058,0.08617659786962943,0.0008268151725267514,0.0029272063350519336,-0.002100391162525182,0.006200000000000011,0.009085714285714284,985103056.0899987,-0.014600000000000002,-16.12586037364798,-91.31652661064425,8.683473389355756,6.943909012056184,0.08796666666666664,0.0883626444360566,0.09617142857142857,0.09335305314681551,0.09789,0.09503231504866089,25399.0,13125726.666666657,118203.0,24314170.42857143
2022-08-22,0.0888,0.0898,0.0846,0.0895,21020280.0,4808.0,12582860.0,0.08786666666666663,0.09309999999999999,0.09744,0.08904066110901415,0.09153609239508373,0.09396840302169293,39.9671052631579,0.1101064746058818,0.0847735253941182,-0.00014593471355073273,0.0018844954880545503,-0.002030430201605283,0.00520000000000001,0.009471428571428573,1037701580.0899987,-0.014200000000000004,-11.996066863323506,-79.55182072829132,20.448179271708682,15.873015873015907,0.7882882882882796,0.0853,0.0954,0.085,0.0888,31578244.0,12398.0,16089330.0,4.103165298944904,37.63955342902712,0.10992734595677853,0.08525265404322147,0.000251689852071621,0.002392103038455871,-0.00214041318638425,0.010399999999999993,0.009435714285714285,1016681300.0899987,-0.008199999999999999,-14.860977948226273,-81.51260504201679,18.487394957983213,10.017570909247501,0.08609999999999995,0.08858132221802831,0.09464285714285715,0.09221478986011163,0.09759,0.0944387612345027,29368.0,14815792.666666657,120853.0,24474241.285714287
2022-08-23,0.0895,0.0967,0.0876,0.0918,35448343.0,12476.0,18247862.0,0.0900333333333333,0.09084285714285714,0.09725,0.09042033055450707,0.09160206929631279,0.09376188844819835,46.584938704028026,0.11014463372653314,0.08435536627346686,-0.0002723250744964545,0.0014531313755443494,-0.0017254564500408039,0.009099999999999997,0.009457142857142858,1073149923.0899987,-0.0087,-4.075235109717856,-73.10924369747896,26.890756302521034,21.942110177404334,2.5698324022346486,0.0888,0.0898,0.0846,0.0895,21020280.0,4808.0,12582860.0,0.7882882882882796,39.9671052631579,0.1101064746058818,0.0847735253941182,-0.00014593471355073273,0.0018844954880545503,-0.002030430201605283,0.00520000000000001,0.009471428571428573,1037701580.0899987,-0.014200000000000004,-11.996066863323506,-79.55182072829132,20.448179271708682,15.873015873015907,0.08786666666666663,0.08904066110901415,0.09309999999999999,0.09153609239508373,0.09744,0.09396840302169293,22830.0,13948502.666666657,115039.0,23898692.0
2022-08-24,0.0919,0.0936,0.0893,0.0908,10516654.0,4531.0,4929799.0,0.09069999999999996,0.08925714285714285,0.09697,0.09061016527725355,0.0914015519722346,0.09347980383408422,41.558441558441565,0.11018165354782505,0.08375834645217495,-0.00044801752168187325,0.0010729015960991048,-0.001520919117780978,0.004299999999999998,0.0092,1062633269.0899987,-0.0087,-9.109109109109104,-75.91036414565824,24.089635854341758,23.80952380952385,-1.1969532100108704,0.0895,0.0967,0.0876,0.0918,35448343.0,12476.0,18247862.0,2.5698324022346486,46.584938704028026,0.11014463372653314,0.08435536627346686,-0.0002723250744964545,0.0014531313755443494,-0.0017254564500408039,0.009099999999999997,0.009457142857142858,1073149923.0899987,-0.0087,-4.075235109717856,-73.10924369747896,26.890756302521034,21.942110177404334,0.0900333333333333,0.09042033055450707,0.09084285714285714,0.09160206929631279,0.09725,0.09376188844819835,29682.0,15640017.333333323,70661.0,15094929.857142856
2022-08-25,0.0909,0.0931,0.0898,0.0912,14291052.0,4480.0,8530925.0,0.09126666666666665,0.08879999999999999,0.09649,0.09090508263862677,0.09135116397917595,0.09326267965940953,44.357976653696504,0.10981285728775392,0.0831671427122461,-0.0005486538546997238,0.0007485905059393391,-0.0012972443606390628,0.0032999999999999974,0.00895,1076924321.0899987,-0.009099999999999997,-5.97938144329897,-74.78991596638654,25.210084033613462,25.396825396825445,0.33003300330033947,0.0919,0.0936,0.0893,0.0908,10516654.0,4531.0,4929799.0,-1.1969532100108704,41.558441558441565,0.11018165354782505,0.08375834645217495,-0.00044801752168187325,0.0010729015960991048,-0.001520919117780978,0.004299999999999998,0.0092,1062633269.0899987,-0.0087,-9.109109109109104,-75.91036414565824,24.089635854341758,23.80952380952385,0.09069999999999996,0.09061016527725355,0.08925714285714285,0.0914015519722346,0.09697,0.09347980383408422,21815.0,11920173.666666657,59612.0,13032433.0
2022-08-26,0.0912,0.0912,0.0842,0.0857,21919233.0,6522.0,13213764.0,0.08923333333333332,0.08901428571428571,0.09569,0.0883025413193134,0.08993837298438195,0.09254242445375148,32.071713147410364,0.10960400657400399,0.08177599342599601,-0.0010599939577228268,0.00038687361320690597,-0.0014468675709297329,0.007000000000000006,0.008700000000000001,1055005088.0899987,-0.021900000000000003,-17.357762777242048,-90.19607843137254,9.803921568627457,19.701213818860918,-6.030701754385969,0.0909,0.0931,0.0898,0.0912,14291052.0,4480.0,8530925.0,0.33003300330033947,44.357976653696504,0.10981285728775392,0.0831671427122461,-0.0005486538546997238,0.0007485905059393391,-0.0012972443606390628,0.0032999999999999974,0.00895,1076924321.0899987,-0.009099999999999997,-5.97938144329897,-74.78991596638654,25.210084033613462,25.396825396825445,0.09126666666666665,0.09090508263862677,0.08879999999999999,0.09135116397917595,0.09649,0.09326267965940953,21487.0,10569528.666666657,55663.0,12676974.857142856
2022-08-27,0.0858,0.0864,0.0831,0.085,14362295.0,3746.0,8825894.0,0.08729999999999997,0.08897142857142858,0.09472499999999999,0.08665127065965669,0.08870377973828647,0.09182409831529896,33.752620545073384,0.1088008658701355,0.08064913412986448,-0.001504377298179982,8.623430929528418e-06,-0.0015130007291095102,0.0033000000000000113,0.008535714285714287,1040642793.0899987,-0.0169,-15.4228855721393,-92.15686274509801,7.843137254901988,14.285714285714327,-0.9324009324009267,0.0912,0.0912,0.0842,0.0857,21919233.0,6522.0,13213764.0,-6.030701754385969,32.071713147410364,0.10960400657400399,0.08177599342599601,-0.0010599939577228268,0.00038687361320690597,-0.0014468675709297329,0.007000000000000006,0.008700000000000001,1055005088.0899987,-0.021900000000000003,-17.357762777242048,-90.19607843137254,9.803921568627457,19.701213818860918,0.08923333333333332,0.0883025413193134,0.08901428571428571,0.08993837298438195,0.09569,0.09254242445375148,15533.0,8891495.99999999,50839.0,12395408.285714285
2022-08-28,0.085,0.0852,0.0775,0.0778,17954425.0,5392.0,10166641.0,0.0828333333333333,0.0874,0.09353,0.08222563532982835,0.08597783480371485,0.09048846990431811,29.87012987012986,0.10909218087795672,0.07796781912204329,-0.0024097559575332467,-0.0004750524467630266,-0.00193470351077022,0.0076999999999999985,0.00845714285714286,1022688368.0899987,-0.016600000000000004,-21.809045226130664,-99.25742574257427,0.7425742574257294,6.12987769365175,-8.470588235294132,0.0858,0.0864,0.0831,0.085,14362295.0,3746.0,8825894.0,-0.9324009324009267,33.752620545073384,0.1088008658701355,0.08064913412986448,-0.001504377298179982,8.623430929528418e-06,-0.0015130007291095102,0.0033000000000000113,0.008535714285714287,1040642793.0899987,-0.0169,-15.4228855721393,-92.15686274509801,7.843137254901988,14.285714285714327,0.08729999999999997,0.08665127065965669,0.08897142857142858,0.08870377973828647,0.09472499999999999,0.09182409831529896,14748.0,10190194.333333323,48961.0,11774347.714285715
2022-08-29,0.0777,0.0848,0.0776,0.0843,11885250.0,4191.0,7023994.0,0.08236666666666663,0.08665714285714285,0.09296000000000001,0.08326281766491417,0.08555837610278613,0.08989909181819257,36.577181208053695,0.10901482711455451,0.07690517288544552,-0.0025731180871401277,-0.0008946655748384468,-0.0016784525123016809,0.007199999999999998,0.008285714285714287,1034573618.0899987,0.00010000000000000286,-15.95214356929212,-83.16831683168317,16.83168316831683,8.472464893548207,8.494208494208486,0.085,0.0852,0.0775,0.0778,17954425.0,5392.0,10166641.0,-8.470588235294132,29.87012987012986,0.10909218087795672,0.07796781912204329,-0.0024097559575332467,-0.0004750524467630266,-0.00193470351077022,0.0076999999999999985,0.00845714285714286,1022688368.0899987,-0.016600000000000004,-21.809045226130664,-99.25742574257427,0.7425742574257294,6.12987769365175,0.0828333333333333,0.08222563532982835,0.0874,0.08597783480371485,0.09353,0.09048846990431811,15660.0,10735432.99999999,41955.0,10928249.285714285
2022-08-30,0.0844,0.0855,0.0786,0.0801,13446029.0,4676.0,6235951.0,0.08073333333333328,0.08498571428571429,0.09197,0.08168140883245709,0.0841937820770896,0.08896584497836471,25.663716814159315,0.10865255943995691,0.07528744056004308,-0.0030068278116225644,-0.0013170980221952704,-0.001689729789427294,0.006900000000000003,0.0075285714285714305,1021127589.0899987,-0.005199999999999996,-25.557620817843862,-92.73743016759775,7.262569832402249,8.278942419381627,-5.094786729857818,0.0777,0.0848,0.0776,0.0843,11885250.0,4191.0,7023994.0,8.494208494208486,36.577181208053695,0.10901482711455451,0.07690517288544552,-0.0025731180871401277,-0.0008946655748384468,-0.0016784525123016809,0.007199999999999998,0.008285714285714287,1034573618.0899987,0.00010000000000000286,-15.95214356929212,-83.16831683168317,16.83168316831683,8.472464893548207,0.08236666666666663,0.08326281766491417,0.08665714285714285,0.08555837610278613,0.09296000000000001,0.08989909181819257,13329.0,8672176.333333323,41338.0,10134125.57142857
2022-08-31,0.0803,0.0848,0.0801,0.0812,15384704.0,4253.0,8180607.0,0.08186666666666663,0.08361428571428571,0.09118000000000001,0.08144070441622854,0.08344533655781719,0.08822624069471093,30.057803468208093,0.108348956072679,0.07401104392732102,-0.003224613746056121,-0.0016986011669674404,-0.0015260125790886804,0.004699999999999996,0.006807142857142859,1036512293.0899987,-0.0076000000000000095,-20.314033366045148,-85.37549407114626,14.624505928853734,12.906252976524295,1.1207970112079677,0.0844,0.0855,0.0786,0.0801,13446029.0,4676.0,6235951.0,-5.094786729857818,25.663716814159315,0.10865255943995691,0.07528744056004308,-0.0030068278116225644,-0.0013170980221952704,-0.001689729789427294,0.006900000000000003,0.0075285714285714305,1021127589.0899987,-0.005199999999999996,-25.557620817843862,-92.73743016759775,7.262569832402249,8.278942419381627,0.08073333333333328,0.08168140883245709,0.08498571428571429,0.0841937820770896,0.09197,0.08896584497836471,14259.0,7808861.99999999,33538.0,8418138.285714285
2022-09-01,0.0812,0.0824,0.0792,0.0819,14578835.0,3452.0,8455902.0,0.08106666666666663,0.0822857142857143,0.09008999999999999,0.08167035220811428,0.08305900241836289,0.08762374158092893,36.1419068736142,0.10667012761027295,0.07350987238972703,-0.003302655560828205,-0.0020194120457395935,-0.0012832435150886114,0.0031999999999999945,0.006407142857142859,1051091128.0899987,-0.007599999999999996,-13.241525423728806,-77.08333333333333,22.91666666666668,14.934580809307578,0.862068965517249,0.0803,0.0848,0.0801,0.0812,15384704.0,4253.0,8180607.0,1.1207970112079677,30.057803468208093,0.108348956072679,0.07401104392732102,-0.003224613746056121,-0.0016986011669674404,-0.0015260125790886804,0.004699999999999996,0.006807142857142859,1036512293.0899987,-0.0076000000000000095,-20.314033366045148,-85.37549407114626,14.624505928853734,12.906252976524295,0.08186666666666663,0.08144070441622854,0.08361428571428571,0.08344533655781719,0.09118000000000001,0.08822624069471093,13120.0,7146850.666666657,33260.0,8882539.42857143
2022-09-02,0.0818,0.0856,0.0794,0.0808,20270653.0,4141.0,9212149.0,0.08129999999999997,0.08158571428571429,0.089105,0.08123517610405714,0.08249425181377217,0.08697386143036427,45.277777777777786,0.10541973018614184,0.07279026981385817,-0.003413911620141638,-0.0022983119606200027,-0.0011155996595216353,0.006199999999999997,0.006050000000000001,1030820475.0899987,-0.01100000000000001,-4.038004750593826,-82.81250000000001,17.187499999999993,18.242890865173493,-1.2224938875305635,0.0812,0.0824,0.0792,0.0819,14578835.0,3452.0,8455902.0,0.862068965517249,36.1419068736142,0.10667012761027295,0.07350987238972703,-0.003302655560828205,-0.0020194120457395935,-0.0012832435150886114,0.0031999999999999945,0.006407142857142859,1051091128.0899987,-0.007599999999999996,-13.241525423728806,-77.08333333333333,22.91666666666668,14.934580809307578,0.08106666666666663,0.08167035220811428,0.0822857142857143,0.08305900241836289,0.09008999999999999,0.08762374158092893,12381.0,7624153.333333324,32232.0,8871821.857142856
2022-09-03,0.0808,0.0847,0.08,0.0826,14295106.0,2994.0,10840800.0,0.08176666666666664,0.08124285714285714,0.08825999999999999,0.08191758805202858,0.08252068886032912,0.08655730319890101,46.321525885558586,0.10404999016680028,0.0724700098331997,-0.0033185833290608063,-0.002502366234308164,-0.0008162170947526425,0.004699999999999996,0.005942857142857143,1045115581.0899987,-0.008199999999999999,-3.165298944900341,-73.43749999999996,26.562500000000043,22.22222222222226,2.22772277227724,0.0818,0.0856,0.0794,0.0808,20270653.0,4141.0,9212149.0,-1.2224938875305635,45.277777777777786,0.10541973018614184,0.07279026981385817,-0.003413911620141638,-0.0022983119606200027,-0.0011155996595216353,0.006199999999999997,0.006050000000000001,1030820475.0899987,-0.01100000000000001,-4.038004750593826,-82.81250000000001,17.187499999999993,18.242890865173493,0.08129999999999997,0.08123517610405714,0.08158571428571429,0.08249425181377217,0.089105,0.08697386143036427,11846.0,8616219.333333323,29851.0,8300162.571428572
2022-09-04,0.0827,0.0832,0.0803,0.0831,14554557.0,2789.0,10652943.0,0.08216666666666662,0.082,0.0874,0.08250879402601428,0.08266551664524684,0.0862280362275771,41.54302670623144,0.1022760492772516,0.0725239507227484,-0.0031661912681962,-0.0026351312410857713,-0.0005310600271104288,0.0029,0.005407142857142858,1059670138.0899987,-0.00810000000000001,-6.4189189189189255,-70.83333333333336,29.16666666666664,24.305555555555582,0.4836759371221253,0.0808,0.0847,0.08,0.0826,14295106.0,2994.0,10840800.0,2.22772277227724,46.321525885558586,0.10404999016680028,0.0724700098331997,-0.0033185833290608063,-0.002502366234308164,-0.0008162170947526425,0.004699999999999996,0.005942857142857143,1045115581.0899987,-0.008199999999999999,-3.165298944900341,-73.43749999999996,26.562500000000043,22.22222222222226,0.08176666666666664,0.08191758805202858,0.08124285714285714,0.08252068886032912,0.08825999999999999,0.08655730319890101,10587.0,9502950.333333323,29099.0,8588006.285714285
2022-09-05,0.083,0.0835,0.0808,0.082,13842388.0,2664.0,9701546.0,0.08256666666666664,0.08167142857142858,0.08612,0.08225439701300714,0.08249913748393513,0.08582536611066499,39.00293255131965,0.09772319375245869,0.07451680624754131,-0.0030984631148898018,-0.0027277976158465774,-0.00037066549904322434,0.002700000000000008,0.005228571428571429,1045827750.0899987,-0.003699999999999995,-8.37988826815642,-76.56249999999997,23.43750000000003,26.38888888888893,-1.2048192771084347,0.0827,0.0832,0.0803,0.0831,14554557.0,2789.0,10652943.0,0.4836759371221253,41.54302670623144,0.1022760492772516,0.0725239507227484,-0.0031661912681962,-0.0026351312410857713,-0.0005310600271104288,0.0029,0.005407142857142858,1059670138.0899987,-0.00810000000000001,-6.4189189189189255,-70.83333333333336,29.16666666666664,24.305555555555582,0.08216666666666662,0.08250879402601428,0.082,0.08266551664524684,0.0874,0.0862280362275771,9924.0,10235297.333333323,26496.0,8657478.0
2022-09-06,0.0821,0.0842,0.0758,0.077,22182983.0,6766.0,12063690.0,0.08069999999999995,0.08122857142857143,0.084875,0.07962719850650357,0.08112435311295135,0.08498485505250641,29.89130434782608,0.0945287693753175,0.07522123062468251,-0.0034089500248076776,-0.0028640280976387975,-0.0005449219271688802,0.00839999999999999,0.005178571428571428,1023644767.0899987,-0.008000000000000007,-16.12200435729848,-93.25842696629218,6.741573033707827,19.781913233458187,-6.211936662606585,0.083,0.0835,0.0808,0.082,13842388.0,2664.0,9701546.0,-1.2048192771084347,39.00293255131965,0.09772319375245869,0.07451680624754131,-0.0030984631148898018,-0.0027277976158465774,-0.00037066549904322434,0.002700000000000008,0.005228571428571429,1045827750.0899987,-0.003699999999999995,-8.37988826815642,-76.56249999999997,23.43750000000003,26.38888888888893,0.08256666666666664,0.08225439701300714,0.08167142857142858,0.08249913748393513,0.08612,0.08582536611066499,8447.0,10398429.666666657,24969.0,9039985.42857143
2022-09-07,0.077,0.1045,0.0756,0.0972,261655481.0,87882.0,141688909.0,0.08539999999999996,0.08351428571428572,0.08501500000000001,0.08841359925325179,0.08514326483471352,0.08614820219036294,55.71428571428571,0.0953102774045205,0.07471972259547952,-0.0020019645550874154,-0.002691615389128521,0.0006896508340411057,0.028899999999999995,0.0069357142857142855,1285300248.0899987,0.0194,7.048458149779724,-25.259515570934266,74.74048442906573,34.97318582092455,26.233766233766225,0.0821,0.0842,0.0758,0.077,22182983.0,6766.0,12063690.0,-6.211936662606585,29.89130434782608,0.0945287693753175,0.07522123062468251,-0.0034089500248076776,-0.0028640280976387975,-0.0005449219271688802,0.00839999999999999,0.005178571428571428,1023644767.0899987,-0.008000000000000007,-16.12200435729848,-93.25842696629218,6.741573033707827,19.781913233458187,0.08069999999999995,0.07962719850650357,0.08122857142857143,0.08112435311295135,0.084875,0.08498485505250641,12219.0,10806059.666666657,27059.0,9872519.57142857
2022-09-08,0.0973,0.0999,0.0896,0.0931,65837308.0,25896.0,32769257.0,0.08909999999999996,0.08511428571428571,0.08546000000000001,0.09075679962662589,0.08713244862603514,0.08681027817223314,51.591289782244566,0.09635865274118219,0.07456134725881783,-0.001203876628040626,-0.002394067636910942,0.001190191008870316,0.010300000000000004,0.007435714285714286,1219462940.0899987,0.008800000000000002,2.083333333333326,-39.446366782006905,60.553633217993095,47.34523022692224,-4.316546762589923,0.077,0.1045,0.0756,0.0972,261655481.0,87882.0,141688909.0,26.233766233766225,55.71428571428571,0.0953102774045205,0.07471972259547952,-0.0020019645550874154,-0.002691615389128521,0.0006896508340411057,0.028899999999999995,0.0069357142857142855,1285300248.0899987,0.0194,7.048458149779724,-25.259515570934266,74.74048442906573,34.97318582092455,0.08539999999999996,0.08841359925325179,0.08351428571428572,0.08514326483471352,0.08501500000000001,0.08614820219036294,97312.0,54484714.99999999,110688.0,28945134.14285714
2022-09-09,0.093,0.097,0.0908,0.0953,33772052.0,13352.0,15584780.0,0.09519999999999995,0.0871857142857143,0.08596000000000001,0.09302839981331294,0.08917433646952636,0.08761882310821092,58.51063829787235,0.09771189122492026,0.07420810877507976,-0.00038937609684396024,-0.001993129328897546,0.0016037532320535858,0.006199999999999997,0.007378571428571428,1253234992.0899987,0.015199999999999991,11.201866977829633,-31.83391003460208,68.16608996539792,67.82006920415228,2.4731182795698885,0.0973,0.0999,0.0896,0.0931,65837308.0,25896.0,32769257.0,-4.316546762589923,51.591289782244566,0.09635865274118219,0.07456134725881783,-0.001203876628040626,-0.002394067636910942,0.001190191008870316,0.010300000000000004,0.007435714285714286,1219462940.0899987,0.008800000000000002,2.083333333333326,-39.446366782006905,60.553633217993095,47.34523022692224,0.08909999999999996,0.09075679962662589,0.08511428571428571,0.08713244862603514,0.08546000000000001,0.08681027817223314,120544.0,62173951.99999999,133132.0,32418470.57142857
2022-09-10,0.0953,0.104,0.0934,0.0989,38106922.0,15672.0,18929981.0,0.09576666666666662,0.08951428571428573,0.086465,0.09596419990665647,0.09160575235214477,0.08869322090742893,61.72006745362563,0.09952587367087572,0.07340412632912428,0.0005403821665932312,-0.0014864270297993906,0.002026809196392622,0.010599999999999998,0.007899999999999999,1291341914.0899987,0.017700000000000007,16.352941176470594,-19.37716262975777,80.62283737024222,69.78085351787776,3.777544596012598,0.093,0.097,0.0908,0.0953,33772052.0,13352.0,15584780.0,2.4731182795698885,58.51063829787235,0.09771189122492026,0.07420810877507976,-0.00038937609684396024,-0.001993129328897546,0.0016037532320535858,0.006199999999999997,0.007378571428571428,1253234992.0899987,0.015199999999999991,11.201866977829633,-31.83391003460208,68.16608996539792,67.82006920415228,0.09519999999999995,0.09302839981331294,0.0871857142857143,0.08917433646952636,0.08596000000000001,0.08761882310821092,127130.0,63347648.66666666,142343.0,33328846.42857143
2022-09-11,0.0988,0.1014,0.0937,0.0949,19487898.0,8621.0,8926327.0,0.09636666666666661,0.09119999999999999,0.08673499999999999,0.09543209995332824,0.09242931426410858,0.08928434272576903,65.24064171122996,0.10027453664737183,0.07319546335262815,0.0009435787300657583,-0.0010004258778263607,0.001944004607892119,0.0076999999999999985,0.007899999999999999,1271854016.0899987,0.012999999999999998,21.979434447300772,-33.21799307958477,66.78200692041523,71.85697808535183,-3.947368421052632,0.0953,0.104,0.0934,0.0989,38106922.0,15672.0,18929981.0,3.777544596012598,61.72006745362563,0.09952587367087572,0.07340412632912428,0.0005403821665932312,-0.0014864270297993906,0.002026809196392622,0.010599999999999998,0.007899999999999999,1291341914.0899987,0.017700000000000007,16.352941176470594,-19.37716262975777,80.62283737024222,69.78085351787776,0.09576666666666662,0.09596419990665647,0.08951428571428573,0.09160575235214477,0.086465,0.08869322090742893,54920.0,22428005.99999999,155021.0,34484443.71428572
2022-09-12,0.0949,0.0987,0.0893,0.0912,29241549.0,11360.0,13581033.0,0.09499999999999996,0.0925142857142857,0.086705,0.09331604997666412,0.09212198569808143,0.08946678627569579,56.47279549718574,0.10019986842018686,0.07321013157981315,0.000953563744409594,-0.0006096279533791698,0.0015631916977887639,0.009399999999999992,0.008057142857142855,1242612467.0899987,0.010400000000000006,8.185053380782925,-46.02076124567473,53.97923875432527,67.12802768166092,-3.8988408851422496,0.0988,0.1014,0.0937,0.0949,19487898.0,8621.0,8926327.0,-3.947368421052632,65.24064171122996,0.10027453664737183,0.07319546335262815,0.0009435787300657583,-0.0010004258778263607,0.001944004607892119,0.0076999999999999985,0.007899999999999999,1271854016.0899987,0.012999999999999998,21.979434447300772,-33.21799307958477,66.78200692041523,71.85697808535183,0.09636666666666661,0.09543209995332824,0.09119999999999999,0.09242931426410858,0.08673499999999999,0.08928434272576903,37645.0,14480362.666666657,160853.0,34237784.28571428
2022-09-13,0.0912,0.092,0.0841,0.0863,23802395.0,8996.0,9656543.0,0.09079999999999995,0.09384285714285714,0.08648,0.08980802498833207,0.09066648927356107,0.08916518758277239,55.74074074074074,0.09983674085657622,0.07312325914342378,0.0005596367471643326,-0.00037577501327046937,0.0009354117604348021,0.007900000000000004,0.008128571428571426,1218810072.0899987,0.003699999999999995,7.740324594257175,-62.97577854671279,37.02422145328721,52.5951557093426,-5.372807017543861,0.0949,0.0987,0.0893,0.0912,29241549.0,11360.0,13581033.0,-3.8988408851422496,56.47279549718574,0.10019986842018686,0.07321013157981315,0.000953563744409594,-0.0006096279533791698,0.0015631916977887639,0.009399999999999992,0.008057142857142855,1242612467.0899987,0.010400000000000006,8.185053380782925,-46.02076124567473,53.97923875432527,67.12802768166092,0.09499999999999996,0.09331604997666412,0.0925142857142857,0.09212198569808143,0.086705,0.08946678627569579,35653.0,13812446.99999999,169549.0,34791996.71428572
2022-09-14,0.0863,0.0988,0.0831,0.0915,50321187.0,18817.0,27542369.0,0.08966666666666663,0.09302857142857143,0.086495,0.09065401249416603,0.0908748669551708,0.08938755067012741,58.86402753872634,0.09987471363056954,0.07311528636943046,0.0006594416724318569,-0.00016873167613000415,0.0008281733485618611,0.015700000000000006,0.008914285714285713,1269131259.0899987,0.008400000000000005,12.684729064039413,-44.982698961937714,55.017301038062286,48.67358708189161,6.025492468134411,0.0912,0.092,0.0841,0.0863,23802395.0,8996.0,9656543.0,-5.372807017543861,55.74074074074074,0.09983674085657622,0.07312325914342378,0.0005596367471643326,-0.00037577501327046937,0.0009354117604348021,0.007900000000000004,0.008128571428571426,1218810072.0899987,0.003699999999999995,7.740324594257175,-62.97577854671279,37.02422145328721,52.5951557093426,0.09079999999999995,0.08980802498833207,0.09384285714285714,0.09066648927356107,0.08648,0.08916518758277239,28977.0,10721300.99999999,171779.0,34448118.571428575
2022-09-15,0.0916,0.099,0.0871,0.0918,55447146.0,19560.0,24284330.0,0.08986666666666664,0.09284285714285714,0.0868,0.09122700624708302,0.0911061502163781,0.0896173077491629,58.578856152513,0.1003800162775753,0.0732199837224247,0.0007540530335681528,1.582526580962723e-05,0.0007382277677585255,0.011900000000000008,0.009535714285714286,1324578405.0899987,0.009800000000000003,12.08791208791209,-43.94463667820066,56.055363321799334,49.36562860438297,0.21834061135371802,0.0863,0.0988,0.0831,0.0915,50321187.0,18817.0,27542369.0,6.025492468134411,58.86402753872634,0.09987471363056954,0.07311528636943046,0.0006594416724318569,-0.00016873167613000415,0.0008281733485618611,0.015700000000000006,0.008914285714285713,1269131259.0899987,0.008400000000000005,12.684729064039413,-44.982698961937714,55.017301038062286,48.67358708189161,0.08966666666666663,0.09065401249416603,0.09302857142857143,0.0908748669551708,0.086495,0.08938755067012741,39173.0,16926648.333333325,102714.0,18141470.0
2022-09-16,0.0917,0.0922,0.0856,0.0866,39939053.0,13873.0,18333196.0,0.08996666666666664,0.0916,0.08688,0.08891350312354152,0.08997961266228358,0.08932994510638548,54.69255663430421,0.10043419531068752,0.07332580468931248,0.0004047707320815469,9.361435906401116e-05,0.00031115637301753574,0.006600000000000009,0.009564285714285716,1284639352.0899987,0.009599999999999997,7.178217821782185,-61.93771626297578,38.06228373702422,49.71164936562864,-5.561613958560531,0.0916,0.099,0.0871,0.0918,55447146.0,19560.0,24284330.0,0.21834061135371802,58.578856152513,0.1003800162775753,0.0732199837224247,0.0007540530335681528,1.582526580962723e-05,0.0007382277677585255,0.011900000000000008,0.009535714285714286,1324578405.0899987,0.009800000000000003,12.08791208791209,-43.94463667820066,56.055363321799334,49.36562860438297,0.08986666666666664,0.09122700624708302,0.09284285714285714,0.0911061502163781,0.0868,0.0896173077491629,47373.0,20494413.99999999,96378.0,16929337.57142857
2022-09-17,0.0865,0.0913,0.0865,0.0888,11600070.0,4380.0,5952615.0,0.08906666666666663,0.09015714285714285,0.08743,0.08885675156177075,0.08968470949671267,0.08927947414387258,54.98392282958199,0.100308721740847,0.07455127825915299,0.00030200231089311247,0.00013529194942983144,0.00016671036146328103,0.004800000000000013,0.009571428571428573,1296239422.0899987,-0.00839999999999999,7.506053268765123,-54.32525951557091,45.67474048442908,46.597462514417565,2.6589595375722666,0.0917,0.0922,0.0856,0.0866,39939053.0,13873.0,18333196.0,-5.561613958560531,54.69255663430421,0.10043419531068752,0.07332580468931248,0.0004047707320815469,9.361435906401116e-05,0.00031115637301753574,0.006600000000000009,0.009564285714285716,1284639352.0899987,0.009599999999999997,7.178217821782185,-61.93771626297578,38.06228373702422,49.71164936562864,0.08996666666666664,0.08891350312354152,0.0916,0.08997961266228358,0.08688,0.08932994510638548,52250.0,23386631.666666657,96899.0,17321968.42857143
2022-09-18,0.0886,0.0897,0.0802,0.0809,18252825.0,7161.0,9806967.0,0.0854333333333333,0.08815714285714285,0.08725999999999999,0.08487837578088538,0.08748853212253449,0.08848142898731329,48.419540229885065,0.1003997989247715,0.07412020107522849,-0.00041215531039005826,2.58024974658535e-05,-0.00043795780785591177,0.009500000000000008,0.010042857142857143,1277986597.0899987,-0.012200000000000003,-2.6474127557159943,-81.66089965397923,18.33910034602076,34.025374855824715,-8.690744920993227,0.0865,0.0913,0.0865,0.0888,11600070.0,4380.0,5952615.0,2.6589595375722666,54.98392282958199,0.100308721740847,0.07455127825915299,0.00030200231089311247,0.00013529194942983144,0.00016671036146328103,0.004800000000000013,0.009571428571428573,1296239422.0899987,-0.00839999999999999,7.506053268765123,-54.32525951557091,45.67474048442908,46.597462514417565,0.08906666666666663,0.08885675156177075,0.09015714285714285,0.08968470949671267,0.08743,0.08927947414387258,37813.0,16190046.99999999,85607.0,15468059.0
2022-09-19,0.0809,0.0853,0.0794,0.0827,21758548.0,6634.0,12715400.0,0.0841333333333333,0.08694285714285714,0.08739,0.08378918789044268,0.08629139909190087,0.08793081670280727,50.49786628733997,0.10028061674218709,0.0744993832578129,-0.0008233938420462161,-0.00014403677043656044,-0.0006793570716096557,0.0059000000000000025,0.010271428571428574,1299745145.0899987,-0.0126,0.8536585365853666,-75.43252595155711,24.567474048442893,29.527104959630933,2.224969097651417,0.0886,0.0897,0.0802,0.0809,18252825.0,7161.0,9806967.0,-8.690744920993227,48.419540229885065,0.1003997989247715,0.07412020107522849,-0.00041215531039005826,2.58024974658535e-05,-0.00043795780785591177,0.009500000000000008,0.010042857142857143,1277986597.0899987,-0.012200000000000003,-2.6474127557159943,-81.66089965397923,18.33910034602076,34.025374855824715,0.0854333333333333,0.08487837578088538,0.08815714285714285,0.08748853212253449,0.08725999999999999,0.08848142898731329,25414.0,11364259.333333323,84147.0,15593864.714285715
2022-09-20,0.0827,0.0861,0.0811,0.0826,19194786.0,5756.0,12313117.0,0.08206666666666664,0.08641428571428571,0.08746,0.08319459394522134,0.08536854931892565,0.08742311987396847,54.28134556574924,0.10022366553497433,0.07469633446502566,-0.001144183075200797,-0.00034406603138940775,-0.0008001170438113892,0.0049999999999999906,0.01002857142857143,1280550359.0899987,-0.016299999999999995,7.272727272727275,-75.77854671280274,24.22145328719726,22.376009227220326,-0.12091898428051873,0.0809,0.0853,0.0794,0.0827,21758548.0,6634.0,12715400.0,2.224969097651417,50.49786628733997,0.10028061674218709,0.0744993832578129,-0.0008233938420462161,-0.00014403677043656044,-0.0006793570716096557,0.0059000000000000025,0.010271428571428574,1299745145.0899987,-0.0126,0.8536585365853666,-75.43252595155711,24.567474048442893,29.527104959630933,0.0841333333333333,0.08378918789044268,0.08694285714285714,0.08629139909190087,0.08739,0.08793081670280727,18175.0,9491660.666666657,79421.0,15470202.857142856
2022-09-21,0.0824,0.0874,0.0777,0.0792,35747808.0,12917.0,17560979.0,0.08149999999999996,0.08465714285714286,0.08732500000000001,0.08119729697261067,0.08382641198919423,0.08663996560025719,31.481481481481495,0.10038983830722577,0.07426016169277426,-0.001653699618838142,-0.0006059927488791546,-0.0010477068699589875,0.0097,0.00865714285714286,1244802551.0899987,-0.015699999999999992,-18.518518518518512,-94.29657794676805,5.703422053231947,18.16411646295739,-3.8834951456310614,0.0827,0.0861,0.0811,0.0826,19194786.0,5756.0,12313117.0,-0.12091898428051873,54.28134556574924,0.10022366553497433,0.07469633446502566,-0.001144183075200797,-0.00034406603138940775,-0.0008001170438113892,0.0049999999999999906,0.01002857142857143,1280550359.0899987,-0.016299999999999995,7.272727272727275,-75.77854671280274,24.22145328719726,22.376009227220326,0.08206666666666664,0.08319459394522134,0.08641428571428571,0.08536854931892565,0.08746,0.08742311987396847,19551.0,11611827.99999999,76181.0,15849713.42857143
2022-09-22,0.0791,0.0834,0.0789,0.0827,14436911.0,4923.0,7448927.0,0.08149999999999996,0.08335714285714287,0.08742000000000001,0.08194864848630534,0.08354480899189567,0.08626473078118509,39.166666666666664,0.10031154761826348,0.07452845238173654,-0.001754845633154145,-0.0008357633257341528,-0.0009190823074199923,0.004500000000000004,0.008242857142857146,1259239462.0899987,-0.008500000000000008,-11.17078410311494,-80.98859315589357,19.011406844106435,16.312094061511903,4.551201011377993,0.0824,0.0874,0.0777,0.0792,35747808.0,12917.0,17560979.0,-3.8834951456310614,31.481481481481495,0.10038983830722577,0.07426016169277426,-0.001653699618838142,-0.0006059927488791546,-0.0010477068699589875,0.0097,0.00865714285714286,1244802551.0899987,-0.015699999999999992,-18.518518518518512,-94.29657794676805,5.703422053231947,18.16411646295739,0.08149999999999996,0.08119729697261067,0.08465714285714286,0.08382641198919423,0.08732500000000001,0.08663996560025719,25307.0,14196498.666666657,70281.0,14423800.57142857
2022-09-23,0.0828,0.0879,0.0819,0.0852,24182267.0,9264.0,11786194.0,0.08236666666666663,0.08315714285714285,0.08755,0.08357432424315267,0.08395860674392176,0.08616332784964364,39.54451345755694,0.10028842095453784,0.07481157904546216,-0.001614662645701967,-0.0009915431897277156,-0.0006231194559742513,0.006000000000000005,0.00822857142857143,1283421729.0899987,-0.0011000000000000038,-10.59811122770199,-71.48288973384031,28.51711026615968,17.743979721166045,2.8985507246376807,0.0791,0.0834,0.0789,0.0827,14436911.0,4923.0,7448927.0,4.551201011377993,39.166666666666664,0.10031154761826348,0.07452845238173654,-0.001754845633154145,-0.0008357633257341528,-0.0009190823074199923,0.004500000000000004,0.008242857142857146,1259239462.0899987,-0.008500000000000008,-11.17078410311494,-80.98859315589357,19.011406844106435,16.312094061511903,0.08149999999999996,0.08194864848630534,0.08335714285714287,0.08354480899189567,0.08742000000000001,0.08626473078118509,23596.0,12441007.666666657,55644.0,12018743.0
2022-09-24,0.0852,0.086,0.0819,0.0823,15336287.0,5041.0,7695994.0,0.08339999999999996,0.08222857142857143,0.08751,0.08293716212157634,0.08354395505794132,0.0857953918639633,32.563025210084035,0.10031212153447347,0.07470787846552654,-0.0017177709872057828,-0.0011367887492233291,-0.0005809822379824537,0.0040999999999999925,0.007764285714285717,1268085442.0899987,-0.0092,-16.78463094034378,-80.59071729957809,19.40928270042191,22.31259993689603,-3.403755868544601,0.0828,0.0879,0.0819,0.0852,24182267.0,9264.0,11786194.0,2.8985507246376807,39.54451345755694,0.10028842095453784,0.07481157904546216,-0.001614662645701967,-0.0009915431897277156,-0.0006231194559742513,0.006000000000000005,0.00822857142857143,1283421729.0899987,-0.0011000000000000038,-10.59811122770199,-71.48288973384031,28.51711026615968,17.743979721166045,0.08236666666666663,0.08357432424315267,0.08315714285714285,0.08395860674392176,0.08755,0.08616332784964364,27104.0,12265366.666666657,51035.0,11083457.0
2022-09-25,0.0824,0.0835,0.0796,0.0801,13743750.0,4025.0,8715092.0,0.08253333333333329,0.08211428571428571,0.08741499999999999,0.08151858106078817,0.08268296629345599,0.0852529735912049,33.84279475982534,0.10041593518880192,0.07441406481119807,-0.0019544767136010083,-0.001300326342098865,-0.0006541503715021433,0.0039000000000000007,0.007492857142857146,1254341692.0899987,-0.011700000000000002,-15.595363540569018,-88.73239436619718,11.267605633802814,19.731332866794826,-2.7912621359223255,0.0852,0.086,0.0819,0.0823,15336287.0,5041.0,7695994.0,-3.403755868544601,32.563025210084035,0.10031212153447347,0.07470787846552654,-0.0017177709872057828,-0.0011367887492233291,-0.0005809822379824537,0.0040999999999999925,0.007764285714285717,1268085442.0899987,-0.0092,-16.78463094034378,-80.59071729957809,19.40928270042191,22.31259993689603,0.08339999999999996,0.08293716212157634,0.08222857142857143,0.08354395505794132,0.08751,0.0857953918639633,19228.0,8977038.333333323,51696.0,11332511.142857144
2022-09-26,0.0801,0.0813,0.0785,0.0812,15098439.0,5357.0,8418258.0,0.08119999999999995,0.0819,0.08762500000000001,0.08135929053039409,0.08231222472009199,0.08486697610632823,38.4259259259259,0.10004007996431248,0.07520992003568754,-0.0020299073913910004,-0.001446242551957292,-0.0005836648394337083,0.002799999999999997,0.007021428571428574,1269440131.0899987,-0.005400000000000002,-10.964912280701766,-83.56807511737094,16.431924882629055,15.702937738951285,1.373283395755293,0.0824,0.0835,0.0796,0.0801,13743750.0,4025.0,8715092.0,-2.7912621359223255,33.84279475982534,0.10041593518880192,0.07441406481119807,-0.0019544767136010083,-0.001300326342098865,-0.0006541503715021433,0.0039000000000000007,0.007492857142857146,1254341692.0899987,-0.011700000000000002,-15.595363540569018,-88.73239436619718,11.267605633802814,19.731332866794826,0.08253333333333329,0.08151858106078817,0.08211428571428571,0.08268296629345599,0.08741499999999999,0.0852529735912049,18330.0,9399093.333333323,48560.0,11176529.0
2022-09-27,0.0811,0.0856,0.0798,0.0814,21804919.0,7792.0,12126136.0,0.08089999999999997,0.08172857142857144,0.086835,0.08137964526519705,0.082084168540069,0.08453678790572555,43.63636363636363,0.09868250029127841,0.07498749970872158,-0.002049918237051071,-0.0015669776889760479,-0.00048294054807502314,0.0058,0.006871428571428574,1291245050.0899987,-0.007400000000000004,-5.677867902665124,-82.62910798122068,17.37089201877932,15.023474178403754,0.3699136868064053,0.0801,0.0813,0.0785,0.0812,15098439.0,5357.0,8418258.0,1.373283395755293,38.4259259259259,0.10004007996431248,0.07520992003568754,-0.0020299073913910004,-0.001446242551957292,-0.0005836648394337083,0.002799999999999997,0.007021428571428574,1269440131.0899987,-0.005400000000000002,-10.964912280701766,-83.56807511737094,16.431924882629055,15.702937738951285,0.08119999999999995,0.08135929053039409,0.0819,0.08231222472009199,0.08762500000000001,0.08486697610632823,14423.0,8276447.99999999,47283.0,10562651.57142857
2022-09-28,0.0815,0.0912,0.0789,0.0848,54597896.0,17792.0,29584531.0,0.08246666666666663,0.08252857142857142,0.08642,0.08308982263259852,0.08276312640505175,0.08456185572422788,40.87193460490464,0.09791985812243123,0.07492014187756876,-0.0017710102872172118,-0.0016077842086242807,-0.00016322607859293103,0.012300000000000005,0.006628571428571431,1345842946.0899987,0.0039000000000000007,-7.322404371584701,-66.66666666666669,33.33333333333331,22.378716744913916,4.049079754601224,0.0811,0.0856,0.0798,0.0814,21804919.0,7792.0,12126136.0,0.3699136868064053,43.63636363636363,0.09868250029127841,0.07498749970872158,-0.002049918237051071,-0.0015669776889760479,-0.00048294054807502314,0.0058,0.006871428571428574,1291245050.0899987,-0.007400000000000004,-5.677867902665124,-82.62910798122068,17.37089201877932,15.023474178403754,0.08089999999999997,0.08137964526519705,0.08172857142857144,0.082084168540069,0.086835,0.08453678790572555,17174.0,9753161.99999999,49319.0,10535940.0
2022-09-29,0.0849,0.0858,0.0807,0.0829,22509993.0,6994.0,11091786.0,0.0830333333333333,0.08255714285714286,0.0858,0.08299491131629927,0.08279734480378881,0.0844035837504919,38.38120104438641,0.0965998050661861,0.07500019493381391,-0.0016838771608548575,-0.0016230027990703963,-6.0874361784461154e-05,0.005100000000000007,0.006142857142857145,1323332953.0899987,0.00020000000000000573,-9.694989106753816,-64.13793103448279,35.86206896551722,28.85543143920997,-2.3557126030624285,0.0815,0.0912,0.0789,0.0848,54597896.0,17792.0,29584531.0,4.049079754601224,40.87193460490464,0.09791985812243123,0.07492014187756876,-0.0017710102872172118,-0.0016077842086242807,-0.00016322607859293103,0.012300000000000005,0.006628571428571431,1345842946.0899987,0.0039000000000000007,-7.322404371584701,-66.66666666666669,33.33333333333331,22.378716744913916,0.08246666666666663,0.08308982263259852,0.08252857142857142,0.08276312640505175,0.08642,0.08456185572422788,30941.0,16709641.666666657,54194.0,12253590.285714285
2022-09-30,0.0829,0.0841,0.0812,0.0827,15641284.0,5202.0,7753713.0,0.08346666666666663,0.08220000000000001,0.08499,0.08284745565814963,0.0827730086028416,0.08424133767901648,44.144144144144136,0.09392129329906507,0.07605870670093492,-0.0016123753990512635,-0.0016208773190665698,8.501920015306294e-06,0.0029,0.00587857142857143,1307691669.0899987,9.999999999998899e-05,-4.5034642032332535,-63.235294117647136,36.76470588235287,35.32003606040116,-0.24125452352232296,0.0849,0.0858,0.0807,0.0829,22509993.0,6994.0,11091786.0,-2.3557126030624285,38.38120104438641,0.0965998050661861,0.07500019493381391,-0.0016838771608548575,-0.0016230027990703963,-6.0874361784461154e-05,0.005100000000000007,0.006142857142857145,1323332953.0899987,0.00020000000000000573,-9.694989106753816,-64.13793103448279,35.86206896551722,28.85543143920997,0.0830333333333333,0.08299491131629927,0.08255714285714286,0.08279734480378881,0.0858,0.0844035837504919,32578.0,17600817.666666657,56265.0,12773998.714285715
2022-10-01,0.0827,0.0835,0.081,0.081,6934414.0,3782.0,3090479.0,0.08219999999999995,0.0820142857142857,0.084295,0.08192372782907481,0.08232975645213121,0.08393263885244348,38.10975609756097,0.09206741410673336,0.07652258589326663,-0.0016735933873925912,-0.0016314205327317742,-4.217285466081699e-05,0.0025000000000000022,0.005714285714285715,1300757255.0899987,0.001799999999999996,-8.783783783783782,-75.55555555555557,24.44444444444443,32.357073097438196,-2.0556227327690366,0.0829,0.0841,0.0812,0.0827,15641284.0,5202.0,7753713.0,-0.24125452352232296,44.144144144144136,0.09392129329906507,0.07605870670093492,-0.0016123753990512635,-0.0016208773190665698,8.501920015306294e-06,0.0029,0.00587857142857143,1307691669.0899987,9.999999999998899e-05,-4.5034642032332535,-63.235294117647136,36.76470588235287,35.32003606040116,0.08346666666666663,0.08284745565814963,0.08220000000000001,0.0827730086028416,0.08499,0.08424133767901648,29988.0,16143343.333333323,52203.0,12197930.0
2022-10-02,0.0811,0.0813,0.078,0.0789,12790854.0,4484.0,6785620.0,0.08086666666666663,0.08184285714285713,0.08368,0.0804118639145374,0.0814723173390984,0.08345333991411552,46.29629629629629,0.09108997904636666,0.07627002095363335,-0.0018700052769774766,-0.001679137481580915,-0.0001908677953965617,0.0032999999999999974,0.005271428571428572,1287966401.0899987,-0.003799999999999998,-2.4721878862793645,-91.11111111111117,8.888888888888836,23.3660130718954,-2.712700369913696,0.0827,0.0835,0.081,0.081,6934414.0,3782.0,3090479.0,-2.0556227327690366,38.10975609756097,0.09206741410673336,0.07652258589326663,-0.0016735933873925912,-0.0016314205327317742,-4.217285466081699e-05,0.0025000000000000022,0.005714285714285715,1300757255.0899987,0.001799999999999996,-8.783783783783782,-75.55555555555557,24.44444444444443,32.357073097438196,0.08219999999999995,0.08192372782907481,0.0820142857142857,0.08232975645213121,0.084295,0.08393263885244348,15978.0,7311992.666666657,50944.0,11539999.285714285
2022-10-03,0.0788,0.0822,0.0781,0.0808,15035227.0,5338.0,7253900.0,0.0802333333333333,0.08178571428571428,0.083405,0.0806059319572687,0.0813042380043238,0.08320064087467594,46.494464944649444,0.09081380699212342,0.07599619300787659,-0.0018510116830399714,-0.0017135123218727263,-0.0001374993611672451,0.0040999999999999925,0.005142857142857143,1303001628.0899987,-0.004400000000000001,-2.297460701330112,-77.0370370370371,22.962962962962905,18.765432098765412,2.53807106598985,0.0811,0.0813,0.078,0.0789,12790854.0,4484.0,6785620.0,-2.712700369913696,46.29629629629629,0.09108997904636666,0.07627002095363335,-0.0018700052769774766,-0.001679137481580915,-0.0001908677953965617,0.0032999999999999974,0.005271428571428572,1287966401.0899987,-0.003799999999999998,-2.4721878862793645,-91.11111111111117,8.888888888888836,23.3660130718954,0.08086666666666663,0.0804118639145374,0.08184285714285713,0.0814723173390984,0.08368,0.08345333991411552,13468.0,5876603.99999999,51403.0,11264360.42857143
2022-10-04,0.0808,0.083,0.0802,0.0823,9947524.0,4016.0,4395568.0,0.08066666666666662,0.08191428571428572,0.08294499999999999,0.08145296597863436,0.08155317850324285,0.08311486555327822,49.4736842105263,0.08930589202567694,0.07658410797432304,-0.001695378392256558,-0.0017098855359494926,1.4507143692934696e-05,0.002800000000000011,0.004985714285714287,1312949152.0899987,0.0,-0.3631961259080052,-65.92592592592598,34.074074074074026,21.97530864197528,1.856435643564358,0.0788,0.0822,0.0781,0.0808,15035227.0,5338.0,7253900.0,2.53807106598985,46.494464944649444,0.09081380699212342,0.07599619300787659,-0.0018510116830399714,-0.0017135123218727263,-0.0001374993611672451,0.0040999999999999925,0.005142857142857143,1303001628.0899987,-0.004400000000000001,-2.297460701330112,-77.0370370370371,22.962962962962905,18.765432098765412,0.0802333333333333,0.0806059319572687,0.08178571428571428,0.0813042380043238,0.083405,0.08320064087467594,13604.0,5709999.666666657,51384.0,11098023.57142857
2022-10-05,0.0823,0.0828,0.0798,0.0813,9635605.0,3546.0,4802996.0,0.08146666666666662,0.08141428571428573,0.08242000000000001,0.08137648298931718,0.08148988387743214,0.08294202121487078,54.0229885057471,0.08725347973096845,0.07758652026903157,-0.001633895006118491,-0.0016946874299832923,6.079242386480138e-05,0.0030000000000000027,0.004507142857142858,1303313547.0899987,0.0011999999999999927,2.651515151515138,-75.00000000000003,24.999999999999975,27.345679012345656,-1.2150668286755781,0.0808,0.083,0.0802,0.0823,9947524.0,4016.0,4395568.0,1.856435643564358,49.4736842105263,0.08930589202567694,0.07658410797432304,-0.001695378392256558,-0.0017098855359494926,1.4507143692934696e-05,0.002800000000000011,0.004985714285714287,1312949152.0899987,0.0,-0.3631961259080052,-65.92592592592598,34.074074074074026,21.97530864197528,0.08066666666666662,0.08145296597863436,0.08191428571428572,0.08155317850324285,0.08294499999999999,0.08311486555327822,13838.0,6145029.333333324,47608.0,9993656.714285715
2022-10-06,0.0813,0.0824,0.0801,0.0807,8592197.0,3042.0,4403103.0,0.08143333333333329,0.08109999999999999,0.082125,0.08103824149465859,0.0812924129080741,0.08272849538488308,45.689655172413794,0.08659048164363925,0.07765951835636076,-0.0016149676237468547,-0.0016787434687360048,6.377584498915012e-05,0.0022999999999999965,0.004350000000000001,1294721350.0899987,-0.0005000000000000004,-2.4183796856106388,-79.5454545454546,20.454545454545404,26.509539842873156,-0.7380073800738048,0.0823,0.0828,0.0798,0.0813,9635605.0,3546.0,4802996.0,-1.2150668286755781,54.0229885057471,0.08725347973096845,0.07758652026903157,-0.001633895006118491,-0.0016946874299832923,6.079242386480138e-05,0.0030000000000000027,0.004507142857142858,1303313547.0899987,0.0011999999999999927,2.651515151515138,-75.00000000000003,24.999999999999975,27.345679012345656,0.08146666666666662,0.08137648298931718,0.08141428571428573,0.08148988387743214,0.08242000000000001,0.08294202121487078,12900.0,5484154.666666657,33362.0,6453437.428571428
2022-10-07,0.0807,0.0814,0.0787,0.08,8161052.0,2777.0,4747296.0,0.08066666666666662,0.08071428571428571,0.081685,0.0805191207473293,0.08096930968105558,0.08246863868156089,37.850467289719624,0.08495545787784009,0.0784145421221599,-0.0016375747444101335,-0.0016705097238708306,3.29349794606971e-05,0.002699999999999994,0.004114285714285714,1286560298.0899987,-0.0013999999999999985,-6.103286384976525,-84.84848484848484,15.15151515151516,20.2020202020202,-0.867410161090449,0.0813,0.0824,0.0801,0.0807,8592197.0,3042.0,4403103.0,-0.7380073800738048,45.689655172413794,0.08659048164363925,0.07765951835636076,-0.0016149676237468547,-0.0016787434687360048,6.377584498915012e-05,0.0022999999999999965,0.004350000000000001,1294721350.0899987,-0.0005000000000000004,-2.4183796856106388,-79.5454545454546,20.454545454545404,26.509539842873156,0.08143333333333329,0.08103824149465859,0.08109999999999999,0.0812924129080741,0.082125,0.08272849538488308,10604.0,4533888.99999999,29410.0,5497911.285714285
2022-10-08,0.0799,0.0887,0.0796,0.0811,45119622.0,9290.0,27740467.0,0.08059999999999996,0.08072857142857141,0.081695,0.08080956037366466,0.08100198226079168,0.08233829214045985,46.9387755102041,0.08495656242736033,0.07843343757263968,-0.0015488757677855208,-0.0016461829326537688,9.7307164868248e-05,0.009099999999999997,0.0044714285714285715,1331679920.0899987,-0.003699999999999995,-1.4580801944106825,-76.51515151515149,23.48484848484852,19.696969696969713,1.5018773466833624,0.0807,0.0814,0.0787,0.08,8161052.0,2777.0,4747296.0,-0.867410161090449,37.850467289719624,0.08495545787784009,0.0784145421221599,-0.0016375747444101335,-0.0016705097238708306,3.29349794606971e-05,0.002699999999999994,0.004114285714285714,1286560298.0899987,-0.0013999999999999985,-6.103286384976525,-84.84848484848484,15.15151515151516,20.2020202020202,0.08066666666666662,0.0805191207473293,0.08071428571428571,0.08096930968105558,0.081685,0.08246863868156089,9365.0,4651131.666666657,26985.0,5068423.142857143
2022-10-09,0.081,0.0833,0.0797,0.0826,45665838.0,6252.0,33860890.0,0.08123333333333331,0.08125714285714285,0.08169000000000001,0.08170478018683233,0.08140148669559376,0.0823632166985113,56.61375661375662,0.08494537611929788,0.07843462388070215,-0.0013420731420222543,-0.001585360974527466,0.0002432878325052117,0.003600000000000006,0.004450000000000001,1377345758.0899987,-0.0002999999999999947,3.121098626716612,-65.1515151515151,34.84848484848489,24.49494949494954,1.9753086419753139,0.0799,0.0887,0.0796,0.0811,45119622.0,9290.0,27740467.0,1.5018773466833624,46.9387755102041,0.08495656242736033,0.07843343757263968,-0.0015488757677855208,-0.0016461829326537688,9.7307164868248e-05,0.009099999999999997,0.0044714285714285715,1331679920.0899987,-0.003699999999999995,-1.4580801944106825,-76.51515151515149,23.48484848484852,19.696969696969713,0.08059999999999996,0.08080956037366466,0.08072857142857141,0.08100198226079168,0.081695,0.08233829214045985,15109.0,12296955.333333323,32493.0,8589850.0
2022-10-10,0.0827,0.0844,0.0797,0.0798,23634745.0,6269.0,13731725.0,0.08116666666666662,0.08111428571428572,0.08155,0.08075239009341617,0.08100111502169531,0.0821191008224626,46.60194174757282,0.08488056024909173,0.07821943975090827,-0.0013881158353185874,-0.0015459119466856904,0.00015779611136710302,0.00470000000000001,0.004585714285714288,1353711013.0899987,-0.0029,-1.7241379310344862,-86.3636363636364,13.636363636363601,23.98989898989902,-3.506650544135429,0.081,0.0833,0.0797,0.0826,45665838.0,6252.0,33860890.0,1.9753086419753139,56.61375661375662,0.08494537611929788,0.07843462388070215,-0.0013420731420222543,-0.001585360974527466,0.0002432878325052117,0.003600000000000006,0.004450000000000001,1377345758.0899987,-0.0002999999999999947,3.121098626716612,-65.1515151515151,34.84848484848489,24.49494949494954,0.08123333333333331,0.08170478018683233,0.08125714285714285,0.08140148669559376,0.08169000000000001,0.0823632166985113,18319.0,22116217.666666657,34261.0,12457745.714285715
2022-10-11,0.0798,0.0827,0.0788,0.0793,20102224.0,7074.0,9497415.0,0.08056666666666662,0.08068571428571428,0.081555,0.08002619504670808,0.08057583626627147,0.08185061502984711,44.976076555023916,0.08487097409585917,0.07823902590414084,-0.0014482562265300258,-0.0015263808026545578,7.812457612453192e-05,0.0039000000000000007,0.004450000000000002,1333608789.0899987,-0.001700000000000007,-2.5798525798525818,-90.15151515151518,9.848484848484812,19.444444444444454,-0.6265664160401008,0.0827,0.0844,0.0797,0.0798,23634745.0,6269.0,13731725.0,-3.506650544135429,46.60194174757282,0.08488056024909173,0.07821943975090827,-0.0013881158353185874,-0.0015459119466856904,0.00015779611136710302,0.00470000000000001,0.004585714285714288,1353711013.0899987,-0.0029,-1.7241379310344862,-86.3636363636364,13.636363636363601,23.98989898989902,0.08116666666666662,0.08075239009341617,0.08111428571428572,0.08100111502169531,0.08155,0.0821191008224626,21811.0,25111027.333333325,35192.0,13383149.285714285
2022-10-12,0.0792,0.081,0.079,0.0796,21615708.0,3448.0,15216699.0,0.07956666666666662,0.08044285714285715,0.0814,0.07981309752335404,0.08033187719970361,0.08163627074129025,35.39325842696633,0.08477981625071802,0.07802018374928198,-0.0014549387982594475,-0.0015120924017755358,5.715360351608834e-05,0.0020000000000000018,0.0037142857142857155,1355224497.0899987,0.0007000000000000062,-6.132075471698107,-85.04672897196258,14.95327102803742,12.8127065042953,0.505050505050502,0.0798,0.0827,0.0788,0.0793,20102224.0,7074.0,9497415.0,-0.6265664160401008,44.976076555023916,0.08487097409585917,0.07823902590414084,-0.0014482562265300258,-0.0015263808026545578,7.812457612453192e-05,0.0039000000000000007,0.004450000000000002,1333608789.0899987,-0.001700000000000007,-2.5798525798525818,-90.15151515151518,9.848484848484812,19.444444444444454,0.08056666666666662,0.08002619504670808,0.08068571428571428,0.08057583626627147,0.081555,0.08185061502984711,19595.0,19030009.99999999,38250.0,14111984.57142857
2022-10-13,0.0795,0.0848,0.0731,0.0821,55783400.0,16831.0,34139410.0,0.0803333333333333,0.08064285714285714,0.081245,0.08095654876167702,0.0807739078997777,0.08168043543259594,47.826086956521756,0.08414071370971228,0.07834928629028771,-0.0012441637328251265,-0.001458506667985454,0.0002143429351603276,0.011700000000000002,0.0041857142857142865,1411007897.0899987,0.0013000000000000095,-0.9650180940892539,-42.30769230769227,57.69230769230773,27.49802118961001,3.2704402515723334,0.0792,0.081,0.079,0.0796,21615708.0,3448.0,15216699.0,0.505050505050502,35.39325842696633,0.08477981625071802,0.07802018374928198,-0.0014549387982594475,-0.0015120924017755358,5.715360351608834e-05,0.0020000000000000018,0.0037142857142857155,1355224497.0899987,0.0007000000000000062,-6.132075471698107,-85.04672897196258,14.95327102803742,12.8127065042953,0.07956666666666662,0.07981309752335404,0.08044285714285715,0.08033187719970361,0.0814,0.08163627074129025,16791.0,12815279.666666657,38152.0,15599656.42857143
2022-10-14,0.0821,0.0846,0.0794,0.0807,33612096.0,7596.0,22942438.0,0.08079999999999997,0.08074285714285714,0.081165,0.0808282743808385,0.08075543092483328,0.08158706062949156,44.89795918367347,0.08402619224214478,0.07830380775785523,-0.0011765289808999407,-0.0014021111305683514,0.0002255821496684107,0.005199999999999996,0.004350000000000001,1377395801.0899987,-0.0016000000000000042,-2.4183796856106388,-51.28205128205132,48.71794871794869,40.45450914609796,-1.70523751522535,0.0795,0.0848,0.0731,0.0821,55783400.0,16831.0,34139410.0,3.2704402515723334,47.826086956521756,0.08414071370971228,0.07834928629028771,-0.0012441637328251265,-0.001458506667985454,0.0002143429351603276,0.011700000000000002,0.0041857142857142865,1411007897.0899987,0.0013000000000000095,-0.9650180940892539,-42.30769230769227,57.69230769230773,27.49802118961001,0.0803333333333333,0.08095654876167702,0.08064285714285714,0.0807739078997777,0.081245,0.08168043543259594,27353.0,19617841.333333325,51941.0,19847700.285714287
2022-10-15,0.0807,0.0848,0.0806,0.0821,20902855.0,7108.0,12614903.0,0.0816333333333333,0.0808857142857143,0.081265,0.08146413719041926,0.08109157319362496,0.0816359119981114,52.84974093264249,0.08410921851151552,0.07842078148848448,-0.000998450141290172,-0.0013213789327127154,0.0003229287914225435,0.004199999999999995,0.0044714285714285715,1398298656.0899987,0.000800000000000009,1.3580246913580396,-42.30769230769227,57.69230769230773,54.700854700854734,1.7348203221809324,0.0821,0.0846,0.0794,0.0807,33612096.0,7596.0,22942438.0,-1.70523751522535,44.89795918367347,0.08402619224214478,0.07830380775785523,-0.0011765289808999407,-0.0014021111305683514,0.0002255821496684107,0.005199999999999996,0.004350000000000001,1377395801.0899987,-0.0016000000000000042,-2.4183796856106388,-51.28205128205132,48.71794871794869,40.45450914609796,0.08079999999999997,0.0808282743808385,0.08074285714285714,0.08075543092483328,0.081165,0.08158706062949156,27875.0,24099515.666666657,56760.0,22447006.285714287
2022-10-16,0.0821,0.0945,0.0812,0.0853,55521194.0,21453.0,27675058.0,0.08269999999999997,0.08127142857142856,0.08147,0.08338206859520964,0.08214367989521872,0.08198487276019603,65.6862745098039,0.08483739787000798,0.07810260212999202,-0.0005922806784473128,-0.0011755592818596349,0.0005832786034123221,0.013300000000000006,0.0051857142857142866,1453819850.0899987,0.004600000000000007,8.111533586818753,-42.99065420560747,57.00934579439253,54.473200734883,3.897685749086473,0.0807,0.0848,0.0806,0.0821,20902855.0,7108.0,12614903.0,1.7348203221809324,52.84974093264249,0.08410921851151552,0.07842078148848448,-0.000998450141290172,-0.0013213789327127154,0.0003229287914225435,0.004199999999999995,0.0044714285714285715,1398298656.0899987,0.000800000000000009,1.3580246913580396,-42.30769230769227,57.69230769230773,54.700854700854734,0.0816333333333333,0.08146413719041926,0.0808857142857143,0.08109157319362496,0.081265,0.0816359119981114,31535.0,23232250.333333325,54578.0,20286211.42857143
2022-10-17,0.0855,0.0893,0.0828,0.0871,33567923.0,13207.0,15531848.0,0.0848333333333333,0.08231428571428571,0.081755,0.08524103429760482,0.08338275992141404,0.08247202773541545,65.51724137931032,0.08595849478588206,0.07755150521411792,-0.00012371735937159734,-0.0009651908973620275,0.0008414735379904301,0.006500000000000006,0.005357142857142859,1487387773.0899987,0.007099999999999995,7.797029702970293,-34.57943925233646,65.42056074766353,60.04073807812129,1.8713450292397547,0.0821,0.0945,0.0812,0.0853,55521194.0,21453.0,27675058.0,3.897685749086473,65.6862745098039,0.08483739787000798,0.07810260212999202,-0.0005922806784473128,-0.0011755592818596349,0.0005832786034123221,0.013300000000000006,0.0051857142857142866,1453819850.0899987,0.004600000000000007,8.111533586818753,-42.99065420560747,57.00934579439253,54.473200734883,0.08269999999999997,0.08338206859520964,0.08127142857142856,0.08214367989521872,0.08147,0.08198487276019603,36157.0,21077466.333333325,69779.0,19402521.14285714
2022-10-18,0.0873,0.0894,0.083,0.0846,24610739.0,10027.0,11004470.0,0.08566666666666663,0.08307142857142857,0.081745,0.08492051714880242,0.08368706994106054,0.08267469176061398,55.39906103286383,0.08591884084055754,0.07757115915944246,4.537033915633093e-05,-0.0007630786500583558,0.0008084489892146867,0.006399999999999989,0.005614285714285715,1462777034.0899987,0.0034999999999999892,2.79465370595382,-46.26168224299067,53.73831775700933,58.72274143302182,-3.092783505154648,0.0855,0.0893,0.0828,0.0871,33567923.0,13207.0,15531848.0,1.8713450292397547,65.51724137931032,0.08595849478588206,0.07755150521411792,-0.00012371735937159734,-0.0009651908973620275,0.0008414735379904301,0.006500000000000006,0.005357142857142859,1487387773.0899987,0.007099999999999995,7.797029702970293,-34.57943925233646,65.42056074766353,60.04073807812129,0.0848333333333333,0.08524103429760482,0.08231428571428571,0.08338275992141404,0.081755,0.08247202773541545,41768.0,18607269.666666657,76717.0,19659681.57142857
2022-10-19,0.0845,0.0854,0.0812,0.0813,11717581.0,5262.0,5436146.0,0.0843333333333333,0.08331428571428572,0.081665,0.08311025857440121,0.08309030245579539,0.08254376873579361,50.0,0.08580684042415292,0.07752315957584709,-8.591844791330794e-05,-0.0006276466096293463,0.0005417281617160383,0.004200000000000009,0.005700000000000001,1451059453.0899987,-0.0013000000000000095,0.0,-61.68224299065421,38.31775700934579,52.492211838006234,-3.7869822485207196,0.0873,0.0894,0.083,0.0846,24610739.0,10027.0,11004470.0,-3.092783505154648,55.39906103286383,0.08591884084055754,0.07757115915944246,4.537033915633093e-05,-0.0007630786500583558,0.0008084489892146867,0.006399999999999989,0.005614285714285715,1462777034.0899987,0.0034999999999999892,2.79465370595382,-46.26168224299067,53.73831775700933,58.72274143302182,0.08566666666666663,0.08492051714880242,0.08307142857142857,0.08368706994106054,0.081745,0.08267469176061398,44687.0,18070458.666666657,79670.0,19874975.14285714
2022-10-20,0.0813,0.0821,0.079,0.0807,8966665.0,4588.0,4077394.0,0.08219999999999995,0.08311428571428571,0.081565,0.0819051292872006,0.08249272684184654,0.08236817171333707,50.0,0.08569819043255661,0.07743180956744339,-0.00023566415347597847,-0.0005492501183986727,0.0003135859649226943,0.0031000000000000055,0.005757142857142858,1442092788.0899987,0.000899999999999998,0.0,-64.48598130841124,35.51401869158876,42.52336448598132,-0.7380073800738048,0.0845,0.0854,0.0812,0.0813,11717581.0,5262.0,5436146.0,-3.7869822485207196,50.0,0.08580684042415292,0.07752315957584709,-8.591844791330794e-05,-0.0006276466096293463,0.0005417281617160383,0.004200000000000009,0.005700000000000001,1451059453.0899987,-0.0013000000000000095,0.0,-61.68224299065421,38.31775700934579,52.492211838006234,0.0843333333333333,0.08311025857440121,0.08331428571428572,0.08309030245579539,0.081665,0.08254376873579361,28496.0,10657487.99999999,81484.0,18477753.285714287
2022-10-21,0.0807,0.0823,0.0774,0.0805,13701725.0,5656.0,6605925.0,0.0808333333333333,0.08308571428571428,0.08154,0.0812025646436003,0.0819945451313849,0.08219025059778116,51.08225108225108,0.085693578038294,0.077386421961706,-0.0003662550720395924,-0.0005126511091268567,0.00014639603708726428,0.004900000000000002,0.0059142857142857165,1428391063.0899987,0.0012000000000000066,0.6250000000000089,-65.42056074766353,34.57943925233646,36.13707165109036,-0.2478314745972638,0.0813,0.0821,0.079,0.0807,8966665.0,4588.0,4077394.0,-0.7380073800738048,50.0,0.08569819043255661,0.07743180956744339,-0.00023566415347597847,-0.0005492501183986727,0.0003135859649226943,0.0031000000000000055,0.005757142857142858,1442092788.0899987,0.000899999999999998,0.0,-64.48598130841124,35.51401869158876,42.52336448598132,0.08219999999999995,0.0819051292872006,0.08311428571428571,0.08249272684184654,0.081565,0.08236817171333707,19877.0,6839336.666666657,69241.0,14183179.57142857
2022-10-22,0.0805,0.0832,0.0803,0.0813,12369622.0,4559.0,6697938.0,0.0808333333333333,0.08297142857142857,0.08166,0.08125128232180015,0.08182090884853868,0.08210546482656392,50.43859649122805,0.08562691581036395,0.07769308418963604,-0.0004005783834835769,-0.0004902365639982008,8.965818051462392e-05,0.0029,0.005471428571428573,1440760685.0899987,0.0016999999999999932,0.2466091245376001,-61.68224299065421,38.31775700934579,36.137071651090366,0.9937888198757704,0.0807,0.0823,0.0774,0.0805,13701725.0,5656.0,6605925.0,-0.2478314745972638,51.08225108225108,0.085693578038294,0.077386421961706,-0.0003662550720395924,-0.0005126511091268567,0.00014639603708726428,0.004900000000000002,0.0059142857142857165,1428391063.0899987,0.0012000000000000066,0.6250000000000089,-65.42056074766353,34.57943925233646,36.13707165109036,0.0808333333333333,0.0812025646436003,0.08308571428571428,0.0819945451313849,0.08154,0.08219025059778116,15506.0,5373154.99999999,67301.0,11849392.0
2022-10-23,0.0814,0.0822,0.0798,0.0814,8252996.0,4043.0,3889315.0,0.08106666666666663,0.0824142857142857,0.08169,0.08132564116090008,0.08171568163640401,0.0820382777002245,47.19626168224298,0.0856385640286845,0.0777414359713155,-0.000414927663008241,-0.0004751747838002089,6.024712079196788e-05,0.0023999999999999994,0.005385714285714287,1449013681.0899987,-0.0007000000000000062,-1.4527845036319653,-61.21495327102804,38.78504672897197,37.227414330218096,0.0,0.0805,0.0832,0.0803,0.0813,12369622.0,4559.0,6697938.0,0.9937888198757704,50.43859649122805,0.08562691581036395,0.07769308418963604,-0.0004005783834835769,-0.0004902365639982008,8.965818051462392e-05,0.0029,0.005471428571428573,1440760685.0899987,0.0016999999999999932,0.2466091245376001,-61.68224299065421,38.31775700934579,36.137071651090366,0.0808333333333333,0.08125128232180015,0.08297142857142857,0.08182090884853868,0.08166,0.08210546482656392,14803.0,5793752.333333324,64752.0,11004111.285714285
2022-10-24,0.0814,0.0818,0.0794,0.0804,12439735.0,3730.0,7628723.0,0.08103333333333329,0.08145714285714287,0.081595,0.08086282058045004,0.08138676122730301,0.08188225125258407,51.530612244897966,0.08557308470103642,0.07761691529896358,-0.0005012135354220681,-0.0004803825341245808,-2.0831001297487363e-05,0.0023999999999999994,0.005221428571428572,1436573946.0899987,-0.0002999999999999947,0.7518796992481258,-65.88785046728972,34.112149532710276,37.071651090342705,-1.2285012285012296,0.0814,0.0822,0.0798,0.0814,8252996.0,4043.0,3889315.0,0.0,47.19626168224298,0.0856385640286845,0.0777414359713155,-0.000414927663008241,-0.0004751747838002089,6.024712079196788e-05,0.0023999999999999994,0.005385714285714287,1449013681.0899987,-0.0007000000000000062,-1.4527845036319653,-61.21495327102804,38.78504672897197,37.227414330218096,0.08106666666666663,0.08132564116090008,0.0824142857142857,0.08171568163640401,0.08169,0.0820382777002245,14258.0,5731059.333333324,47342.0,7606148.0
2022-10-25,0.0804,0.0839,0.0793,0.0816,13979457.0,5723.0,7324334.0,0.0811333333333333,0.08102857142857144,0.08160999999999999,0.08123141029022501,0.08144007092047725,0.0818553701809094,55.665024630541886,0.08558566280395173,0.07763433719604824,-0.0004673780960263857,-0.0004777816465049418,1.0403550478556105e-05,0.004600000000000007,0.005271428571428573,1450553403.0899987,-0.0005000000000000004,2.900378310214391,-60.28037383177567,39.71962616822433,37.538940809968885,1.4925373134328441,0.0814,0.0818,0.0794,0.0804,12439735.0,3730.0,7628723.0,-1.2285012285012296,51.530612244897966,0.08557308470103642,0.07761691529896358,-0.0005012135354220681,-0.0004803825341245808,-2.0831001297487363e-05,0.0023999999999999994,0.005221428571428572,1436573946.0899987,-0.0002999999999999947,0.7518796992481258,-65.88785046728972,34.112149532710276,37.071651090342705,0.08103333333333329,0.08086282058045004,0.08145714285714287,0.08138676122730301,0.081595,0.08188225125258407,12332.0,6071991.99999999,37865.0,6477130.142857143
2022-10-26,0.0817,0.0839,0.0813,0.0818,11614604.0,6038.0,5172578.0,0.08126666666666663,0.08109999999999999,0.081665,0.0815157051451125,0.08153005319035794,0.0818500968303466,55.44554455445543,0.08561802682086975,0.07771197317913026,-0.0004195881865736162,-0.0004661429545186767,4.655476794506049e-05,0.002600000000000005,0.005314285714285716,1462168007.0899987,-0.003500000000000003,2.7638190954773822,-59.34579439252337,40.65420560747663,38.161993769470435,0.12239902080783706,0.0804,0.0839,0.0793,0.0816,13979457.0,5723.0,7324334.0,1.4925373134328441,55.665024630541886,0.08558566280395173,0.07763433719604824,-0.0004673780960263857,-0.0004777816465049418,1.0403550478556105e-05,0.004600000000000007,0.005271428571428573,1450553403.0899987,-0.0005000000000000004,2.900378310214391,-60.28037383177567,39.71962616822433,37.538940809968885,0.0811333333333333,0.08123141029022501,0.08102857142857144,0.08144007092047725,0.08160999999999999,0.0818553701809094,13496.0,6280790.666666657,33561.0,5951396.428571428
2022-10-27,0.0817,0.0845,0.0805,0.081,14770717.0,7138.0,6297019.0,0.08146666666666663,0.08114285714285716,0.08171500000000001,0.08125785257255624,0.08139753989276846,0.08176913522745645,47.02702702702702,0.08560413466145586,0.07782586533854416,-0.00044118198188472513,-0.0004611507599918864,1.996877810716126e-05,0.0040000000000000036,0.004764285714285716,1447397290.0899987,-0.006099999999999994,-1.3398294762484775,-78.9473684210526,21.0526315789474,33.808821118216144,-0.8567931456548253,0.0817,0.0839,0.0813,0.0818,11614604.0,6038.0,5172578.0,0.12239902080783706,55.44554455445543,0.08561802682086975,0.07771197317913026,-0.0004195881865736162,-0.0004661429545186767,4.655476794506049e-05,0.002600000000000005,0.005314285714285716,1462168007.0899987,-0.003500000000000003,2.7638190954773822,-59.34579439252337,40.65420560747663,38.161993769470435,0.08126666666666663,0.0815157051451125,0.08109999999999999,0.08153005319035794,0.081665,0.0818500968303466,15491.0,6708544.99999999,34337.0,5913743.857142857
2022-10-28,0.0809,0.0835,0.0803,0.0822,9493762.0,4543.0,4705243.0,0.08166666666666662,0.08138571428571428,0.08177,0.08172892628627812,0.08159815491957634,0.08181016996769869,54.09836065573771,0.08565362283308701,0.07788637716691298,-0.0003573459869645329,-0.0004403898053864157,8.304381842188282e-05,0.0032000000000000084,0.004621428571428574,1456891052.0899987,-0.0023999999999999994,1.8587360594795488,-71.92982456140352,28.07017543859648,29.92567087500686,1.6069221260815767,0.0817,0.0845,0.0805,0.081,14770717.0,7138.0,6297019.0,-0.8567931456548253,47.02702702702702,0.08560413466145586,0.07782586533854416,-0.00044118198188472513,-0.0004611507599918864,1.996877810716126e-05,0.0040000000000000036,0.004764285714285716,1447397290.0899987,-0.006099999999999994,-1.3398294762484775,-78.9473684210526,21.0526315789474,33.808821118216144,0.08146666666666663,0.08125785257255624,0.08114285714285716,0.08139753989276846,0.08171500000000001,0.08176913522745645,18899.0,6264643.666666657,36887.0,6230833.142857143
2022-10-29,0.0823,0.088,0.0821,0.0842,20022535.0,8754.0,9856850.0,0.08246666666666663,0.0818,0.08185,0.08296446314313906,0.08224861618968225,0.08203777282791787,55.555555555555536,0.08586916461524191,0.0778308353847581,-0.00012804603667705694,-0.000377921051644544,0.00024987501496748704,0.005899999999999989,0.004742857142857145,1476913587.0899987,0.0029,2.5578562728379994,-60.23391812865497,39.76608187134502,29.629629629629658,2.3086269744835954,0.0809,0.0835,0.0803,0.0822,9493762.0,4543.0,4705243.0,1.6069221260815767,54.09836065573771,0.08565362283308701,0.07788637716691298,-0.0003573459869645329,-0.0004403898053864157,8.304381842188282e-05,0.0032000000000000084,0.004621428571428574,1456891052.0899987,-0.0023999999999999994,1.8587360594795488,-71.92982456140352,28.07017543859648,29.92567087500686,0.08166666666666662,0.08172892628627812,0.08138571428571428,0.08159815491957634,0.08177,0.08181016996769869,17719.0,5391613.333333324,35774.0,5959307.142857143
2022-10-30,0.0841,0.0865,0.083,0.084,12976706.0,7261.0,6870890.0,0.08346666666666662,0.08217142857142856,0.08206,0.08348223157156953,0.08268646214226169,0.0822246516062114,45.911949685534594,0.08606704642430313,0.07805295357569686,3.710971966416898e-05,-0.00029491489738280144,0.0003320246170469704,0.0034999999999999892,0.004042857142857144,1463936881.0899987,0.0033000000000000113,-1.5240328253223856,-44.999999999999915,55.000000000000085,40.94541910331389,-0.11890606420926159,0.0823,0.088,0.0821,0.0842,20022535.0,8754.0,9856850.0,2.3086269744835954,55.555555555555536,0.08586916461524191,0.0778308353847581,-0.00012804603667705694,-0.000377921051644544,0.00024987501496748704,0.005899999999999989,0.004742857142857145,1476913587.0899987,0.0029,2.5578562728379994,-60.23391812865497,39.76608187134502,29.629629629629658,0.08246666666666663,0.08296446314313906,0.0818,0.08224861618968225,0.08185,0.08203777282791787,20435.0,6953037.333333324,39969.0,6410580.285714285
2022-10-31,0.0842,0.0868,0.0833,0.0851,17990536.0,5503.0,10303643.0,0.08443333333333329,0.08284285714285713,0.08234999999999999,0.08429111578578477,0.08328984660669626,0.08249849431038174,43.421052631578924,0.08635552250277144,0.07834447749722855,0.00025383164022024785,-0.00018516558986219158,0.00043899723008243943,0.003500000000000003,0.003828571428571429,1481927417.0899987,0.004599999999999993,-2.296211251435132,-35.83333333333333,64.16666666666667,52.97758284600395,1.068883610451304,0.0841,0.0865,0.083,0.084,12976706.0,7261.0,6870890.0,-0.11890606420926159,45.911949685534594,0.08606704642430313,0.07805295357569686,3.710971966416898e-05,-0.00029491489738280144,0.0003320246170469704,0.0034999999999999892,0.004042857142857144,1463936881.0899987,0.0033000000000000113,-1.5240328253223856,-44.999999999999915,55.000000000000085,40.94541910331389,0.08346666666666662,0.08348223157156953,0.08217142857142856,0.08268646214226169,0.08206,0.0822246516062114,20558.0,7144327.666666657,43187.0,6836519.571428572
2022-11-01,0.0851,0.0858,0.0819,0.0827,12801592.0,6241.0,6088165.0,0.08393333333333329,0.08299999999999999,0.082505,0.08349555789289238,0.0831423849550222,0.08251768532844063,43.708609271523166,0.08629666676225638,0.07871333323774361,0.00022928235700668542,-0.00010227600048841619,0.0003315583574951016,0.0039000000000000007,0.0036500000000000013,1469125825.0899987,0.0013999999999999985,-2.245862884160754,-50.0,50.0,56.38888888888894,-2.820211515863689,0.0842,0.0868,0.0833,0.0851,17990536.0,5503.0,10303643.0,1.068883610451304,43.421052631578924,0.08635552250277144,0.07834447749722855,0.00025383164022024785,-0.00018516558986219158,0.00043899723008243943,0.003500000000000003,0.003828571428571429,1481927417.0899987,0.004599999999999993,-2.296211251435132,-35.83333333333333,64.16666666666667,52.97758284600395,0.08443333333333329,0.08429111578578477,0.08284285714285713,0.08328984660669626,0.08234999999999999,0.08249849431038174,21518.0,9010460.99999999,44960.0,7218651.0
2022-11-02,0.0827,0.0834,0.0789,0.0801,16125454.0,7621.0,7454482.0,0.0826333333333333,0.08275714285714286,0.08240499999999999,0.08179777894644619,0.08238178871626665,0.08228742958287485,45.83333333333335,0.08634426255377545,0.07846573744622454,2.8276346403233177e-08,-8.18151451214523e-05,8.184342146785554e-05,0.004500000000000004,0.0036714285714285724,1453000371.0899987,-0.0012999999999999956,-1.4760147601475926,-74.52830188679236,25.471698113207626,46.54612159329145,-3.1438935912938226,0.0851,0.0858,0.0819,0.0827,12801592.0,6241.0,6088165.0,-2.820211515863689,43.708609271523166,0.08629666676225638,0.07871333323774361,0.00022928235700668542,-0.00010227600048841619,0.0003315583574951016,0.0039000000000000007,0.0036500000000000013,1469125825.0899987,0.0013999999999999985,-2.245862884160754,-50.0,50.0,56.38888888888894,0.08393333333333329,0.08349555789289238,0.08299999999999999,0.0831423849550222,0.082505,0.08251768532844063,19005.0,7754232.666666657,45478.0,7042055.428571428
2022-11-03,0.0801,0.093,0.08,0.0871,43084354.0,18339.0,23573952.0,0.08329999999999996,0.08362857142857143,0.08272499999999999,0.0844488894732231,0.08356134153719999,0.08274576962260105,65.38461538461543,0.08709710054227851,0.07835289945772148,0.00037881749205306847,1.0311382313451855e-05,0.0003685061097396166,0.012999999999999998,0.004378571428571429,1496084725.0899987,0.006699999999999998,7.930607187112759,-37.82051282051283,62.17948717948717,45.88372843089829,8.739076154806481,0.0827,0.0834,0.0789,0.0801,16125454.0,7621.0,7454482.0,-3.1438935912938226,45.83333333333335,0.08634426255377545,0.07846573744622454,2.8276346403233177e-08,-8.18151451214523e-05,8.184342146785554e-05,0.004500000000000004,0.0036714285714285724,1453000371.0899987,-0.0012999999999999956,-1.4760147601475926,-74.52830188679236,25.471698113207626,46.54612159329145,0.0826333333333333,0.08179777894644619,0.08275714285714286,0.08238178871626665,0.08240499999999999,0.08228742958287485,19365.0,7948763.333333324,47061.0,7368041.714285715
2022-11-04,0.0872,0.093,0.0862,0.0905,34510803.0,14147.0,19671672.0,0.08589999999999998,0.0848142857142857,0.083145,0.08747444473661155,0.0852960061529,0.08348426775378191,70.83333333333337,0.08871426717225954,0.07757573282774045,0.0009424977323696515,0.00019674865232469178,0.0007457490800449598,0.0068000000000000005,0.004514285714285715,1530595528.0899987,0.008899999999999991,12.422360248447205,-17.730496453900724,82.26950354609927,56.640229612931385,3.7844036697247674,0.0801,0.093,0.08,0.0871,43084354.0,18339.0,23573952.0,8.739076154806481,65.38461538461543,0.08709710054227851,0.07835289945772148,0.00037881749205306847,1.0311382313451855e-05,0.0003685061097396166,0.012999999999999998,0.004378571428571429,1496084725.0899987,0.006699999999999998,7.930607187112759,-37.82051282051283,62.17948717948717,45.88372843089829,0.08329999999999996,0.0844488894732231,0.08362857142857143,0.08356134153719999,0.08272499999999999,0.08274576962260105,32201.0,12372199.666666657,58262.0,9836175.0
2022-11-05,0.0904,0.0944,0.0883,0.0888,16867375.0,8074.0,8531058.0,0.08879999999999998,0.08547142857142857,0.08331999999999999,0.08813722236830578,0.086172004614675,0.08399052796770745,65.06024096385546,0.08937330705562622,0.07726669294437376,0.001237774299770164,0.00040495378181378623,0.0008328205179563778,0.006099999999999994,0.004742857142857143,1513728153.0899987,0.007000000000000006,9.225092250922518,-36.12903225806448,63.87096774193552,69.43998615584069,-1.7699115044247684,0.0872,0.093,0.0862,0.0905,34510803.0,14147.0,19671672.0,3.7844036697247674,70.83333333333337,0.08871426717225954,0.07757573282774045,0.0009424977323696515,0.00019674865232469178,0.0007457490800449598,0.0068000000000000005,0.004514285714285715,1530595528.0899987,0.008899999999999991,12.422360248447205,-17.730496453900724,82.26950354609927,56.640229612931385,0.08589999999999998,0.08747444473661155,0.0848142857142857,0.0852960061529,0.083145,0.08348426775378191,40107.0,16900035.333333325,67866.0,11974236.285714285
2022-11-06,0.0887,0.1017,0.0878,0.0887,42045615.0,23777.0,20842126.0,0.0893333333333333,0.08614285714285715,0.0834,0.0884186111841529,0.08680400346100625,0.08443904911364009,64.65863453815264,0.08970087713143851,0.07709912286856149,0.0014470334417532454,0.000613369713801678,0.0008336637279515674,0.013899999999999996,0.005564285714285714,1471682538.0899987,0.0076999999999999985,8.968058968058967,-57.01754385964911,42.98245614035089,63.04097580946191,0.0,0.0904,0.0944,0.0883,0.0888,16867375.0,8074.0,8531058.0,-1.7699115044247684,65.06024096385546,0.08937330705562622,0.07726669294437376,0.001237774299770164,0.00040495378181378623,0.0008328205179563778,0.006099999999999994,0.004742857142857143,1513728153.0899987,0.007000000000000006,9.225092250922518,-36.12903225806448,63.87096774193552,69.43998615584069,0.08879999999999998,0.08813722236830578,0.08547142857142857,0.086172004614675,0.08331999999999999,0.08399052796770745,40560.0,17258893.99999999,67186.0,11784837.42857143
2022-11-07,0.0887,0.0914,0.086,0.0879,14332224.0,8084.0,6358634.0,0.08846666666666664,0.08654285714285714,0.083565,0.08815930559207645,0.08707800259575468,0.0847686634837696,65.18218623481786,0.0901639712112222,0.0769660287887778,0.0015306748385576219,0.0007968307387528668,0.000733844099804755,0.005400000000000002,0.005778571428571429,1457350314.0899987,0.005700000000000011,9.328358208955233,-60.52631578947365,39.47368421052635,48.77570269760428,-0.9019165727170183,0.0887,0.1017,0.0878,0.0887,42045615.0,23777.0,20842126.0,0.0,64.65863453815264,0.08970087713143851,0.07709912286856149,0.0014470334417532454,0.000613369713801678,0.0008336637279515674,0.013899999999999996,0.005564285714285714,1471682538.0899987,0.0076999999999999985,8.968058968058967,-57.01754385964911,42.98245614035089,63.04097580946191,0.0893333333333333,0.0884186111841529,0.08614285714285715,0.08680400346100625,0.0834,0.08443904911364009,45998.0,16348285.333333323,83702.0,13780728.285714285
2022-11-08,0.0878,0.0892,0.0715,0.0771,33889339.0,14959.0,16690119.0,0.08456666666666664,0.08574285714285713,0.083355,0.08262965279603823,0.084583501946816,0.08403831458055344,43.440233236151585,0.09050201998953042,0.07620798001046958,0.0007172237980076768,0.0007809093506038288,-6.368555259615206e-05,0.017700000000000007,0.006714285714285714,1423460975.0899987,-0.007099999999999995,-5.514705882352944,-81.45695364238408,18.543046357615918,33.666395569497745,-12.186788154897494,0.0887,0.0914,0.086,0.0879,14332224.0,8084.0,6358634.0,-0.9019165727170183,65.18218623481786,0.0901639712112222,0.0769660287887778,0.0015306748385576219,0.0007968307387528668,0.000733844099804755,0.005400000000000002,0.005778571428571429,1457350314.0899987,0.005700000000000011,9.328358208955233,-60.52631578947365,39.47368421052635,48.77570269760428,0.08846666666666664,0.08815930559207645,0.08654285714285714,0.08707800259575468,0.083565,0.0847686634837696,39935.0,11910605.99999999,86283.0,13217155.57142857
2022-11-09,0.077,0.0775,0.0578,0.06,41272196.0,16683.0,20189714.0,0.07499999999999997,0.08287142857142858,0.08232,0.07131482639801912,0.078437626460112,0.0817489512871674,28.71093749999997,0.09496588137629663,0.06967411862370337,-0.001292371447984525,0.0003662531908861581,-0.001658624638870683,0.019700000000000002,0.007935714285714286,1382188779.0899987,-0.024000000000000007,-26.650366748166256,-94.9886104783599,5.011389521640092,21.00937336326081,-22.07792207792208,0.0878,0.0892,0.0715,0.0771,33889339.0,14959.0,16690119.0,-12.186788154897494,43.440233236151585,0.09050201998953042,0.07620798001046958,0.0007172237980076768,0.0007809093506038288,-6.368555259615206e-05,0.017700000000000007,0.006714285714285714,1423460975.0899987,-0.007099999999999995,-5.514705882352944,-81.45695364238408,18.543046357615918,33.666395569497745,0.08456666666666664,0.08262965279603823,0.08574285714285713,0.084583501946816,0.083355,0.08403831458055344,46820.0,14630292.99999999,95001.0,14731720.42857143
2022-11-10,0.0598,0.0707,0.059,0.0689,27065596.0,11152.0,13456885.0,0.06866666666666663,0.08027142857142856,0.08174000000000001,0.07010741319900957,0.07605321984508401,0.08052524164077052,39.79763912310286,0.09572998137744484,0.06775001862255517,-0.0021421412680868585,-0.00013542570090844521,-0.0020067155671784132,0.011700000000000002,0.008485714285714286,1409254375.0899987,-0.016199999999999992,-14.938271604938269,-74.71526195899771,25.284738041002292,16.279724640086126,15.217391304347833,0.077,0.0775,0.0578,0.06,41272196.0,16683.0,20189714.0,-22.07792207792208,28.71093749999997,0.09496588137629663,0.06967411862370337,-0.001292371447984525,0.0003662531908861581,-0.001658624638870683,0.019700000000000002,0.007935714285714286,1382188779.0899987,-0.024000000000000007,-26.650366748166256,-94.9886104783599,5.011389521640092,21.00937336326081,0.07499999999999997,0.07131482639801912,0.08287142857142858,0.078437626460112,0.08232,0.0817489512871674,39726.0,14412822.333333323,104063.0,16551039.285714285
2022-11-11,0.0688,0.0691,0.0621,0.0649,19934431.0,7999.0,9997284.0,0.06459999999999998,0.07661428571428572,0.08091999999999999,0.06750370659950478,0.07326491488381301,0.07903712338926856,36.07085346215781,0.09681181848407275,0.06502818151592724,-0.0031025917964509486,-0.000728858920016946,-0.0023737328764340026,0.006999999999999992,0.008757142857142856,1389319944.0899987,-0.017799999999999996,-21.046228710462277,-83.82687927107061,16.173120728929387,15.489749430523949,-5.668604651162791,0.0598,0.0707,0.059,0.0689,27065596.0,11152.0,13456885.0,15.217391304347833,39.79763912310286,0.09572998137744484,0.06775001862255517,-0.0021421412680868585,-0.00013542570090844521,-0.0020067155671784132,0.011700000000000002,0.008485714285714286,1409254375.0899987,-0.016199999999999992,-14.938271604938269,-74.71526195899771,25.284738041002292,16.279724640086126,0.06866666666666663,0.07010741319900957,0.08027142857142856,0.07605321984508401,0.08174000000000001,0.08052524164077052,42794.0,16778905.99999999,96876.0,15105744.0
2022-11-12,0.0651,0.0655,0.0614,0.0617,9074142.0,4427.0,3806551.0,0.06516666666666664,0.07274285714285714,0.079935,0.06460185329975239,0.07037368616285976,0.0773859687807668,32.22748815165876,0.09799563180086715,0.06187436819913286,-0.0040749950104518595,-0.0013980861381039287,-0.002676908872347931,0.0040999999999999995,0.008628571428571428,1380245802.0899987,-0.018400000000000007,-26.72209026128266,-91.11617312072893,8.883826879271071,16.78056188306761,-5.22273425499233,0.0688,0.0691,0.0621,0.0649,19934431.0,7999.0,9997284.0,-5.668604651162791,36.07085346215781,0.09681181848407275,0.06502818151592724,-0.0031025917964509486,-0.000728858920016946,-0.0023737328764340026,0.006999999999999992,0.008757142857142856,1389319944.0899987,-0.017799999999999996,-21.046228710462277,-83.82687927107061,16.173120728929387,15.489749430523949,0.06459999999999998,0.06750370659950478,0.07661428571428572,0.07326491488381301,0.08091999999999999,0.07903712338926856,35834.0,14547960.99999999,90728.0,13723688.57142857
2022-11-13,0.0616,0.0635,0.0584,0.0601,15255579.0,6762.0,7218854.0,0.0622333333333333,0.06865714285714286,0.07892,0.062350926649876195,0.06780526462214481,0.07573968603974139,31.53013910355486,0.09903541435642554,0.05880458564357446,-0.004918046018453123,-0.002102078114173768,-0.0028159679042793553,0.0051,0.008742857142857144,1364990223.0899987,-0.026999999999999996,-28.452380952380953,-94.76082004555808,5.239179954441921,10.098709187547485,-2.435064935064937,0.0651,0.0655,0.0614,0.0617,9074142.0,4427.0,3806551.0,-5.22273425499233,32.22748815165876,0.09799563180086715,0.06187436819913286,-0.0040749950104518595,-0.0013980861381039287,-0.002676908872347931,0.0040999999999999995,0.008628571428571428,1380245802.0899987,-0.018400000000000007,-26.72209026128266,-91.11617312072893,8.883826879271071,16.78056188306761,0.06516666666666664,0.06460185329975239,0.07274285714285714,0.07037368616285976,0.079935,0.0773859687807668,23578.0,9086906.666666657,87081.0,13048759.0
2022-11-14,0.0602,0.0638,0.0569,0.0634,16698188.0,8128.0,8615329.0,0.061733333333333286,0.06515714285714284,0.07801,0.0628754633249381,0.06670394846660861,0.0745644778454803,33.78176382660688,0.0992312306799767,0.05678876932002329,-0.005259262095736697,-0.002733514910486354,-0.002525747185250343,0.006899999999999996,0.008985714285714286,1381688411.0899987,-0.0271,-25.49941245593419,-85.49107142857143,14.50892857142857,9.543978468380546,5.315614617940202,0.0616,0.0635,0.0584,0.0601,15255579.0,6762.0,7218854.0,-2.435064935064937,31.53013910355486,0.09903541435642554,0.05880458564357446,-0.004918046018453123,-0.002102078114173768,-0.0028159679042793553,0.0051,0.008742857142857144,1364990223.0899987,-0.026999999999999996,-28.452380952380953,-94.76082004555808,5.239179954441921,10.098709187547485,0.0622333333333333,0.062350926649876195,0.06865714285714286,0.06780526462214481,0.07892,0.07573968603974139,19188.0,7007562.99999999,70066.0,11102577.285714285
2022-11-15,0.0633,0.0646,0.061,0.0625,12576851.0,5581.0,5942991.0,0.061999999999999965,0.06307142857142857,0.077045,0.06268773166246905,0.06565296134995646,0.07341547995543457,34.5565749235474,0.09927200822716965,0.05481799177283035,-0.0055384568902382275,-0.003294503306436729,-0.0022439535838014984,0.003600000000000006,0.008964285714285715,1369111560.0899987,-0.026300000000000004,-24.425634824667462,-87.5,12.500000000000004,10.749369508623522,-1.2638230647709245,0.0602,0.0638,0.0569,0.0634,16698188.0,8128.0,8615329.0,5.315614617940202,33.78176382660688,0.0992312306799767,0.05678876932002329,-0.005259262095736697,-0.002733514910486354,-0.002525747185250343,0.006899999999999996,0.008985714285714286,1381688411.0899987,-0.0271,-25.49941245593419,-85.49107142857143,14.50892857142857,9.543978468380546,0.061733333333333286,0.0628754633249381,0.06515714285714284,0.06670394846660861,0.07801,0.0745644778454803,19317.0,6546911.333333324,70110.0,11424962.285714285
2022-11-16,0.0626,0.0642,0.0596,0.0608,8452289.0,4350.0,3822651.0,0.0622333333333333,0.06318571428571428,0.07603499999999999,0.06174386583123452,0.06443972101246735,0.07221400567396462,35.03875968992247,0.099316099178114,0.05275390082188598,-0.005829695468377735,-0.0038015417388249303,-0.002028153729552805,0.004599999999999993,0.008971428571428571,1360659271.0899987,-0.0279,-24.094881398252188,-91.29464285714286,8.705357142857144,11.904761904761932,-2.875399361022369,0.0633,0.0646,0.061,0.0625,12576851.0,5581.0,5942991.0,-1.2638230647709245,34.5565749235474,0.09927200822716965,0.05481799177283035,-0.0055384568902382275,-0.003294503306436729,-0.0022439535838014984,0.003600000000000006,0.008964285714285715,1369111560.0899987,-0.026300000000000004,-24.425634824667462,-87.5,12.500000000000004,10.749369508623522,0.061999999999999965,0.06268773166246905,0.06307142857142857,0.06565296134995646,0.077045,0.07341547995543457,20471.0,7259057.99999999,60732.0,9889658.285714285
2022-11-17,0.0607,0.0615,0.0593,0.0603,5310811.0,2808.0,2588142.0,0.061199999999999956,0.061957142857142856,0.07493999999999999,0.061021932915617264,0.06340479075935052,0.07107933846692037,26.896551724137936,0.09904567961015583,0.05083432038984416,-0.006031324605457078,-0.00424749831215136,-0.001783826293305718,0.0022000000000000006,0.008199999999999999,1355348460.0899987,-0.027600000000000006,-30.76923076923077,-92.41071428571429,7.589285714285715,9.598214285714313,-0.6589785831960422,0.0626,0.0642,0.0596,0.0608,8452289.0,4350.0,3822651.0,-2.875399361022369,35.03875968992247,0.099316099178114,0.05275390082188598,-0.005829695468377735,-0.0038015417388249303,-0.002028153729552805,0.004599999999999993,0.008971428571428571,1360659271.0899987,-0.0279,-24.094881398252188,-91.29464285714286,8.705357142857144,11.904761904761932,0.0622333333333333,0.06174386583123452,0.06318571428571428,0.06443972101246735,0.07603499999999999,0.07221400567396462,18059.0,6126990.333333324,48399.0,7551506.428571428
2022-11-18,0.0601,0.0618,0.0594,0.06,8782934.0,3278.0,5409467.0,0.060366666666666624,0.06125714285714286,0.07372999999999999,0.06051096645780863,0.06255359306951289,0.07002416337483272,22.22222222222223,0.09830350734330932,0.049156492656690656,-0.0061444947315966725,-0.004626897596040423,-0.0015175971355562493,0.0023999999999999994,0.007885714285714286,1346565526.0899987,-0.017100000000000004,-33.70165745856354,-93.08035714285715,6.919642857142853,7.738095238095262,-0.16638935108153555,0.0607,0.0615,0.0593,0.0603,5310811.0,2808.0,2588142.0,-0.6589785831960422,26.896551724137936,0.09904567961015583,0.05083432038984416,-0.006031324605457078,-0.00424749831215136,-0.001783826293305718,0.0022000000000000006,0.008199999999999999,1355348460.0899987,-0.027600000000000006,-30.76923076923077,-92.41071428571429,7.589285714285715,9.598214285714313,0.061199999999999956,0.061021932915617264,0.061957142857142856,0.06340479075935052,0.07493999999999999,0.07107933846692037,12739.0,4117927.99999999,40055.0,5998828.857142857
2022-11-19,0.06,0.0607,0.0592,0.0599,8713345.0,2286.0,5716021.0,0.06006666666666663,0.061,0.072525,0.060205483228904316,0.06189019480213467,0.06905995733913436,22.889305816135092,0.09734043450087973,0.04770956549912028,-0.006171115260833124,-0.004935741128998963,-0.0012353741318341608,0.0014999999999999944,0.007557142857142857,1337852181.0899987,-9.999999999999593e-05,-32.54504504504505,-93.30357142857142,6.6964285714285765,7.068452380952407,-0.16666666666665989,0.0601,0.0618,0.0594,0.06,8782934.0,3278.0,5409467.0,-0.16638935108153555,22.22222222222223,0.09830350734330932,0.049156492656690656,-0.0061444947315966725,-0.004626897596040423,-0.0015175971355562493,0.0023999999999999994,0.007885714285714286,1346565526.0899987,-0.017100000000000004,-33.70165745856354,-93.08035714285715,6.919642857142853,7.738095238095262,0.060366666666666624,0.06051096645780863,0.06125714285714286,0.06255359306951289,0.07372999999999999,0.07002416337483272,10436.0,3940086.6666666567,35334.0,5343426.428571428
2022-11-20,0.0598,0.0625,0.0567,0.0571,17054734.0,6771.0,8157448.0,0.05899999999999996,0.06057142857142857,0.07112500000000001,0.05865274161445216,0.060692646101600994,0.06792091378302632,21.785714285714278,0.09611205980879878,0.04613794019120124,-0.006345007524356461,-0.005217594408070463,-0.001127413116285998,0.0058,0.006978571428571429,1320797447.0899987,-0.011800000000000005,-35.62570462232244,-98.84726224783861,1.1527377521613764,4.9229363935776265,-4.515050167224082,0.06,0.0607,0.0592,0.0599,8713345.0,2286.0,5716021.0,-0.16666666666665989,22.889305816135092,0.09734043450087973,0.04770956549912028,-0.006171115260833124,-0.004935741128998963,-0.0012353741318341608,0.0014999999999999944,0.007557142857142857,1337852181.0899987,-9.999999999999593e-05,-32.54504504504505,-93.30357142857142,6.6964285714285765,7.068452380952407,0.06006666666666663,0.060205483228904316,0.061,0.06189019480213467,0.072525,0.06905995733913436,8372.0,4571209.99999999,33193.0,5616207.857142857
2022-11-21,0.057,0.0571,0.054,0.0547,17452783.0,6579.0,8901152.0,0.057233333333333296,0.05932857142857143,0.06972500000000001,0.05667637080722608,0.059194484576200745,0.06666177913702381,21.180555555555557,0.09511574634574047,0.04433425365425955,-0.006600393115158441,-0.0054941541494880584,-0.001106238965670383,0.0030999999999999986,0.006814285714285713,1303344664.0899987,-0.0102,-37.77019340159272,-98.01136363636364,1.988636363636361,3.2792675624087964,-4.035087719298251,0.0598,0.0625,0.0567,0.0571,17054734.0,6771.0,8157448.0,-4.515050167224082,21.785714285714278,0.09611205980879878,0.04613794019120124,-0.006345007524356461,-0.005217594408070463,-0.001127413116285998,0.0058,0.006978571428571429,1320797447.0899987,-0.011800000000000005,-35.62570462232244,-98.84726224783861,1.1527377521613764,4.9229363935776265,0.05899999999999996,0.05865274161445216,0.06057142857142857,0.060692646101600994,0.07112500000000001,0.06792091378302632,12335.0,6427645.333333324,33202.0,5750292.714285715
2022-11-22,0.0547,0.0569,0.0527,0.0569,17918656.0,6366.0,9034087.0,0.05623333333333328,0.05852857142857143,0.068565,0.05678818540361304,0.05862086343215056,0.06573208588587869,29.387755102040813,0.09407951805487741,0.0430504819451226,-0.006549764810343375,-0.005705276281659122,-0.0008444885286842535,0.004200000000000002,0.005849999999999999,1321263320.0899987,-0.004799999999999999,-26.199740596627763,-83.06451612903226,16.93548387096775,6.692285995588521,4.021937842778795,0.057,0.0571,0.054,0.0547,17452783.0,6579.0,8901152.0,-4.035087719298251,21.180555555555557,0.09511574634574047,0.04433425365425955,-0.006600393115158441,-0.0054941541494880584,-0.001106238965670383,0.0030999999999999986,0.006814285714285713,1303344664.0899987,-0.0102,-37.77019340159272,-98.01136363636364,1.988636363636361,3.2792675624087964,0.057233333333333296,0.05667637080722608,0.05932857142857143,0.059194484576200745,0.06972500000000001,0.06666177913702381,15636.0,7591540.333333324,31653.0,5791124.571428572
2022-11-23,0.0569,0.0777,0.0563,0.0641,156575234.0,65915.0,75817285.0,0.05856666666666663,0.059000000000000004,0.067415,0.06044409270180652,0.05999064757411292,0.06557664913484262,55.24296675191817,0.09144193882847725,0.04338806117152276,-0.0058610985907835075,-0.005736440743483999,-0.00012465784729950857,0.021400000000000002,0.00597142857142857,1477838554.0899987,0.0040000000000000036,6.833333333333336,-54.399999999999984,45.600000000000016,21.5080400782014,12.653778558875228,0.0547,0.0569,0.0527,0.0569,17918656.0,6366.0,9034087.0,4.021937842778795,29.387755102040813,0.09407951805487741,0.0430504819451226,-0.006549764810343375,-0.005705276281659122,-0.0008444885286842535,0.004200000000000002,0.005849999999999999,1321263320.0899987,-0.004799999999999999,-26.199740596627763,-83.06451612903226,16.93548387096775,6.692285995588521,0.05623333333333328,0.05678818540361304,0.05852857142857143,0.05862086343215056,0.068565,0.06573208588587869,19716.0,8697562.333333323,32438.0,6232709.714285715
2022-11-24,0.064,0.07,0.0605,0.0629,69447673.0,25314.0,31644211.0,0.061299999999999966,0.05937142857142857,0.066035,0.06167204635090326,0.06071798568058469,0.06532173016961952,40.445859872611464,0.08751461334538799,0.044555386654612006,-0.0053504786342532945,-0.005659248321637858,0.00030876968738456374,0.009500000000000008,0.0058142857142857145,1408390881.0899987,-0.0005000000000000004,-8.70827285921626,-59.20000000000001,40.79999999999999,34.44516129032261,-1.7187500000000058,0.0569,0.0777,0.0563,0.0641,156575234.0,65915.0,75817285.0,12.653778558875228,55.24296675191817,0.09144193882847725,0.04338806117152276,-0.0058610985907835075,-0.005736440743483999,-0.00012465784729950857,0.021400000000000002,0.00597142857142857,1477838554.0899987,0.0040000000000000036,6.833333333333336,-54.399999999999984,45.600000000000016,21.5080400782014,0.05856666666666663,0.06044409270180652,0.059000000000000004,0.05999064757411292,0.067415,0.06557664913484262,78860.0,31250841.333333325,94003.0,16517657.42857143
2022-11-25,0.0629,0.0637,0.0594,0.0621,33301670.0,12328.0,14929788.0,0.06303333333333329,0.05967142857142856,0.06470000000000001,0.06188602317545163,0.06106348926043852,0.06501489872489385,45.03546099290781,0.08335543521742561,0.046044564782574404,-0.004953263812080021,-0.005518051419726291,0.0005647876076462707,0.004300000000000005,0.0056214285714285715,1375089211.0899987,-0.0003999999999999976,-4.314329738058542,-62.39999999999999,37.60000000000001,41.333333333333364,-1.2718600953894994,0.064,0.07,0.0605,0.0629,69447673.0,25314.0,31644211.0,-1.7187500000000058,40.445859872611464,0.08751461334538799,0.044555386654612006,-0.0053504786342532945,-0.005659248321637858,0.00030876968738456374,0.009500000000000008,0.0058142857142857145,1408390881.0899987,-0.0005000000000000004,-8.70827285921626,-59.20000000000001,40.79999999999999,34.44516129032261,0.061299999999999966,0.06167204635090326,0.05937142857142857,0.06071798568058469,0.066035,0.06532173016961952,97595.0,38831860.99999999,116509.0,20668524.42857143
2022-11-26,0.0621,0.0645,0.0604,0.0609,22416125.0,7793.0,10254678.0,0.06196666666666662,0.05981428571428571,0.06331,0.06139301158772582,0.061022616945328886,0.0646230036082373,48.4732824427481,0.07819848371601595,0.048421516283984056,-0.004681334662946207,-0.005350708068370275,0.0006693734054240676,0.0040999999999999995,0.005621428571428571,1352673086.0899987,0.00010000000000000286,-1.296596434359798,-67.19999999999999,32.80000000000001,37.0666666666667,-1.9323671497584536,0.0629,0.0637,0.0594,0.0621,33301670.0,12328.0,14929788.0,-1.2718600953894994,45.03546099290781,0.08335543521742561,0.046044564782574404,-0.004953263812080021,-0.005518051419726291,0.0005647876076462707,0.004300000000000005,0.0056214285714285715,1375089211.0899987,-0.0003999999999999976,-4.314329738058542,-62.39999999999999,37.60000000000001,41.333333333333364,0.06303333333333329,0.06188602317545163,0.05967142857142856,0.06106348926043852,0.06470000000000001,0.06501489872489385,103557.0,40797094.66666666,125559.0,22028570.285714287
2022-11-27,0.0611,0.0667,0.0608,0.0621,33657218.0,12063.0,16166657.0,0.061699999999999956,0.06052857142857143,0.06202,0.06174650579386291,0.06129196270899666,0.06438271755030994,53.87596899224807,0.07138322031837747,0.05265677968162252,-0.0043192097208847036,-0.0051444083988731616,0.000825198677988458,0.0058999999999999955,0.005678571428571429,1386330304.0899987,0.001800000000000003,3.3277870216306127,-62.39999999999999,37.60000000000001,36.000000000000036,1.6366612111292977,0.0621,0.0645,0.0604,0.0609,22416125.0,7793.0,10254678.0,-1.9323671497584536,48.4732824427481,0.07819848371601595,0.048421516283984056,-0.004681334662946207,-0.005350708068370275,0.0006693734054240676,0.0040999999999999995,0.005621428571428571,1352673086.0899987,0.00010000000000000286,-1.296596434359798,-67.19999999999999,32.80000000000001,37.0666666666667,0.06196666666666662,0.06139301158772582,0.05981428571428571,0.061022616945328886,0.06331,0.0646230036082373,45435.0,18942892.333333325,131066.0,22676949.85714286
2022-11-28,0.0618,0.0638,0.0585,0.0612,27704941.0,10579.0,13270996.0,0.061399999999999955,0.06145714285714286,0.061224999999999995,0.06147325289693145,0.06126897203174749,0.06407960159313757,45.2991452991453,0.06733034709508963,0.05511965290491036,-0.004058066706780855,-0.0049271400604547,0.0008690733536738451,0.005299999999999992,0.005564285714285714,1358625363.0899987,0.0011999999999999997,-3.4700315457413256,-66.00000000000001,33.99999999999999,34.80000000000003,-0.9708737864077723,0.0611,0.0667,0.0608,0.0621,33657218.0,12063.0,16166657.0,1.6366612111292977,53.87596899224807,0.07138322031837747,0.05265677968162252,-0.0043192097208847036,-0.0051444083988731616,0.000825198677988458,0.0058999999999999955,0.005678571428571429,1386330304.0899987,0.001800000000000003,3.3277870216306127,-62.39999999999999,37.60000000000001,36.000000000000036,0.061699999999999956,0.06174650579386291,0.06052857142857143,0.06129196270899666,0.06202,0.06438271755030994,32184.0,13783707.666666657,136358.0,23821122.57142857
2022-11-29,0.0612,0.0639,0.0607,0.0622,22084447.0,7683.0,9603073.0,0.06183333333333329,0.062214285714285715,0.061334999999999994,0.06183662644846573,0.06150172902381062,0.06390059191760065,49.36170212765957,0.06742667680605394,0.05524332319394605,-0.003727449624998297,-0.00468720197336342,0.0009597523483651227,0.0032000000000000015,0.005535714285714285,1380709810.0899987,0.0022999999999999965,-0.48000000000000265,-62.000000000000014,37.99999999999999,36.53333333333335,1.6339869281045767,0.0618,0.0638,0.0585,0.0612,27704941.0,10579.0,13270996.0,-0.9708737864077723,45.2991452991453,0.06733034709508963,0.05511965290491036,-0.004058066706780855,-0.0049271400604547,0.0008690733536738451,0.005299999999999992,0.005564285714285714,1358625363.0899987,0.0011999999999999997,-3.4700315457413256,-66.00000000000001,33.99999999999999,34.80000000000003,0.061399999999999955,0.06147325289693145,0.06145714285714286,0.06126897203174749,0.061224999999999995,0.06407960159313757,30435.0,13230776.99999999,140358.0,24445386.0
2022-11-30,0.0622,0.0642,0.0616,0.0632,21787861.0,7876.0,10283307.0,0.06219999999999996,0.062085714285714286,0.06105000000000001,0.06251831322423287,0.06192629676785796,0.06383386887782917,55.26315789473684,0.06609485146554506,0.05600514853445496,-0.003346169009641617,-0.004418995380619059,0.0010728263709774422,0.002599999999999991,0.005392857142857142,1402497671.0899987,0.006100000000000008,3.9473684210526327,-57.99999999999997,42.00000000000002,38.00000000000003,1.6077170418006559,0.0612,0.0639,0.0607,0.0622,22084447.0,7683.0,9603073.0,1.6339869281045767,49.36170212765957,0.06742667680605394,0.05524332319394605,-0.003727449624998297,-0.00468720197336342,0.0009597523483651227,0.0032000000000000015,0.005535714285714285,1380709810.0899987,0.0022999999999999965,-0.48000000000000265,-62.000000000000014,37.99999999999999,36.53333333333335,0.06183333333333329,0.06183662644846573,0.062214285714285715,0.06150172902381062,0.061334999999999994,0.06390059191760065,30325.0,13013575.333333323,141675.0,24526669.714285713
2022-12-01,0.0634,0.0645,0.0617,0.0621,16031612.0,6121.0,7307308.0,0.062499999999999965,0.06197142857142857,0.060910000000000006,0.06230915661211644,0.06196972257589348,0.06366873850851211,53.846153846153854,0.06565126343298801,0.056168736567012004,-0.003097061188383335,-0.004154608542171915,0.0010575473537885799,0.002800000000000004,0.005435714285714286,1386466059.0899987,0.007400000000000004,2.9850746268656803,-62.39999999999999,37.60000000000001,39.20000000000004,-2.050473186119867,0.0622,0.0642,0.0616,0.0632,21787861.0,7876.0,10283307.0,1.6077170418006559,55.26315789473684,0.06609485146554506,0.05600514853445496,-0.003346169009641617,-0.004418995380619059,0.0010728263709774422,0.002599999999999991,0.005392857142857142,1402497671.0899987,0.006100000000000008,3.9473684210526327,-57.99999999999997,42.00000000000002,38.00000000000003,0.06219999999999996,0.06251831322423287,0.062085714285714286,0.06192629676785796,0.06105000000000001,0.06383386887782917,26138.0,11052458.666666657,83636.0,15164672.857142856
2022-12-02,0.0621,0.0644,0.0615,0.0637,14154269.0,4909.0,6367041.0,0.06299999999999996,0.06220000000000001,0.061009999999999995,0.06300457830605823,0.06240229193192011,0.06367171579341573,57.489878542510134,0.06590334671762436,0.056116653282375625,-0.00273896177072077,-0.003871479187881686,0.001132517417160916,0.0029,0.0054714285714285715,1400620328.0899987,0.006800000000000007,6.166666666666676,-55.99999999999997,44.00000000000002,41.20000000000004,2.5764895330112787,0.0634,0.0645,0.0617,0.0621,16031612.0,6121.0,7307308.0,-2.050473186119867,53.846153846153854,0.06565126343298801,0.056168736567012004,-0.003097061188383335,-0.004154608542171915,0.0010575473537885799,0.002800000000000004,0.005435714285714286,1386466059.0899987,0.007400000000000004,2.9850746268656803,-62.39999999999999,37.60000000000001,39.20000000000004,0.062499999999999965,0.06230915661211644,0.06197142857142857,0.06196972257589348,0.060910000000000006,0.06366873850851211,21680.0,9064562.666666657,64443.0,11687972.42857143
2022-12-03,0.0637,0.064,0.062,0.0627,10450282.0,3286.0,5768971.0,0.0628333333333333,0.062457142857142864,0.06113999999999999,0.06285228915302912,0.06247671894894009,0.06357917143213804,55.46875,0.06606956707760134,0.05621043292239865,-0.002506958389125076,-0.003598575028130364,0.001091616639005288,0.0020000000000000018,0.005507142857142857,1390170046.0899987,-0.0013999999999999985,4.6744574290484175,-59.99999999999998,40.00000000000002,40.53333333333338,-1.5698587127158568,0.0621,0.0644,0.0615,0.0637,14154269.0,4909.0,6367041.0,2.5764895330112787,57.489878542510134,0.06590334671762436,0.056116653282375625,-0.00273896177072077,-0.003871479187881686,0.001132517417160916,0.0029,0.0054714285714285715,1400620328.0899987,0.006800000000000007,6.166666666666676,-55.99999999999997,44.00000000000002,41.20000000000004,0.06299999999999996,0.06300457830605823,0.06220000000000001,0.06240229193192011,0.061009999999999995,0.06367171579341573,18906.0,7985885.333333324,57024.0,10464722.857142856
2022-12-04,0.0628,0.0659,0.0623,0.0633,16658955.0,6159.0,7443702.0,0.0632333333333333,0.06262857142857144,0.06113500000000001,0.06307614457651456,0.06268253921170507,0.06355258367669632,63.24786324786323,0.06605510911239112,0.056214890887608886,-0.0022487567837253114,-0.0033286113792493537,0.0010798545955240423,0.003599999999999999,0.00535,1406829001.0899987,0.0003999999999999976,10.858143607705784,-57.600000000000016,42.39999999999998,42.13333333333336,0.7961783439490453,0.0637,0.064,0.062,0.0627,10450282.0,3286.0,5768971.0,-1.5698587127158568,55.46875,0.06606956707760134,0.05621043292239865,-0.002506958389125076,-0.003598575028130364,0.001091616639005288,0.0020000000000000018,0.005507142857142857,1390170046.0899987,-0.0013999999999999985,4.6744574290484175,-59.99999999999998,40.00000000000002,40.53333333333338,0.0628333333333333,0.06285228915302912,0.062457142857142864,0.06247671894894009,0.06113999999999999,0.06357917143213804,14316.0,6481106.666666657,52517.0,9823907.57142857
2022-12-05,0.0632,0.075,0.0631,0.0682,170060261.0,49484.0,86634905.0,0.06473333333333328,0.06362857142857144,0.06142000000000001,0.06563807228825727,0.06406190440877879,0.06399519475510619,76.06177606177604,0.06724936305936059,0.05559063694063943,-0.0016299520298226344,-0.00298887950936401,0.0013589274795413756,0.011899999999999994,0.005978571428571429,1576889262.0899987,0.006099999999999994,24.6800731261426,-38.00000000000002,61.99999999999998,48.13333333333335,7.911392405063275,0.0628,0.0659,0.0623,0.0633,16658955.0,6159.0,7443702.0,0.7961783439490453,63.24786324786323,0.06605510911239112,0.056214890887608886,-0.0022487567837253114,-0.0033286113792493537,0.0010798545955240423,0.003599999999999999,0.00535,1406829001.0899987,0.0003999999999999976,10.858143607705784,-57.600000000000016,42.39999999999998,42.13333333333336,0.0632333333333333,0.06307614457651456,0.06262857142857144,0.06268253921170507,0.06113500000000001,0.06355258367669632,14354.0,6526571.333333324,46613.0,8577771.142857144
2022-12-06,0.0683,0.0793,0.0673,0.0699,111062825.0,47200.0,54661921.0,0.06713333333333328,0.06472857142857144,0.061875,0.06776903614412863,0.0655214283065841,0.06455755715938179,75.59055118110234,0.06881530941172474,0.054934690588275256,-0.0009909460029208644,-0.0025892928080753813,0.001598346805154517,0.011999999999999997,0.0065357142857142845,1687952087.0899987,0.009000000000000001,22.847100175746938,-40.869565217391276,59.130434782608724,54.51014492753625,2.3426061493411483,0.0632,0.075,0.0631,0.0682,170060261.0,49484.0,86634905.0,7.911392405063275,76.06177606177604,0.06724936305936059,0.05559063694063943,-0.0016299520298226344,-0.00298887950936401,0.0013589274795413756,0.011899999999999994,0.005978571428571429,1576889262.0899987,0.006099999999999994,24.6800731261426,-38.00000000000002,61.99999999999998,48.13333333333335,0.06473333333333328,0.06563807228825727,0.06362857142857144,0.06406190440877879,0.06142000000000001,0.06399519475510619,58929.0,33282525.99999999,85518.0,19058329.57142857
2022-12-07,0.07,0.084,0.065,0.0826,134086727.0,57828.0,69949917.0,0.07356666666666663,0.0675,0.06299,0.07518451807206432,0.06979107122993808,0.06627588504896448,79.93527508090614,0.07451551403096007,0.05146448596903993,0.0005340979896992781,-0.0019646146485204495,0.0024987126382197277,0.019000000000000003,0.006364285714285714,1822038814.0899987,0.020500000000000004,28.86115444617785,-5.490196078431366,94.50980392156863,71.88007956805914,18.0,0.0683,0.0793,0.0673,0.0699,111062825.0,47200.0,54661921.0,2.3426061493411483,75.59055118110234,0.06881530941172474,0.054934690588275256,-0.0009909460029208644,-0.0025892928080753813,0.001598346805154517,0.011999999999999997,0.0065357142857142845,1687952087.0899987,0.009000000000000001,22.847100175746938,-40.869565217391276,59.130434782608724,54.51014492753625,0.06713333333333328,0.06776903614412863,0.06472857142857144,0.0655214283065841,0.061875,0.06455755715938179,102843.0,49580175.99999999,125035.0,25495307.85714286
2022-12-08,0.0826,0.0993,0.0739,0.0887,282310446.0,122658.0,142205690.0,0.08039999999999996,0.0713,0.064425,0.08194225903603217,0.07451830342245355,0.0684115150443012,86.03351955307262,0.08059422027199181,0.04825577972800817,0.0022094561264848767,-0.0011298004935193845,0.003339256620004261,0.025400000000000006,0.007499999999999999,2104349260.0899987,0.027500000000000004,41.0174880763116,-25.98039215686274,74.01960784313727,75.88661551577157,7.384987893462462,0.07,0.084,0.065,0.0826,134086727.0,57828.0,69949917.0,18.0,79.93527508090614,0.07451551403096007,0.05146448596903993,0.0005340979896992781,-0.0019646146485204495,0.0024987126382197277,0.019000000000000003,0.006364285714285714,1822038814.0899987,0.020500000000000004,28.86115444617785,-5.490196078431366,94.50980392156863,71.88007956805914,0.07356666666666663,0.07518451807206432,0.0675,0.06979107122993808,0.06299,0.06627588504896448,154512.0,70415580.99999999,174987.0,34019109.28571428
2022-12-09,0.0889,0.1313,0.0887,0.1202,518207141.0,263571.0,269439056.0,0.09716666666666662,0.07937142857142857,0.06744,0.10107112951801608,0.08593872756684016,0.0733437517067487,93.68421052631578,0.09699967381050029,0.03788032618949971,0.006009700180929611,0.0002980996413704148,0.005711600539559197,0.0426,0.010235714285714284,2622556401.0899987,0.058,93.55877616747182,-15.247252747252746,84.75274725274724,84.42738633915107,35.20809898762654,0.0826,0.0993,0.0739,0.0887,282310446.0,122658.0,142205690.0,7.384987893462462,86.03351955307262,0.08059422027199181,0.04825577972800817,0.0022094561264848767,-0.0011298004935193845,0.003339256620004261,0.025400000000000006,0.007499999999999999,2104349260.0899987,0.027500000000000004,41.0174880763116,-25.98039215686274,74.01960784313727,75.88661551577157,0.08039999999999996,0.08194225903603217,0.0713,0.07451830342245355,0.064425,0.0684115150443012,227686.0,88939175.99999999,291524.0,53290306.71428572
2022-12-10,0.1202,0.128,0.0927,0.0931,183841142.0,102919.0,84996816.0,0.10066666666666661,0.08371428571428573,0.06924,0.09708556475900804,0.08772904567513012,0.07522529916324881,67.42424242424242,0.10048486652562708,0.037995133474372916,0.0067567893953130315,0.0015898375921589384,0.005166951803154093,0.0353,0.012464285714285714,2438715259.0899987,0.029899999999999996,52.87356321839081,-52.47252747252746,47.527472527472526,68.7666092077857,-22.54575707154742,0.0889,0.1313,0.0887,0.1202,518207141.0,263571.0,269439056.0,35.20809898762654,93.68421052631578,0.09699967381050029,0.03788032618949971,0.006009700180929611,0.0002980996413704148,0.005711600539559197,0.0426,0.010235714285714284,2622556401.0899987,0.058,93.55877616747182,-15.247252747252746,84.75274725274724,84.42738633915107,0.09716666666666662,0.10107112951801608,0.07937142857142857,0.08593872756684016,0.06744,0.0733437517067487,444057.0,160531554.33333334,550186.0,90872023.14285715
2022-12-11,0.093,0.1139,0.0923,0.104,144969471.0,82146.0,72668481.0,0.10576666666666662,0.08952857142857143,0.071705,0.10054278237950401,0.09179678425634759,0.07796574686198703,70.51909892262488,0.1057714041943173,0.03763859580568272,0.00813463092344463,0.002898796258416077,0.005235834665028553,0.021600000000000008,0.013585714285714284,2583684730.0899987,0.04189999999999999,67.47181964573268,-37.50000000000001,62.499999999999986,64.92673992673996,11.827956989247307,0.1202,0.128,0.0927,0.0931,183841142.0,102919.0,84996816.0,-22.54575707154742,67.42424242424242,0.10048486652562708,0.037995133474372916,0.0067567893953130315,0.0015898375921589384,0.005166951803154093,0.0353,0.012464285714285714,2438715259.0899987,0.029899999999999996,52.87356321839081,-52.47252747252746,47.527472527472526,68.7666092077857,0.10066666666666661,0.09708556475900804,0.08371428571428573,0.08772904567513012,0.06924,0.07522529916324881,489148.0,165547187.33333334,649819.0,102190286.71428572
2022-12-12,0.104,0.1096,0.0939,0.0952,82528512.0,50781.0,39301321.0,0.0974333333333333,0.09338571428571428,0.07362,0.09787139118975201,0.0926475881922607,0.07960710430370255,65.45454545454547,0.10847897000009417,0.03876102999990584,0.008419439745502785,0.004002924955833419,0.004416514789669366,0.015700000000000006,0.014328571428571428,2501156218.0899987,0.0315,55.55555555555558,-51.13314447592068,48.86685552407934,52.964776017183986,-8.461538461538451,0.093,0.1139,0.0923,0.104,144969471.0,82146.0,72668481.0,11.827956989247307,70.51909892262488,0.1057714041943173,0.03763859580568272,0.00813463092344463,0.002898796258416077,0.005235834665028553,0.021600000000000008,0.013585714285714284,2583684730.0899987,0.04189999999999999,67.47181964573268,-37.50000000000001,62.499999999999986,64.92673992673996,0.10576666666666662,0.10054278237950401,0.08952857142857143,0.09179678425634759,0.071705,0.07796574686198703,448636.0,142368117.66666666,725806.0,111508112.28571428
2022-12-13,0.0953,0.0988,0.0885,0.0911,55059843.0,27721.0,25776501.0,0.09676666666666663,0.09641428571428572,0.07497000000000001,0.094485695594876,0.09226069114419552,0.08070166579858802,62.776304155614504,0.11036379071315236,0.039576209286847665,0.008219567002152303,0.004846253365097196,0.0033733136370551068,0.010300000000000004,0.014835714285714285,2446096375.0899987,0.028399999999999995,46.4630225080386,-57.59312320916905,42.40687679083095,51.257910771636794,-4.407135362014686,0.104,0.1096,0.0939,0.0952,82528512.0,50781.0,39301321.0,-8.461538461538451,65.45454545454547,0.10847897000009417,0.03876102999990584,0.008419439745502785,0.004002924955833419,0.004416514789669366,0.015700000000000006,0.014328571428571428,2501156218.0899987,0.0315,55.55555555555558,-51.13314447592068,48.86685552407934,52.964776017183986,0.0974333333333333,0.09787139118975201,0.09338571428571428,0.0926475881922607,0.07362,0.07960710430370255,235846.0,65655539.333333336,727103.0,104746171.71428572
2022-12-14,0.091,0.1138,0.0904,0.0997,141255542.0,81473.0,71069705.0,0.09533333333333328,0.09885714285714285,0.07681,0.097092847797438,0.09412051835814664,0.08251103096062726,65.12013256006628,0.11336881490642499,0.04025118509357502,0.0086553411547734,0.005608070923032437,0.0030472702317409627,0.023400000000000004,0.016321428571428574,2587351917.0899987,0.0364,57.753164556962,-45.272206303724936,54.72779369627507,48.66717533706181,9.56043956043956,0.0953,0.0988,0.0885,0.0911,55059843.0,27721.0,25776501.0,-4.407135362014686,62.776304155614504,0.11036379071315236,0.039576209286847665,0.008219567002152303,0.004846253365097196,0.0033733136370551068,0.010300000000000004,0.014835714285714285,2446096375.0899987,0.028399999999999995,46.4630225080386,-57.59312320916905,42.40687679083095,51.257910771636794,0.09676666666666663,0.094485695594876,0.09641428571428572,0.09226069114419552,0.07497000000000001,0.08070166579858802,160648.0,45915434.333333336,707624.0,100619683.14285715
2022-12-15,0.0996,0.1056,0.0956,0.1028,70075823.0,38659.0,32708437.0,0.09786666666666662,0.10087142857142857,0.078845,0.099946423898719,0.09629038876860999,0.0844433137262818,66.58516707416463,0.11647161292215719,0.04121838707784281,0.009145416731274003,0.00631554008468075,0.002829876646593253,0.009999999999999995,0.016835714285714287,2657427740.0899987,0.034600000000000006,65.53945249597423,-40.83094555873925,59.16905444126075,52.10124164278895,3.212851405622499,0.091,0.1138,0.0904,0.0997,141255542.0,81473.0,71069705.0,9.56043956043956,65.12013256006628,0.11336881490642499,0.04025118509357502,0.0086553411547734,0.005608070923032437,0.0030472702317409627,0.023400000000000004,0.016321428571428574,2587351917.0899987,0.0364,57.753164556962,-45.272206303724936,54.72779369627507,48.66717533706181,0.09533333333333328,0.097092847797438,0.09885714285714285,0.09412051835814664,0.07681,0.08251103096062726,159975.0,45382509.0,731269.0,100779652.85714285
2022-12-16,0.1028,0.1071,0.0896,0.0908,84247974.0,45566.0,39448684.0,0.09776666666666663,0.09667142857142859,0.08034000000000001,0.0953732119493595,0.0949177915764575,0.08504871241901686,60.18031555221638,0.11733521448418305,0.04334478551581696,0.008467892846979339,0.006746010637140468,0.0017218822098388703,0.0175,0.01787857142857143,2573179766.0899987,0.020900000000000002,42.54317111459969,-58.44155844155843,41.558441558441565,51.818429898659154,-11.673151750972758,0.0996,0.1056,0.0956,0.1028,70075823.0,38659.0,32708437.0,3.212851405622499,66.58516707416463,0.11647161292215719,0.04121838707784281,0.009145416731274003,0.00631554008468075,0.002829876646593253,0.009999999999999995,0.016835714285714287,2657427740.0899987,0.034600000000000006,65.53945249597423,-40.83094555873925,59.16905444126075,52.10124164278895,0.09786666666666662,0.099946423898719,0.10087142857142857,0.09629038876860999,0.078845,0.0844433137262818,147853.0,43184881.0,647270.0,85137188.14285715
2022-12-17,0.0909,0.0941,0.0857,0.0896,40148573.0,21794.0,17113557.0,0.09439999999999994,0.09617142857142857,0.08171500000000001,0.09248660597467975,0.09358834368234312,0.0854821683791105,60.0900225056264,0.11789090212739312,0.04553909787260691,0.007744842591797127,0.0069457770280718,0.0007990655637253267,0.008400000000000005,0.01833571428571429,2533031193.0899987,0.006999999999999992,42.90271132376393,-60.43478260869565,39.565217391304344,46.764237797002245,-1.4301430143014253,0.1028,0.1071,0.0896,0.0908,84247974.0,45566.0,39448684.0,-11.673151750972758,60.18031555221638,0.11733521448418305,0.04334478551581696,0.008467892846979339,0.006746010637140468,0.0017218822098388703,0.0175,0.01787857142857143,2573179766.0899987,0.020900000000000002,42.54317111459969,-58.44155844155843,41.558441558441565,51.818429898659154,0.09776666666666663,0.0953732119493595,0.09667142857142859,0.0949177915764575,0.08034000000000001,0.08504871241901686,165698.0,47742275.333333336,429265.0,52281420.71428572
2022-12-18,0.0896,0.0935,0.0859,0.0878,36708750.0,22522.0,17714651.0,0.08939999999999997,0.09385714285714286,0.08304500000000001,0.09014330298733989,0.09214125776175733,0.08570291424776665,59.10780669144981,0.11797979490036747,0.048110205099632534,0.006946500168599698,0.0069459216561773805,5.78512422317462e-07,0.007599999999999996,0.018621428571428573,2496322443.0899987,-0.000899999999999998,38.704581358609815,-63.78299120234604,36.21700879765396,39.113555915799985,-2.008928571428567,0.0909,0.0941,0.0857,0.0896,40148573.0,21794.0,17113557.0,-1.4301430143014253,60.0900225056264,0.11789090212739312,0.04553909787260691,0.007744842591797127,0.0069457770280718,0.0007990655637253267,0.008400000000000005,0.01833571428571429,2533031193.0899987,0.006999999999999992,42.90271132376393,-60.43478260869565,39.565217391304344,46.764237797002245,0.09439999999999994,0.09248660597467975,0.09617142857142857,0.09358834368234312,0.08171500000000001,0.0854821683791105,106019.0,29756892.666666668,348140.0,42583812.28571428
2022-12-19,0.0879,0.0913,0.0833,0.0844,32662133.0,17124.0,13720893.0,0.08726666666666662,0.09231428571428571,0.08415500000000001,0.08727165149366994,0.09020594332131801,0.08557882717655077,56.090225563909776,0.11768352516878597,0.050626474831214054,0.0059706307467943115,0.006750863474300767,-0.0007802327275064557,0.008000000000000007,0.018342857142857143,2463660310.0899987,-0.0358,23.75366568914956,-70.7390648567119,29.260935143288087,35.01438711074883,-3.9817974971558625,0.0896,0.0935,0.0859,0.0878,36708750.0,22522.0,17714651.0,-2.008928571428567,59.10780669144981,0.11797979490036747,0.048110205099632534,0.006946500168599698,0.0069459216561773805,5.78512422317462e-07,0.007599999999999996,0.018621428571428573,2496322443.0899987,-0.000899999999999998,38.704581358609815,-63.78299120234604,36.21700879765396,39.113555915799985,0.08939999999999997,0.09014330298733989,0.09385714285714286,0.09214125776175733,0.08304500000000001,0.08570291424776665,89882.0,24758964.0,288516.0,34733265.14285714
2022-12-20,0.0844,0.0892,0.0843,0.0856,19888816.0,11661.0,9858932.0,0.08593333333333329,0.09152857142857142,0.085275,0.08643582574683498,0.0890544574909885,0.08558084363592688,55.9245283018868,0.11731989449431565,0.05323010550568435,0.005233745806669923,0.006447439940774599,-0.0012136941341046757,0.004900000000000002,0.017835714285714288,2483549126.0899987,-0.007500000000000007,22.46065808297566,-68.9291101055807,31.070889894419295,32.18294461178714,1.42180094786729,0.0879,0.0913,0.0833,0.0844,32662133.0,17124.0,13720893.0,-3.9817974971558625,56.090225563909776,0.11768352516878597,0.050626474831214054,0.0059706307467943115,0.006750863474300767,-0.0007802327275064557,0.008000000000000007,0.018342857142857143,2463660310.0899987,-0.0358,23.75366568914956,-70.7390648567119,29.260935143288087,35.01438711074883,0.08726666666666662,0.08727165149366994,0.09231428571428571,0.09020594332131801,0.08415500000000001,0.08557882717655077,61440.0,16183033.666666666,254859.0,31078918.285714287
2022-12-21,0.0857,0.0968,0.0817,0.0934,82682511.0,46785.0,40602271.0,0.08779999999999995,0.09062857142857143,0.08684,0.0899179128734175,0.09014084311824137,0.08632552519441004,54.2319749216301,0.11712846575659921,0.056551534243400786,0.005218992696240057,0.006201750491867691,-0.000982757795627634,0.015100000000000002,0.017557142857142858,2566231637.0899987,-0.010599999999999998,13.075060532687633,-66.02787456445994,33.97212543554007,31.43465015774918,8.984830805134187,0.0844,0.0892,0.0843,0.0856,19888816.0,11661.0,9858932.0,1.42180094786729,55.9245283018868,0.11731989449431565,0.05323010550568435,0.005233745806669923,0.006447439940774599,-0.0012136941341046757,0.004900000000000002,0.017835714285714288,2483549126.0899987,-0.007500000000000007,22.46065808297566,-68.9291101055807,31.070889894419295,32.18294461178714,0.08593333333333329,0.08643582574683498,0.09152857142857142,0.0890544574909885,0.085275,0.08558084363592688,51307.0,13764825.333333334,238799.0,28804979.85714286
2022-12-22,0.0934,0.1007,0.0882,0.0946,82001886.0,49389.0,39880817.0,0.09119999999999995,0.08945714285714287,0.088385,0.09225895643670876,0.09125563233868103,0.08711357041399005,52.4042379788101,0.11679784179629582,0.05997215820370419,0.00524368478697175,0.006010137350888504,-0.0007664525639167535,0.012499999999999997,0.01663571428571429,2648233523.0899987,-0.0006000000000000033,6.651634723788047,-73.99193548387095,26.008064516129046,30.350359948696166,1.28479657387581,0.0857,0.0968,0.0817,0.0934,82682511.0,46785.0,40602271.0,8.984830805134187,54.2319749216301,0.11712846575659921,0.056551534243400786,0.005218992696240057,0.006201750491867691,-0.000982757795627634,0.015100000000000002,0.017557142857142858,2566231637.0899987,-0.010599999999999998,13.075060532687633,-66.02787456445994,33.97212543554007,31.43465015774918,0.08779999999999995,0.0899179128734175,0.09062857142857143,0.09014084311824137,0.08684,0.08632552519441004,75570.0,21394032.0,204111.0,24452489.285714287
2022-12-23,0.0946,0.0964,0.0897,0.0903,28512075.0,18044.0,13533999.0,0.09276666666666662,0.08938571428571429,0.08976500000000001,0.09127947821835439,0.09101672425401076,0.08741703989837195,34.3455497382199,0.11547793141785369,0.06405206858214633,0.004860253407494061,0.005780160562209616,-0.0009199071547155548,0.006699999999999998,0.014071428571428572,2619721448.0899987,-0.0007999999999999952,-24.875207986688853,-81.42548596112309,18.57451403887691,26.18490133018204,-4.545454545454543,0.0934,0.1007,0.0882,0.0946,82001886.0,49389.0,39880817.0,1.28479657387581,52.4042379788101,0.11679784179629582,0.05997215820370419,0.00524368478697175,0.006010137350888504,-0.0007664525639167535,0.012499999999999997,0.01663571428571429,2648233523.0899987,-0.0006000000000000033,6.651634723788047,-73.99193548387095,26.008064516129046,30.350359948696166,0.09119999999999995,0.09225895643670876,0.08945714285714287,0.09125563233868103,0.088385,0.08711357041399005,107835.0,30114006.666666668,214841.0,25477115.0
2022-12-24,0.0902,0.0956,0.0894,0.0933,22335376.0,12946.0,10652935.0,0.09273333333333329,0.08991428571428572,0.091265,0.09228973910917719,0.09158754319050808,0.08797732181281272,50.140056022408956,0.11377855381225185,0.06875144618774814,0.004743772943145527,0.005572883038396799,-0.0008291100952512714,0.006200000000000011,0.011992857142857147,2642056824.0899987,-0.006400000000000003,0.21482277121374072,-63.97515527950311,36.02484472049689,26.869141091834308,3.436807095343671,0.0946,0.0964,0.0897,0.0903,28512075.0,18044.0,13533999.0,-4.545454545454543,34.3455497382199,0.11547793141785369,0.06405206858214633,0.004860253407494061,0.005780160562209616,-0.0009199071547155548,0.006699999999999998,0.014071428571428572,2619721448.0899987,-0.0007999999999999952,-24.875207986688853,-81.42548596112309,18.57451403887691,26.18490133018204,0.09276666666666662,0.09127947821835439,0.08938571428571429,0.09101672425401076,0.08976500000000001,0.08741703989837195,114218.0,31339029.0,187319.0,21775017.14285714
2022-12-25,0.0933,0.0988,0.0917,0.0951,39233684.0,22252.0,18801110.0,0.09289999999999994,0.09095714285714286,0.09261,0.0936948695545886,0.09246565739288105,0.08865567211635436,42.85714285714286,0.1123670400509025,0.07285295994909749,0.004742042973149979,0.0054067150253474345,-0.0006646720521974554,0.007099999999999995,0.01095714285714286,2681290508.0899987,-0.0076999999999999985,-8.5576923076923,-58.255451713395615,41.744548286604385,32.11463568199276,1.9292604501607826,0.0902,0.0956,0.0894,0.0933,22335376.0,12946.0,10652935.0,3.436807095343671,50.140056022408956,0.11377855381225185,0.06875144618774814,0.004743772943145527,0.005572883038396799,-0.0008291100952512714,0.006200000000000011,0.011992857142857147,2642056824.0899987,-0.006400000000000003,0.21482277121374072,-63.97515527950311,36.02484472049689,26.869141091834308,0.09273333333333329,0.09228973910917719,0.08991428571428572,0.09158754319050808,0.091265,0.08797732181281272,80379.0,21355917.0,178471.0,20852071.14285714
2022-12-26,0.0952,0.1058,0.0937,0.0992,71237952.0,39238.0,33693928.0,0.09586666666666661,0.09307142857142857,0.09407499999999999,0.0964474347772943,0.0941492430446608,0.08965989381955872,53.47222222222222,0.11086395313479841,0.07728604686520157,0.005013712734855472,0.005328114567249042,-0.0003144018323935705,0.0121,0.010700000000000003,2752528460.0899987,0.00839999999999999,4.201680672268893,-45.482866043613704,54.51713395638629,44.09550898782921,4.201680672268896,0.0933,0.0988,0.0917,0.0951,39233684.0,22252.0,18801110.0,1.9292604501607826,42.85714285714286,0.1123670400509025,0.07285295994909749,0.004742042973149979,0.0054067150253474345,-0.0006646720521974554,0.007099999999999995,0.01095714285714286,2681290508.0899987,-0.0076999999999999985,-8.5576923076923,-58.255451713395615,41.744548286604385,32.11463568199276,0.09289999999999994,0.0936948695545886,0.09095714285714286,0.09246565739288105,0.09261,0.08865567211635436,53242.0,14329348.0,178201.0,21007279.57142857
2022-12-27,0.0991,0.1023,0.0956,0.098,43126807.0,22731.0,20622431.0,0.0974333333333333,0.09484285714285715,0.094845,0.09722371738864716,0.0951119322834956,0.0904541896462674,56.30712979890312,0.11081041986835904,0.07887958013164095,0.005073696591065116,0.005277230972012257,-0.00020353438094714103,0.006699999999999998,0.010442857142857143,2709401653.0899987,0.008400000000000005,7.574094401756315,-49.22118380062303,50.77881619937696,49.01349948078924,-1.1099899091826337,0.0952,0.1058,0.0937,0.0992,71237952.0,39238.0,33693928.0,4.201680672268896,53.47222222222222,0.11086395313479841,0.07728604686520157,0.005013712734855472,0.005328114567249042,-0.0003144018323935705,0.0121,0.010700000000000003,2752528460.0899987,0.00839999999999999,4.201680672268893,-45.482866043613704,54.51713395638629,44.09550898782921,0.09586666666666661,0.0964474347772943,0.09307142857142857,0.0941492430446608,0.09407499999999999,0.08965989381955872,74436.0,21049324.333333332,200315.0,23860570.285714287
2022-12-28,0.0979,0.1032,0.0932,0.096,50517394.0,27238.0,23955760.0,0.09773333333333328,0.09521428571428571,0.09521,0.09661185869432358,0.0953339492126217,0.09098236206090861,46.15384615384615,0.11091556723265078,0.07950443276734923,0.004903328426089024,0.00520245046282761,-0.00029912203673858676,0.009999999999999995,0.009485714285714287,2658884259.0899987,0.008199999999999999,-3.7111334002005947,-43.700787401574786,56.29921259842521,53.86505425139618,-1.9407558733401418,0.0991,0.1023,0.0956,0.098,43126807.0,22731.0,20622431.0,-1.1099899091826337,56.30712979890312,0.11081041986835904,0.07887958013164095,0.005073696591065116,0.005277230972012257,-0.00020353438094714103,0.006699999999999998,0.010442857142857143,2709401653.0899987,0.008400000000000005,7.574094401756315,-49.22118380062303,50.77881619937696,49.01349948078924,0.0974333333333333,0.09722371738864716,0.09484285714285715,0.0951119322834956,0.094845,0.0904541896462674,84221.0,24372489.666666668,211385.0,25398213.0
2022-12-29,0.0958,0.099,0.0899,0.0925,28547227.0,16063.0,12409919.0,0.09549999999999996,0.09491428571428571,0.093825,0.09455592934716178,0.09462546190946627,0.09112689900748874,39.38144329896906,0.10424903598947274,0.08340096401052727,0.0044347684287306816,0.005048914056008225,-0.0006141456272775432,0.00910000000000001,0.009421428571428572,2630337032.0899987,0.008099999999999996,-10.019455252918286,-57.48031496062992,42.51968503937009,49.86590461239078,-3.444676409185801,0.0979,0.1032,0.0932,0.096,50517394.0,27238.0,23955760.0,-1.9407558733401418,46.15384615384615,0.11091556723265078,0.07950443276734923,0.004903328426089024,0.00520245046282761,-0.00029912203673858676,0.009999999999999995,0.009485714285714287,2658884259.0899987,0.008199999999999999,-3.7111334002005947,-43.700787401574786,56.29921259842521,53.86505425139618,0.09773333333333328,0.09661185869432358,0.09521428571428571,0.0953339492126217,0.09521,0.09098236206090861,89207.0,26090706.333333332,191838.0,23020140.0
2022-12-30,0.0925,0.096,0.089,0.0937,23293107.0,15236.0,11716720.0,0.09406666666666663,0.09540000000000001,0.093855,0.0941279646735809,0.0943940964320997,0.09137195624487077,53.846153846153854,0.10427370281825364,0.08343629718174635,0.004112850841868937,0.004861701413180368,-0.000748850571311431,0.007000000000000006,0.008671428571428573,2653630139.0899987,0.00810000000000001,3.19383259911894,-50.20746887966803,49.79253112033197,49.53714291937578,1.2972972972973045,0.0958,0.099,0.0899,0.0925,28547227.0,16063.0,12409919.0,-3.444676409185801,39.38144329896906,0.10424903598947274,0.08340096401052727,0.0044347684287306816,0.005048914056008225,-0.0006141456272775432,0.00910000000000001,0.009421428571428572,2630337032.0899987,0.008099999999999996,-10.019455252918286,-57.48031496062992,42.51968503937009,49.86590461239078,0.09549999999999996,0.09455592934716178,0.09491428571428571,0.09462546190946627,0.093825,0.09112689900748874,66032.0,18996036.666666668,158512.0,19095726.0
2022-12-31,0.0937,0.0945,0.091,0.0917,9758891.0,6103.0,4275122.0,0.09263333333333329,0.09517142857142857,0.09324,0.09291398233679045,0.09372057232407477,0.09140319850726403,52.72727272727274,0.1025280001810103,0.08395199981898971,0.0036542219536796205,0.004620205521280219,-0.0009659835676005986,0.003500000000000003,0.008321428571428573,2643871248.0899987,-0.0016999999999999932,2.34375,-58.506224066390025,41.493775933609975,44.60199736443737,-2.134471718249735,0.0925,0.096,0.089,0.0937,23293107.0,15236.0,11716720.0,1.2972972972973045,53.846153846153854,0.10427370281825364,0.08343629718174635,0.004112850841868937,0.004861701413180368,-0.000748850571311431,0.007000000000000006,0.008671428571428573,2653630139.0899987,0.00810000000000001,3.19383259911894,-50.20746887966803,49.79253112033197,49.53714291937578,0.09406666666666663,0.0941279646735809,0.09540000000000001,0.0943940964320997,0.093855,0.09137195624487077,58537.0,16027466.333333334,155704.0,18836114.714285713
2023-01-01,0.0916,0.0926,0.0899,0.0915,9182851.0,5905.0,4370582.0,0.09229999999999995,0.09465714285714287,0.093055,0.09220699116839523,0.09316542924305607,0.09141241769704841,55.01355013550135,0.10232600176238979,0.08378399823761021,0.0032372993551987583,0.004343624288063928,-0.0011063249328651693,0.002700000000000008,0.007971428571428574,2634688397.0899987,-0.0031000000000000055,4.214123006833703,-59.33609958506224,40.66390041493776,43.9834024896266,-0.10917030567685901,0.0937,0.0945,0.091,0.0917,9758891.0,6103.0,4275122.0,-2.134471718249735,52.72727272727274,0.1025280001810103,0.08395199981898971,0.0036542219536796205,0.004620205521280219,-0.0009659835676005986,0.003500000000000003,0.008321428571428573,2643871248.0899987,-0.0016999999999999932,2.34375,-58.506224066390025,41.493775933609975,44.60199736443737,0.09263333333333329,0.09291398233679045,0.09517142857142857,0.09372057232407477,0.09324,0.09140319850726403,37402.0,9467253.666666666,148861.0,17924998.57142857
2023-01-02,0.0914,0.1015,0.0901,0.0965,41969617.0,21895.0,20753750.0,0.09323333333333328,0.09427142857142858,0.093325,0.09435349558419762,0.09399907193229207,0.09189694934494858,65.71428571428572,0.10267050271770647,0.08397949728229354,0.003272618694221449,0.004129423169295432,-0.0008568044750739828,0.011400000000000007,0.008214285714285717,2676658014.0899987,0.006199999999999997,14.336492890995256,-38.58921161825726,61.41078838174274,47.856154910096855,5.579868708971562,0.0916,0.0926,0.0899,0.0915,9182851.0,5905.0,4370582.0,-0.10917030567685901,55.01355013550135,0.10232600176238979,0.08378399823761021,0.0032372993551987583,0.004343624288063928,-0.0011063249328651693,0.002700000000000008,0.007971428571428574,2634688397.0899987,-0.0031000000000000055,4.214123006833703,-59.33609958506224,40.66390041493776,43.9834024896266,0.09229999999999995,0.09220699116839523,0.09465714285714287,0.09316542924305607,0.093055,0.09141241769704841,27244.0,6787474.666666667,132514.0,15863494.57142857
2023-01-03,0.0966,0.1043,0.0961,0.1026,64219333.0,32573.0,32300640.0,0.09686666666666661,0.09492857142857143,0.09347000000000001,0.0984767477920988,0.09614930394921906,0.09291628750257253,69.5852534562212,0.1033089344734568,0.08363106552654322,0.0037496054277096486,0.0040534596209782755,-0.0003038541932686269,0.008199999999999999,0.008450000000000003,2740877347.0899987,0.009300000000000003,19.859813084112155,-13.278008298755214,86.72199170124479,62.93222683264179,6.211180124223594,0.0914,0.1015,0.0901,0.0965,41969617.0,21895.0,20753750.0,5.579868708971562,65.71428571428572,0.10267050271770647,0.08397949728229354,0.003272618694221449,0.004129423169295432,-0.0008568044750739828,0.011400000000000007,0.008214285714285717,2676658014.0899987,0.006199999999999997,14.336492890995256,-38.58921161825726,61.41078838174274,47.856154910096855,0.09323333333333328,0.09435349558419762,0.09427142857142858,0.09399907193229207,0.093325,0.09189694934494858,33903.0,9799818.0,115171.0,14014897.714285715
2023-01-04,0.1028,0.117,0.1014,0.1119,96984356.0,53058.0,46921092.0,0.10366666666666662,0.0972,0.09392500000000001,0.1051883738960494,0.10008697796191429,0.09472426012137514,70.60133630289532,0.10613627606566692,0.0817137239343331,0.004822462778132489,0.004207260252409118,0.0006152025257233707,0.015600000000000003,0.008485714285714287,2837861703.0899987,0.016799999999999995,19.807280513918624,-17.708333333333353,82.29166666666664,76.80814891655142,8.852140077821009,0.0966,0.1043,0.0961,0.1026,64219333.0,32573.0,32300640.0,6.211180124223594,69.5852534562212,0.1033089344734568,0.08363106552654322,0.0037496054277096486,0.0040534596209782755,-0.0003038541932686269,0.008199999999999999,0.008450000000000003,2740877347.0899987,0.009300000000000003,19.859813084112155,-13.278008298755214,86.72199170124479,62.93222683264179,0.09686666666666661,0.0984767477920988,0.09492857142857143,0.09614930394921906,0.09347000000000001,0.09291628750257253,60373.0,19141657.333333332,125013.0,15683213.285714285
2023-01-05,0.1118,0.114,0.1058,0.1069,41889754.0,22659.0,18842649.0,0.10713333333333329,0.09925714285714285,0.09473000000000001,0.1060441869480247,0.10179023347143572,0.09588385439552988,62.62833675564681,0.10813794736809568,0.08132205263190434,0.005209203291675929,0.00440764886026248,0.0008015544314134487,0.008199999999999999,0.008178571428571431,2795971949.0899987,0.0076999999999999985,13.002114164904842,-36.0714285714286,63.9285714285714,77.64740993216097,-4.3828264758497335,0.1028,0.117,0.1014,0.1119,96984356.0,53058.0,46921092.0,8.852140077821009,70.60133630289532,0.10613627606566692,0.0817137239343331,0.004822462778132489,0.004207260252409118,0.0006152025257233707,0.015600000000000003,0.008485714285714287,2837861703.0899987,0.016799999999999995,19.807280513918624,-17.708333333333353,82.29166666666664,76.80814891655142,0.10366666666666662,0.1051883738960494,0.0972,0.10008697796191429,0.09392500000000001,0.09472426012137514,107526.0,33325160.666666668,150833.0,18963975.0
2023-01-06,0.1069,0.1345,0.1066,0.1241,153809969.0,88895.0,78046610.0,0.11429999999999996,0.1036,0.096455,0.11507209347401234,0.10736767510357678,0.09857110635786036,77.43506493506493,0.11498343902290868,0.07792656097709132,0.0068249207505299,0.004891103238315965,0.0019338175122139353,0.027900000000000008,0.009692857142857145,2949781918.0899987,0.026099999999999998,37.430786267995565,-22.857142857142865,77.14285714285714,74.45436507936509,16.08980355472405,0.1118,0.114,0.1058,0.1069,41889754.0,22659.0,18842649.0,-4.3828264758497335,62.62833675564681,0.10813794736809568,0.08132205263190434,0.005209203291675929,0.00440764886026248,0.0008015544314134487,0.008199999999999999,0.008178571428571431,2795971949.0899987,0.0076999999999999985,13.002114164904842,-36.0714285714286,63.9285714285714,77.64740993216097,0.10713333333333329,0.1060441869480247,0.09925714285714285,0.10179023347143572,0.09473000000000001,0.09588385439552988,108290.0,32688127.0,157429.0,19882936.42857143
2023-01-07,0.1242,0.1698,0.1237,0.1578,199831896.0,134524.0,101532086.0,0.12959999999999997,0.11304285714285713,0.09995499999999999,0.13643604673700616,0.11997575632768258,0.10421195337139748,84.94041170097508,0.13263845630106436,0.06727154369893562,0.010701338466150206,0.006053150283882813,0.004648188182267393,0.0461,0.012542857142857146,3149613814.0899987,0.061799999999999994,69.13183279742765,-14.851485148514861,85.14851485148513,75.40664780763791,27.05314009661835,0.1069,0.1345,0.1066,0.1241,153809969.0,88895.0,78046610.0,16.08980355472405,77.43506493506493,0.11498343902290868,0.07792656097709132,0.0068249207505299,0.004891103238315965,0.0019338175122139353,0.027900000000000008,0.009692857142857145,2949781918.0899987,0.026099999999999998,37.430786267995565,-22.857142857142865,77.14285714285714,74.45436507936509,0.11429999999999996,0.11507209347401234,0.1036,0.10736767510357678,0.096455,0.09857110635786036,164612.0,47936783.666666664,231088.0,29358635.0
2023-01-08,0.1579,0.1688,0.1387,0.14,181412455.0,128584.0,86791333.0,0.1406333333333333,0.11997142857142859,0.10273499999999999,0.13821802336850308,0.12498181724576193,0.10762033876459773,70.72945521698985,0.13909884989163707,0.06637115010836292,0.012196522277919397,0.00728182468269013,0.004914697595229267,0.030100000000000016,0.01418571428571429,2968201359.0899987,0.047500000000000014,47.21345951629865,-36.88118811881187,63.11881188118813,75.13672795851016,-11.336288790373652,0.1242,0.1698,0.1237,0.1578,199831896.0,134524.0,101532086.0,27.05314009661835,84.94041170097508,0.13263845630106436,0.06727154369893562,0.010701338466150206,0.006053150283882813,0.004648188182267393,0.0461,0.012542857142857146,3149613814.0899987,0.061799999999999994,69.13183279742765,-14.851485148514861,85.14851485148513,75.40664780763791,0.12959999999999997,0.13643604673700616,0.11304285714285713,0.11997575632768258,0.09995499999999999,0.10421195337139748,246078.0,66140448.333333336,359509.0,43252487.0
2023-01-09,0.14,0.1727,0.1385,0.1531,154613895.0,102615.0,76676141.0,0.15029999999999996,0.12805714285714287,0.10611,0.14565901168425155,0.13201136293432145,0.11195173507273129,72.97527706734869,0.14790216244823245,0.06431783755176755,0.014273985124428928,0.00868025677103789,0.005593728353391038,0.03419999999999998,0.015764285714285717,3122815254.0899987,0.05940000000000001,54.33467741935485,-23.4169653524492,76.58303464755079,74.95012046007471,9.357142857142858,0.1579,0.1688,0.1387,0.14,181412455.0,128584.0,86791333.0,-11.336288790373652,70.72945521698985,0.13909884989163707,0.06637115010836292,0.012196522277919397,0.00728182468269013,0.004914697595229267,0.030100000000000016,0.01418571428571429,2968201359.0899987,0.047500000000000014,47.21345951629865,-36.88118811881187,63.11881188118813,75.13672795851016,0.1406333333333333,0.13821802336850308,0.11997142857142859,0.12498181724576193,0.10273499999999999,0.10762033876459773,352003.0,88790009.66666667,482188.0,55026880.0
2023-01-10,0.153,0.1985,0.1462,0.189,228595839.0,148140.0,112612865.0,0.16069999999999998,0.1404,0.11089,0.16732950584212578,0.1462585222007411,0.1192896650658045,79.9342105263158,0.166232984150939,0.05554701584906098,0.01860277812241297,0.010664761041312906,0.007938017081100063,0.05230000000000001,0.019021428571428575,3351411093.0899987,0.0973,92.85714285714286,-8.675799086757998,91.32420091324201,77.00868248066034,23.529411764705884,0.14,0.1727,0.1385,0.1531,154613895.0,102615.0,76676141.0,9.357142857142858,72.97527706734869,0.14790216244823245,0.06431783755176755,0.014273985124428928,0.00868025677103789,0.005593728353391038,0.03419999999999998,0.015764285714285717,3122815254.0899987,0.05940000000000001,54.33467741935485,-23.4169653524492,76.58303464755079,74.95012046007471,0.15029999999999996,0.14565901168425155,0.12805714285714287,0.13201136293432145,0.10611,0.11195173507273129,365723.0,88333186.66666667,562908.0,63015793.0
2023-01-11,0.1891,0.2083,0.1723,0.1806,204173611.0,143100.0,101856191.0,0.17423333333333332,0.15021428571428572,0.11518999999999999,0.1739647529210629,0.15484389165055581,0.12512874458334694,76.70454545454545,0.1780563377416478,0.05232366225835218,0.021112199666447062,0.012754248766339737,0.008357950900107325,0.036000000000000004,0.020878571428571437,3147237482.0899987,0.08910000000000001,88.12500000000001,-23.21877619446773,76.78122380553228,81.56281978877506,-4.49497620306715,0.153,0.1985,0.1462,0.189,228595839.0,148140.0,112612865.0,23.529411764705884,79.9342105263158,0.166232984150939,0.05554701584906098,0.01860277812241297,0.010664761041312906,0.007938017081100063,0.05230000000000001,0.019021428571428575,3351411093.0899987,0.0973,92.85714285714286,-8.675799086757998,91.32420091324201,77.00868248066034,0.16069999999999998,0.16732950584212578,0.1404,0.1462585222007411,0.11089,0.1192896650658045,379339.0,92026779.66666667,678475.0,74488968.0
2023-01-12,0.1806,0.2183,0.1786,0.2026,184495572.0,139604.0,92586108.0,0.1907333333333333,0.16388571428571427,0.12080500000000001,0.18828237646053145,0.16678291873791687,0.13250695938493295,81.11927642736009,0.19358913577866405,0.04802086422133599,0.02459266156372225,0.01512193132581624,0.009470730237906011,0.039699999999999985,0.023064285714285714,3331733054.0899987,0.1061,119.027027027027,-12.142304717710745,87.85769528228926,85.32104000035454,12.181616832779618,0.1891,0.2083,0.1723,0.1806,204173611.0,143100.0,101856191.0,-4.49497620306715,76.70454545454545,0.1780563377416478,0.05232366225835218,0.021112199666447062,0.012754248766339737,0.008357950900107325,0.036000000000000004,0.020878571428571437,3147237482.0899987,0.08910000000000001,88.12500000000001,-23.21877619446773,76.78122380553228,81.56281978877506,0.17423333333333332,0.1739647529210629,0.15021428571428572,0.15484389165055581,0.11518999999999999,0.12512874458334694,393855.0,97048399.0,768517.0,82336839.28571428
2023-01-13,0.2026,0.2565,0.201,0.2396,238470668.0,176406.0,120111401.0,0.20759999999999998,0.1803857142857143,0.12812,0.21394118823026573,0.18498718905343767,0.1427062965863679,84.2971321109544,0.2169116686465971,0.039328331353402926,0.029990827875676057,0.018095710635788204,0.011895117239887853,0.055499999999999994,0.02652857142857143,3570203722.0899987,0.137,155.70971184631804,-10.144057623049218,89.85594237695076,84.83162048825746,18.26258637709773,0.1806,0.2183,0.1786,0.2026,184495572.0,139604.0,92586108.0,12.181616832779618,81.11927642736009,0.19358913577866405,0.04802086422133599,0.02459266156372225,0.01512193132581624,0.009470730237906011,0.039699999999999985,0.023064285714285714,3331733054.0899987,0.1061,119.027027027027,-12.142304717710745,87.85769528228926,85.32104000035454,0.1907333333333333,0.18828237646053145,0.16388571428571427,0.16678291873791687,0.12080500000000001,0.13250695938493295,430844.0,102351721.33333333,885462.0,92871619.14285715
2023-01-14,0.2396,0.2658,0.2147,0.2384,162856227.0,127158.0,78251426.0,0.22686666666666663,0.1919,0.13528500000000002,0.22617059411513285,0.19834039179007823,0.15181998262576143,84.61538461538461,0.235278079234172,0.03529192076582806,0.033782658144293126,0.021233100137489188,0.012549558006803938,0.05109999999999998,0.029928571428571426,3407347495.0899987,0.1265,159.9781897491821,-15.577032404775428,84.42296759522458,87.37886841815491,-0.5008347245409043,0.2026,0.2565,0.201,0.2396,238470668.0,176406.0,120111401.0,18.26258637709773,84.2971321109544,0.2169116686465971,0.039328331353402926,0.029990827875676057,0.018095710635788204,0.011895117239887853,0.055499999999999994,0.02652857142857143,3570203722.0899987,0.137,155.70971184631804,-10.144057623049218,89.85594237695076,84.83162048825746,0.20759999999999998,0.21394118823026573,0.1803857142857143,0.18498718905343767,0.12812,0.1427062965863679,459110.0,104851233.33333333,972973.0,98880875.0
2023-01-15,0.2381,0.248,0.2117,0.2277,105466287.0,90945.0,53155259.0,0.23523333333333332,0.20442857142857143,0.14171,0.22693529705756643,0.20568029384255868,0.15904665094711748,80.62050359712231,0.24824017165891943,0.03517982834108058,0.03551491652404387,0.024089463414800127,0.011425453109243745,0.0363,0.03232857142857143,3301881208.0899987,0.12080000000000002,148.85245901639345,-21.68468981217984,78.31531018782016,84.1980733866652,-4.367912641747162,0.2396,0.2658,0.2147,0.2384,162856227.0,127158.0,78251426.0,-0.5008347245409043,84.61538461538461,0.235278079234172,0.03529192076582806,0.033782658144293126,0.021233100137489188,0.012549558006803938,0.05109999999999998,0.029928571428571426,3407347495.0899987,0.1265,159.9781897491821,-15.577032404775428,84.42296759522458,87.37886841815491,0.22686666666666663,0.22617059411513285,0.1919,0.19834039179007823,0.13528500000000002,0.15181998262576143,443168.0,96982978.33333333,965607.0,95555066.42857143
2023-01-16,0.2278,0.25,0.2176,0.2295,84714792.0,66502.0,42380346.0,0.23186666666666664,0.21534285714285714,0.148285,0.22821764852878323,0.211635220381919,0.16575649371405868,80.33759124087592,0.2595817824758128,0.0369882175241872,0.03661096036545494,0.026593762804931094,0.010017197560523848,0.03240000000000001,0.03382857142857143,3386596000.0899987,0.10540000000000001,137.8238341968912,-21.39068945197406,78.60931054802596,80.44919611035692,0.7462686567164211,0.2381,0.248,0.2117,0.2277,105466287.0,90945.0,53155259.0,-4.367912641747162,80.62050359712231,0.24824017165891943,0.03517982834108058,0.03551491652404387,0.024089463414800127,0.011425453109243745,0.0363,0.03232857142857143,3301881208.0899987,0.12080000000000002,148.85245901639345,-21.68468981217984,78.31531018782016,84.1980733866652,0.23523333333333332,0.22693529705756643,0.20442857142857143,0.20568029384255868,0.14171,0.15904665094711748,394509.0,83839362.0,927968.0,90749913.0
2023-01-17,0.2295,0.284,0.2237,0.2793,234311928.0,236563.0,122659252.0,0.24549999999999997,0.22824285714285716,0.15745,0.2537588242643916,0.22855141528643927,0.17657016097938644,83.60593381513884,0.28021583615285894,0.034684163847141056,0.0410251148239342,0.029480033208731715,0.011545081615202485,0.060299999999999965,0.03754999999999999,3620907928.0899987,0.1215,172.22222222222223,-2.5739320920043713,97.42606790799563,84.78356288128062,21.699346405228752,0.2278,0.25,0.2176,0.2295,84714792.0,66502.0,42380346.0,0.7462686567164211,80.33759124087592,0.2595817824758128,0.0369882175241872,0.03661096036545494,0.026593762804931094,0.010017197560523848,0.03240000000000001,0.03382857142857143,3386596000.0899987,0.10540000000000001,137.8238341968912,-21.39068945197406,78.60931054802596,80.44919611035692,0.23186666666666664,0.22821764852878323,0.21534285714285714,0.211635220381919,0.148285,0.16575649371405868,284605.0,57929010.333333336,891855.0,85850513.71428572
2023-01-18,0.279,0.2978,0.2377,0.2487,206045745.0,182949.0,99927628.0,0.25249999999999995,0.23797142857142856,0.16526000000000002,0.2512294121321958,0.23358856146482945,0.18343966945754012,74.06755805770584,0.2904777286926348,0.04004227130736526,0.04157494962959249,0.03189901649290387,0.009675933136688616,0.060100000000000015,0.040728571428571426,3414862183.0899987,0.10869999999999999,122.25201072386058,-25.572916666666668,74.42708333333333,83.48748726311834,-10.860215053763447,0.2295,0.284,0.2237,0.2793,234311928.0,236563.0,122659252.0,21.699346405228752,83.60593381513884,0.28021583615285894,0.034684163847141056,0.0410251148239342,0.029480033208731715,0.011545081615202485,0.060299999999999965,0.03754999999999999,3620907928.0899987,0.1215,172.22222222222223,-2.5739320920043713,97.42606790799563,84.78356288128062,0.24549999999999997,0.2537588242643916,0.22824285714285716,0.22855141528643927,0.15745,0.17657016097938644,394010.0,72731619.0,980278.0,87285711.85714285
2023-01-19,0.249,0.2746,0.2439,0.2722,102200958.0,99056.0,49855624.0,0.26673333333333327,0.24791428571428573,0.174185,0.2617147060660979,0.2432414210986221,0.1918930342711077,77.30426164519326,0.3033114133768687,0.045058586623131336,0.04340658715961429,0.03420053062624596,0.009206056533368333,0.030700000000000005,0.04233571428571429,3517063141.0899987,0.11909999999999998,154.63049579045838,-13.389121338912139,86.61087866108787,86.15467663413897,9.317269076305221,0.279,0.2978,0.2377,0.2487,206045745.0,182949.0,99927628.0,-10.860215053763447,74.06755805770584,0.2904777286926348,0.04004227130736526,0.04157494962959249,0.03189901649290387,0.009675933136688616,0.060100000000000015,0.040728571428571426,3414862183.0899987,0.10869999999999999,122.25201072386058,-25.572916666666668,74.42708333333333,83.48748726311834,0.25249999999999995,0.2512294121321958,0.23797142857142856,0.23358856146482945,0.16526000000000002,0.18343966945754012,486014.0,88322408.66666667,1020127.0,87010202.85714285
2023-01-20,0.2721,0.2942,0.2587,0.2828,102125000.0,94704.0,50279434.0,0.26789999999999997,0.2540857142857143,0.18374000000000001,0.272257353033049,0.25313106582396655,0.20055084053100222,76.79837892603851,0.3154232147717647,0.052056785228235286,0.045192552892142884,0.03639893507942534,0.008793617812717543,0.03550000000000003,0.042878571428571426,3619188141.0899987,0.0938,127.88074133763092,-8.615738081562329,91.38426191843767,84.14074130428632,3.9323778022785696,0.249,0.2746,0.2439,0.2722,102200958.0,99056.0,49855624.0,9.317269076305221,77.30426164519326,0.3033114133768687,0.045058586623131336,0.04340658715961429,0.03420053062624596,0.009206056533368333,0.030700000000000005,0.04233571428571429,3517063141.0899987,0.11909999999999998,154.63049579045838,-13.389121338912139,86.61087866108787,86.15467663413897,0.26673333333333327,0.2617147060660979,0.24791428571428573,0.2432414210986221,0.174185,0.1918930342711077,518568.0,90814168.0,979579.0,80905848.0
2023-01-21,0.2827,0.3071,0.2661,0.268,121047413.0,134517.0,61940490.0,0.27433333333333326,0.2583142857142857,0.19256500000000001,0.2701286765165245,0.25684829936797493,0.2069745700042401,69.8773448773449,0.3218554893314825,0.06327451066851753,0.04489617216529618,0.03809838249659951,0.006797789668696666,0.04099999999999998,0.04251428571428571,3498140728.0899987,0.0874,69.83523447401777,-23.19098457888492,76.80901542111508,84.93471866688024,-5.1998585072515,0.2721,0.2942,0.2587,0.2828,102125000.0,94704.0,50279434.0,3.9323778022785696,76.79837892603851,0.3154232147717647,0.052056785228235286,0.045192552892142884,0.03639893507942534,0.008793617812717543,0.03550000000000003,0.042878571428571426,3619188141.0899987,0.0938,127.88074133763092,-8.615738081562329,91.38426191843767,84.14074130428632,0.26789999999999997,0.272257353033049,0.2540857142857143,0.25313106582396655,0.18374000000000001,0.20055084053100222,376709.0,66687562.0,897877.0,70929852.71428572
2023-01-22,0.2679,0.2838,0.2565,0.2657,78107140.0,84213.0,38964744.0,0.2721666666666666,0.26374285714285717,0.201025,0.2679143382582623,0.2590612245259812,0.2125674680990744,74.01604891096676,0.32591649606546086,0.07613350393453916,0.043968851970014045,0.039272476391282424,0.004696375578731621,0.02729999999999999,0.042314285714285714,3420033588.0899987,0.06309999999999999,89.78571428571426,-24.555160142348754,75.44483985765125,81.21270573240135,-0.8212019410227829,0.2827,0.3071,0.2661,0.268,121047413.0,134517.0,61940490.0,-5.1998585072515,69.8773448773449,0.3218554893314825,0.06327451066851753,0.04489617216529618,0.03809838249659951,0.006797789668696666,0.04099999999999998,0.04251428571428571,3498140728.0899987,0.0874,69.83523447401777,-23.19098457888492,76.80901542111508,84.93471866688024,0.27433333333333326,0.2701286765165245,0.2583142857142857,0.25684829936797493,0.19256500000000001,0.2069745700042401,328277.0,54025182.666666664,905236.0,68599719.0
2023-01-23,0.2657,0.3071,0.2637,0.2849,153007200.0,157449.0,79007949.0,0.2728666666666666,0.2716571428571429,0.21014,0.2764071691291311,0.2655209183944859,0.21945628066106732,74.60791635548918,0.3313408580827522,0.08893914191724776,0.04427287344698658,0.040272555802423254,0.004000317644563323,0.043399999999999994,0.04297142857142856,3573040788.0899987,0.04529999999999998,86.08752449379489,-13.79738968303294,86.20261031696707,79.48548853191116,7.226194956718102,0.2679,0.2838,0.2565,0.2657,78107140.0,84213.0,38964744.0,-0.8212019410227829,74.01604891096676,0.32591649606546086,0.07613350393453916,0.043968851970014045,0.039272476391282424,0.004696375578731621,0.02729999999999999,0.042314285714285714,3420033588.0899987,0.06309999999999999,89.78571428571426,-24.555160142348754,75.44483985765125,81.21270573240135,0.2721666666666666,0.2679143382582623,0.26374285714285717,0.2590612245259812,0.201025,0.2125674680990744,313434.0,50394889.333333336,898504.0,66572502.571428575
2023-01-24,0.2849,0.2934,0.2567,0.266,63734528.0,77799.0,30579499.0,0.27219999999999994,0.26975714285714286,0.21784499999999998,0.27120358456456556,0.26564068879586444,0.22388901583620374,65.35087719298247,0.33214629114708316,0.1035437088529168,0.04249884043382274,0.04071781272870316,0.0017810277051195783,0.03670000000000001,0.04185714285714286,3509306260.0899987,0.027600000000000013,40.74074074074075,-30.489614243323427,69.51038575667657,77.05261197709832,-6.633906633906625,0.2657,0.3071,0.2637,0.2849,153007200.0,157449.0,79007949.0,7.226194956718102,74.60791635548918,0.3313408580827522,0.08893914191724776,0.04427287344698658,0.040272555802423254,0.004000317644563323,0.043399999999999994,0.04297142857142856,3573040788.0899987,0.04529999999999998,86.08752449379489,-13.79738968303294,86.20261031696707,79.48548853191116,0.2728666666666666,0.2764071691291311,0.2716571428571429,0.2655209183944859,0.21014,0.21945628066106732,376179.0,59971061.0,989451.0,71805017.28571428
2023-01-25,0.2658,0.2796,0.2524,0.2701,63456338.0,72795.0,30333985.0,0.27366666666666656,0.27281428571428573,0.226005,0.27065179228228275,0.26675551659689833,0.2282900619470415,68.15415821501014,0.32977378092534615,0.12223621907465389,0.040951676786086716,0.04076458554017987,0.00018709124590684384,0.027200000000000002,0.04122857142857143,3572762598.0899987,0.04239999999999999,49.55703211517164,-28.793774319066134,71.20622568093387,75.63974058485921,1.6177577125658489,0.2849,0.2934,0.2567,0.266,63734528.0,77799.0,30579499.0,-6.633906633906625,65.35087719298247,0.33214629114708316,0.1035437088529168,0.04249884043382274,0.04071781272870316,0.0017810277051195783,0.03670000000000001,0.04185714285714286,3509306260.0899987,0.027600000000000013,40.74074074074075,-30.489614243323427,69.51038575667657,77.05261197709832,0.27219999999999994,0.27120358456456556,0.26975714285714286,0.26564068879586444,0.21784499999999998,0.22388901583620374,319461.0,49517397.333333336,830687.0,58650766.85714286
2023-01-26,0.2703,0.2801,0.2598,0.2635,46947088.0,56039.0,22699441.0,0.2665333333333333,0.2715714285714286,0.23297500000000002,0.26707589614114136,0.26594163744767374,0.23164338938065657,63.17611423626136,0.3261047199439461,0.13984528005605396,0.03874633003317576,0.040360934438779056,-0.0016146044056032927,0.02030000000000004,0.039842857142857145,3525815510.0899987,0.034,30.059230009871673,-41.09330819981148,58.90669180018852,66.54110107926634,-2.5157232704402417,0.2658,0.2796,0.2524,0.2701,63456338.0,72795.0,30333985.0,1.6177577125658489,68.15415821501014,0.32977378092534615,0.12223621907465389,0.040951676786086716,0.04076458554017987,0.00018709124590684384,0.027200000000000002,0.04122857142857143,3572762598.0899987,0.04239999999999999,49.55703211517164,-28.793774319066134,71.20622568093387,75.63974058485921,0.27366666666666656,0.27065179228228275,0.27281428571428573,0.26675551659689833,0.226005,0.2282900619470415,308043.0,46640477.666666664,720533.0,48708817.85714286
2023-01-27,0.2633,0.3013,0.2562,0.2807,91977698.0,120077.0,48118818.0,0.27143333333333325,0.27127142857142855,0.23912,0.2738879480705707,0.2696312280857553,0.23631544753487976,59.725508755324185,0.3274597889729496,0.15078021102705041,0.03794902041157114,0.03987855163333748,-0.0019295312217663396,0.04510000000000003,0.03910000000000001,3617793208.0899987,0.0014000000000000123,17.153589315525885,-27.67295597484275,72.32704402515725,67.4799871687599,6.60843144701862,0.2703,0.2801,0.2598,0.2635,46947088.0,56039.0,22699441.0,-2.5157232704402417,63.17611423626136,0.3261047199439461,0.13984528005605396,0.03874633003317576,0.040360934438779056,-0.0016146044056032927,0.02030000000000004,0.039842857142857145,3525815510.0899987,0.034,30.059230009871673,-41.09330819981148,58.90669180018852,66.54110107926634,0.2665333333333333,0.26707589614114136,0.2715714285714286,0.26594163744767374,0.23297500000000002,0.23164338938065657,206633.0,27870975.0,677516.0,44829363.14285714
2023-01-28,0.2808,0.3119,0.28,0.2946,99046589.0,116481.0,48905568.0,0.2795999999999999,0.2750714285714286,0.24685,0.28424397403528534,0.27587342106431645,0.24186635729346265,62.54464285714286,0.32515683239664267,0.16854316760335736,0.03800071207086589,0.03950298372084316,-0.0015022716499772729,0.031899999999999984,0.03772857142857143,3716839797.0899987,0.04589999999999997,23.573825503355692,-17.26546906187628,82.73453093812371,71.32275558782318,4.914529914529908,0.2633,0.3013,0.2562,0.2807,91977698.0,120077.0,48118818.0,6.60843144701862,59.725508755324185,0.3274597889729496,0.15078021102705041,0.03794902041157114,0.03987855163333748,-0.0019295312217663396,0.04510000000000003,0.03910000000000001,3617793208.0899987,0.0014000000000000123,17.153589315525885,-27.67295597484275,72.32704402515725,67.4799871687599,0.27143333333333325,0.2738879480705707,0.27127142857142855,0.2696312280857553,0.23912,0.23631544753487976,248911.0,33717414.666666664,702889.0,44520703.71428572
2023-01-29,0.2944,0.2969,0.2833,0.2891,44306486.0,50625.0,21284256.0,0.2881333333333333,0.2784142857142857,0.25365000000000004,0.2866719870176427,0.27918006579823734,0.24636479945599002,64.0310786106033,0.32045373453156933,0.18684626546843072,0.037169408247568425,0.03903626862618821,-0.0018668603786197863,0.013600000000000001,0.03610714285714286,3672533311.0899987,0.016900000000000026,26.965305226174795,-24.17815482502649,75.82184517497352,76.96114004608485,-1.800271739130425,0.2808,0.3119,0.28,0.2946,99046589.0,116481.0,48905568.0,4.914529914529908,62.54464285714286,0.32515683239664267,0.16854316760335736,0.03800071207086589,0.03950298372084316,-0.0015022716499772729,0.031899999999999984,0.03772857142857143,3716839797.0899987,0.04589999999999997,23.573825503355692,-17.26546906187628,82.73453093812371,71.32275558782318,0.2795999999999999,0.28424397403528534,0.2750714285714286,0.27587342106431645,0.24685,0.24186635729346265,292597.0,39907942.333333336,684853.0,42658572.0
2023-01-30,0.2891,0.2892,0.2588,0.2659,48130992.0,58911.0,22331718.0,0.28319999999999995,0.2757,0.25749500000000003,0.2762859935088213,0.275860049348678,0.24822529474589575,57.577019150707756,0.3170950167784877,0.19789498322151233,0.034243806582619496,0.03807777621747447,-0.0038339696348549737,0.030400000000000038,0.03596428571428572,3624402319.0899987,-0.01689999999999997,15.860566448801737,-52.154195011337855,47.84580498866215,68.80072703391983,-8.024904877205117,0.2944,0.2969,0.2833,0.2891,44306486.0,50625.0,21284256.0,-1.800271739130425,64.0310786106033,0.32045373453156933,0.18684626546843072,0.037169408247568425,0.03903626862618821,-0.0018668603786197863,0.013600000000000001,0.03610714285714286,3672533311.0899987,0.016900000000000026,26.965305226174795,-24.17815482502649,75.82184517497352,76.96114004608485,0.2881333333333333,0.2866719870176427,0.2784142857142857,0.27918006579823734,0.25365000000000004,0.24636479945599002,287183.0,39436214.0,651265.0,40132788.0
2023-01-31,0.266,0.2866,0.2583,0.275,60718192.0,72700.0,28997525.0,0.2766666666666666,0.2769857142857143,0.262215,0.2756429967544107,0.27564503701150855,0.25077526667485806,48.922305764411036,0.3099440279102689,0.21448597208973105,0.032287351641903134,0.036919691302360204,-0.00463233966045707,0.028300000000000047,0.03367857142857144,3685120511.0899987,0.007000000000000006,-1.5395631936985232,-49.73045822102423,50.26954177897577,57.97906398087051,3.383458646616544,0.2891,0.2892,0.2588,0.2659,48130992.0,58911.0,22331718.0,-8.024904877205117,57.577019150707756,0.3170950167784877,0.19789498322151233,0.034243806582619496,0.03807777621747447,-0.0038339696348549737,0.030400000000000038,0.03596428571428572,3624402319.0899987,-0.01689999999999997,15.860566448801737,-52.154195011337855,47.84580498866215,68.80072703391983,0.28319999999999995,0.2762859935088213,0.2757,0.275860049348678,0.25749500000000003,0.24822529474589575,226017.0,30840514.0,552727.0,32036183.57142857
2023-02-01,0.275,0.3,0.2575,0.2886,86038813.0,119760.0,42997655.0,0.2764999999999999,0.27962857142857145,0.26651499999999995,0.28212149837720535,0.27888377775863143,0.2543776222296335,60.931506849315085,0.3064971157387086,0.2265328842612913,0.031471469832032445,0.03583004700829465,-0.004358577176262209,0.04249999999999998,0.03242142857142858,3771159324.0899987,0.02290000000000003,16.043425814234013,-34.26470588235292,65.73529411764709,54.61688029509503,4.945454545454545,0.266,0.2866,0.2583,0.275,60718192.0,72700.0,28997525.0,3.383458646616544,48.922305764411036,0.3099440279102689,0.21448597208973105,0.032287351641903134,0.036919691302360204,-0.00463233966045707,0.028300000000000047,0.03367857142857144,3685120511.0899987,0.007000000000000006,-1.5395631936985232,-49.73045822102423,50.26954177897577,57.97906398087051,0.2766666666666666,0.2756429967544107,0.2769857142857143,0.27564503701150855,0.262215,0.25077526667485806,182236.0,24204499.666666668,547628.0,31810187.285714287
2023-02-02,0.2886,0.3011,0.2721,0.2748,87646238.0,115243.0,42712218.0,0.2794666666666666,0.2812428571428572,0.26827500000000004,0.27846074918860264,0.27786283331897355,0.256322610588716,50.75231481481481,0.3063206166642699,0.23022938333573018,0.029372742262110618,0.03453858605905785,-0.005165843796947234,0.02899999999999997,0.03230000000000001,3683513086.0899987,-0.010099999999999998,0.9551800146950784,-62.35294117647064,37.64705882352937,51.21729824005077,-4.781704781704793,0.275,0.3,0.2575,0.2886,86038813.0,119760.0,42997655.0,4.945454545454545,60.931506849315085,0.3064971157387086,0.2265328842612913,0.031471469832032445,0.03583004700829465,-0.004358577176262209,0.04249999999999998,0.03242142857142858,3771159324.0899987,0.02290000000000003,16.043425814234013,-34.26470588235292,65.73529411764709,54.61688029509503,0.2764999999999999,0.28212149837720535,0.27962857142857145,0.27888377775863143,0.26651499999999995,0.2543776222296335,251371.0,31442299.333333332,594593.0,33619283.0
2023-02-03,0.2748,0.3373,0.2679,0.3301,181360077.0,208918.0,91397238.0,0.29783333333333323,0.2883,0.27286,0.30428037459430135,0.29092212498923015,0.2633490286278859,60.87356321839081,0.3173094935143294,0.22841050648567057,0.031805103940808765,0.033991889635408036,-0.0021867856945992706,0.06939999999999996,0.03472142857142858,3864873163.0899987,0.06409999999999999,16.725601131541733,-8.480565371024719,91.51943462897528,64.96726252338395,20.123726346433777,0.2886,0.3011,0.2721,0.2748,87646238.0,115243.0,42712218.0,-4.781704781704793,50.75231481481481,0.3063206166642699,0.23022938333573018,0.029372742262110618,0.03453858605905785,-0.005165843796947234,0.02899999999999997,0.03230000000000001,3683513086.0899987,-0.010099999999999998,0.9551800146950784,-62.35294117647064,37.64705882352937,51.21729824005077,0.2794666666666666,0.27846074918860264,0.2812428571428572,0.27786283331897355,0.26827500000000004,0.256322610588716,307703.0,38235799.333333336,653797.0,36478251.14285714
2023-02-04,0.3301,0.3507,0.3143,0.3317,140521111.0,185290.0,68006238.0,0.3121999999999999,0.2936,0.27806000000000003,0.3179901872971507,0.30111659374192257,0.2698586449490396,65.58981889378364,0.3245511264877668,0.23156887351223324,0.033475984413397775,0.033888708591005984,-0.0004127241776082091,0.03639999999999999,0.03439285714285715,4005394274.0899987,0.06159999999999999,23.7686567164179,-19.328585961342846,80.67141403865715,69.94596916372063,0.4847016055740655,0.2748,0.3373,0.2679,0.3301,181360077.0,208918.0,91397238.0,20.123726346433777,60.87356321839081,0.3173094935143294,0.22841050648567057,0.031805103940808765,0.033991889635408036,-0.0021867856945992706,0.06939999999999996,0.03472142857142858,3864873163.0899987,0.06409999999999999,16.725601131541733,-8.480565371024719,91.51943462897528,64.96726252338395,0.29783333333333323,0.30428037459430135,0.2883,0.29092212498923015,0.27286,0.2633490286278859,443921.0,59035703.666666664,742638.0,42660882.571428575
2023-02-05,0.3317,0.4624,0.327,0.4498,335982848.0,406730.0,176459149.0,0.3705333333333332,0.31655714285714287,0.28907499999999997,0.3838950936485753,0.33828744530644195,0.2869959168586549,78.75663855045299,0.37488595194484564,0.2032640480551543,0.04382466872196872,0.03587590061719853,0.007948768104770187,0.13539999999999996,0.042114285714285715,4341377122.089998,0.18629999999999997,69.28867143394805,-6.000000000000001,94.0,88.73028288921084,35.60446186312933,0.3301,0.3507,0.3143,0.3317,140521111.0,185290.0,68006238.0,0.4847016055740655,65.58981889378364,0.3245511264877668,0.23156887351223324,0.033475984413397775,0.033888708591005984,-0.0004127241776082091,0.03639999999999999,0.03439285714285715,4005394274.0899987,0.06159999999999999,23.7686567164179,-19.328585961342846,80.67141403865715,69.94596916372063,0.3121999999999999,0.3179901872971507,0.2936,0.30111659374192257,0.27806000000000003,0.2698586449490396,509451.0,67371898.0,811447.0,45389549.71428572
2023-02-06,0.4494,0.4755,0.4063,0.4329,237198532.0,347562.0,119387006.0,0.4047999999999999,0.34041428571428567,0.296755,0.40839754682428764,0.3619405839798315,0.3008915438244973,73.28508495909378,0.4037593279990245,0.1897506720009755,0.05008503769623973,0.03871772803300677,0.01136730966323296,0.06919999999999998,0.043957142857142854,4104178590.0899982,0.1522,51.94805194805197,-19.094576423128633,80.90542357687137,85.1922792051762,-3.671562082777039,0.3317,0.4624,0.327,0.4498,335982848.0,406730.0,176459149.0,35.60446186312933,78.75663855045299,0.37488595194484564,0.2032640480551543,0.04382466872196872,0.03587590061719853,0.007948768104770187,0.13539999999999996,0.042114285714285715,4341377122.089998,0.18629999999999997,69.28867143394805,-6.000000000000001,94.0,88.73028288921084,0.3705333333333332,0.3838950936485753,0.31655714285714287,0.33828744530644195,0.28907499999999997,0.2869959168586549,800938.0,111954208.33333333,1167552.0,67557391.57142857
2023-02-07,0.433,0.5944,0.433,0.5404,327135033.0,506802.0,164191639.0,0.4743666666666666,0.3783285714285714,0.31134,0.4743987734121438,0.4065554379848736,0.323701872984069,83.75984251968504,0.46155830290052036,0.16112169709947968,0.06299461409834678,0.04357310524607477,0.019421508852272007,0.16140000000000004,0.05286428571428572,4431313623.089998,0.24580000000000002,103.15789473684207,-15.78947368421054,84.21052631578945,86.37198329755363,24.803695150115473,0.4494,0.4755,0.4063,0.4329,237198532.0,347562.0,119387006.0,-3.671562082777039,73.28508495909378,0.4037593279990245,0.1897506720009755,0.05008503769623973,0.03871772803300677,0.01136730966323296,0.06919999999999998,0.043957142857142854,4104178590.0899982,0.1522,51.94805194805197,-19.094576423128633,80.90542357687137,85.1922792051762,0.4047999999999999,0.40839754682428764,0.34041428571428567,0.3619405839798315,0.296755,0.3008915438244973,939582.0,121284131.0,1456203.0,81422432.71428572
2023-02-08,0.5406,0.6083,0.4448,0.4771,303918629.0,410919.0,146042588.0,0.48346666666666654,0.4052571428571428,0.321585,0.4757493867060719,0.4241915784886552,0.3383112184141576,72.22938144329898,0.48767409815611806,0.15549590184388198,0.06734149459460337,0.048326783115780494,0.019014711478822874,0.16349999999999998,0.0626,4127394994.0899982,0.188,76.63828211773418,-37.262141437091714,62.73785856290828,75.95126948518973,-11.746207917129107,0.433,0.5944,0.433,0.5404,327135033.0,506802.0,164191639.0,24.803695150115473,83.75984251968504,0.46155830290052036,0.16112169709947968,0.06299461409834678,0.04357310524607477,0.019421508852272007,0.16140000000000004,0.05286428571428572,4431313623.089998,0.24580000000000002,103.15789473684207,-15.78947368421054,84.21052631578945,86.37198329755363,0.4743666666666666,0.4743987734121438,0.3783285714285714,0.4065554379848736,0.31134,0.323701872984069,1261094.0,153345931.33333334,1890305.0,100735877.57142857
2023-02-09,0.477,0.4966,0.3643,0.389,229060904.0,384838.0,110409770.0,0.4688333333333332,0.4215714285714286,0.32689500000000005,0.43237469335303597,0.4153936838664914,0.3431387214223331,61.46956680679949,0.49454634843351497,0.1592436515664851,0.06295182552933881,0.051251791598492163,0.011700033930846648,0.13229999999999997,0.0706,3898334090.0899982,0.12309999999999999,47.628083491461105,-62.28344220391933,37.71655779608067,61.554980891592834,-18.44863731656184,0.5406,0.6083,0.4448,0.4771,303918629.0,410919.0,146042588.0,-11.746207917129107,72.22938144329898,0.48767409815611806,0.15549590184388198,0.06734149459460337,0.048326783115780494,0.019014711478822874,0.16349999999999998,0.0626,4127394994.0899982,0.188,76.63828211773418,-37.262141437091714,62.73785856290828,75.95126948518973,0.48346666666666654,0.4757493867060719,0.4052571428571428,0.4241915784886552,0.321585,0.3383112184141576,1265283.0,143207077.66666666,2181464.0,115456582.28571428
2023-02-10,0.389,0.4531,0.3791,0.4218,220107879.0,319846.0,109251557.0,0.42929999999999985,0.43467142857142854,0.334585,0.427087346676518,0.41699526289986855,0.3506302717630633,62.53776435045318,0.504949158264142,0.16422084173585802,0.061411750614623395,0.05328378340171842,0.008127967212904978,0.07400000000000001,0.07266428571428571,4118441969.0899982,0.14679999999999999,50.267189169932315,-53.16419612314709,46.835803876852914,49.09674007861398,8.431876606683804,0.477,0.4966,0.3643,0.389,229060904.0,384838.0,110409770.0,-18.44863731656184,61.46956680679949,0.49454634843351497,0.1592436515664851,0.06295182552933881,0.051251791598492163,0.011700033930846648,0.13229999999999997,0.0706,3898334090.0899982,0.12309999999999999,47.628083491461105,-62.28344220391933,37.71655779608067,61.554980891592834,0.4688333333333332,0.43237469335303597,0.4215714285714286,0.4153936838664914,0.32689500000000005,0.3431387214223331,1302559.0,140214665.66666666,2451059.0,125127661.14285715
2023-02-11,0.4218,0.4291,0.3953,0.4169,73677769.0,110650.0,34365516.0,0.40923333333333317,0.44684285714285715,0.34214500000000003,0.421993673338259,0.4169714471749014,0.35694167445229535,61.04388658118115,0.5130566666277372,0.17123333337226285,0.05911440701346893,0.054449908124068525,0.004664498889400404,0.0338,0.07279999999999999,4044764200.0899982,0.12829999999999997,41.51391717583164,-54.56100342075256,45.43899657924744,43.330452750727034,-1.1616880037932704,0.389,0.4531,0.3791,0.4218,220107879.0,319846.0,109251557.0,8.431876606683804,62.53776435045318,0.504949158264142,0.16422084173585802,0.061411750614623395,0.05328378340171842,0.008127967212904978,0.07400000000000001,0.07266428571428571,4118441969.0899982,0.14679999999999999,50.267189169932315,-53.16419612314709,46.835803876852914,49.09674007861398,0.42929999999999985,0.427087346676518,0.43467142857142854,0.41699526289986855,0.334585,0.3506302717630633,1115603.0,121901305.0,2561987.0,127678278.14285715
2023-02-12,0.417,0.43,0.3935,0.3982,64536990.0,95121.0,30855075.0,0.4122999999999999,0.43947142857142857,0.34781000000000006,0.4100968366691295,0.4122785853811761,0.360871038790172,59.6225083789028,0.5182426494542556,0.1773773505457445,0.055149087587909484,0.05458974401683672,0.0005593435710727623,0.03649999999999998,0.07443571428571427,3980227210.0899982,0.12340000000000001,37.73780698720164,-59.89167616875712,40.10832383124288,44.12770809578111,-4.508393285371699,0.4218,0.4291,0.3953,0.4169,73677769.0,110650.0,34365516.0,-1.1616880037932704,61.04388658118115,0.5130566666277372,0.17123333337226285,0.05911440701346893,0.054449908124068525,0.004664498889400404,0.0338,0.07279999999999999,4044764200.0899982,0.12829999999999997,41.51391717583164,-54.56100342075256,45.43899657924744,43.330452750727034,0.40923333333333317,0.421993673338259,0.44684285714285715,0.4169714471749014,0.34214500000000003,0.35694167445229535,815334.0,84675614.33333333,2487347.0,122872460.71428572
2023-02-13,0.3982,0.4088,0.3652,0.3855,80095796.0,121287.0,39264489.0,0.4001999999999999,0.43270000000000003,0.353785,0.39779841833456475,0.4055839390358821,0.36321665414348897,60.747663551401864,0.5204793408252216,0.18709065917477843,0.05040077080050065,0.05375194937356951,-0.0033511785730688595,0.04359999999999997,0.07537857142857142,3900131414.0899982,0.055400000000000005,44.97931553215493,-63.511972633979475,36.48802736602053,40.678449258836984,-3.1893520843797063,0.417,0.43,0.3935,0.3982,64536990.0,95121.0,30855075.0,-4.508393285371699,59.6225083789028,0.5182426494542556,0.1773773505457445,0.055149087587909484,0.05458974401683672,0.0005593435710727623,0.03649999999999998,0.07443571428571427,3980227210.0899982,0.12340000000000001,37.73780698720164,-59.89167616875712,40.10832383124288,44.12770809578111,0.4122999999999999,0.4100968366691295,0.43947142857142857,0.4122785853811761,0.34781000000000006,0.360871038790172,525617.0,58157382.666666664,2175738.0,102071878.71428572
2023-02-14,0.3855,0.463,0.378,0.453,170587368.0,233252.0,88200552.0,0.41223333333333323,0.42021428571428576,0.36293000000000003,0.42539920916728236,0.4174379542769116,0.37176744898696623,64.47625243981783,0.5303601626601923,0.19549983733980783,0.0514908272114995,0.053299724941155514,-0.001808897729656013,0.08500000000000002,0.07942857142857142,4070718782.0899982,0.12130000000000002,64.72727272727272,-44.270239452679576,55.72976054732042,44.1087039148613,17.509727626459146,0.3982,0.4088,0.3652,0.3855,80095796.0,121287.0,39264489.0,-3.1893520843797063,60.747663551401864,0.5204793408252216,0.18709065917477843,0.05040077080050065,0.05375194937356951,-0.0033511785730688595,0.04359999999999997,0.07537857142857142,3900131414.0899982,0.055400000000000005,44.97931553215493,-63.511972633979475,36.48802736602053,40.678449258836984,0.4001999999999999,0.39779841833456475,0.43270000000000003,0.4055839390358821,0.353785,0.36321665414348897,327058.0,34828360.0,1949463.0,90625804.85714285
2023-02-15,0.4531,0.4798,0.4109,0.4734,138049210.0,201857.0,68164858.0,0.43729999999999986,0.41968571428571433,0.373425,0.44939960458364114,0.43142846570768373,0.3814467395596361,64.86486486486487,0.5409270675441842,0.2059229324558158,0.05338542038579763,0.05331686403008394,6.855635571369201e-05,0.06890000000000002,0.0813142857142857,4208767992.0899982,0.02360000000000001,64.03326403326402,-39.62984723854289,60.370152761457106,50.86264689159938,4.480247186051641,0.3855,0.463,0.378,0.453,170587368.0,233252.0,88200552.0,17.509727626459146,64.47625243981783,0.5303601626601923,0.19549983733980783,0.0514908272114995,0.053299724941155514,-0.001808897729656013,0.08500000000000002,0.07942857142857142,4070718782.0899982,0.12130000000000002,64.72727272727272,-44.270239452679576,55.72976054732042,44.1087039148613,0.41223333333333323,0.42539920916728236,0.42021428571428576,0.4174379542769116,0.36293000000000003,0.37176744898696623,449660.0,52773372.0,1675913.0,79769935.28571428
2023-02-16,0.4734,0.4839,0.4085,0.4133,124153803.0,183196.0,59703004.0,0.44656666666666656,0.42315714285714284,0.38005500000000003,0.43134980229182057,0.4268963492807628,0.3844803834110993,60.36831861057045,0.5425250325404097,0.2175849674595903,0.0494671054039994,0.052546912304867036,-0.003079806900867635,0.07540000000000002,0.08462857142857143,4084614189.0899982,-0.019600000000000006,50.40029112081514,-57.285546415981194,42.714453584018806,52.9381222975988,-12.695395014786648,0.4531,0.4798,0.4109,0.4734,138049210.0,201857.0,68164858.0,4.480247186051641,64.86486486486487,0.5409270675441842,0.2059229324558158,0.05338542038579763,0.05331686403008394,6.855635571369201e-05,0.06890000000000002,0.0813142857142857,4208767992.0899982,0.02360000000000001,64.03326403326402,-39.62984723854289,60.370152761457106,50.86264689159938,0.43729999999999986,0.44939960458364114,0.41968571428571433,0.43142846570768373,0.373425,0.3814467395596361,556396.0,65209966.333333336,1466851.0,68644545.28571428
2023-02-17,0.4133,0.448,0.4118,0.4428,71479177.0,105447.0,35578652.0,0.44316666666666654,0.4261571428571429,0.387465,0.4370749011459103,0.43087226196057216,0.39003463261004223,58.7758916056689,0.5470167705125264,0.22791322948747358,0.048186749160094855,0.051674879675912604,-0.0034881305158177486,0.03620000000000001,0.08225714285714288,4156093366.0899982,-0.09759999999999996,34.141169342623456,-56.29251700680271,43.70748299319729,48.93069644622443,7.1376723929349195,0.4734,0.4839,0.4085,0.4133,124153803.0,183196.0,59703004.0,-12.695395014786648,60.36831861057045,0.5425250325404097,0.2175849674595903,0.0494671054039994,0.052546912304867036,-0.003079806900867635,0.07540000000000002,0.08462857142857143,4084614189.0899982,-0.019600000000000006,50.40029112081514,-57.285546415981194,42.714453584018806,52.9381222975988,0.44656666666666656,0.43134980229182057,0.42315714285714284,0.4268963492807628,0.38005500000000003,0.3844803834110993,618305.0,72022804.66666667,1265209.0,61400721.571428575
2023-02-18,0.4428,0.4549,0.4294,0.4321,42021565.0,61772.0,20256879.0,0.42939999999999995,0.4283285714285715,0.394615,0.4345874505729551,0.43117919647042907,0.3940408580757525,57.708845208845204,0.5483158752500432,0.24091412474995672,0.04578092305264714,0.050496088351259516,-0.004715165298612378,0.025500000000000023,0.08147857142857143,4114071801.0899982,-0.04500000000000004,30.268314742236967,-62.637753288304296,37.3622467116957,41.26139442963729,-2.4164408310749868,0.4133,0.448,0.4118,0.4428,71479177.0,105447.0,35578652.0,7.1376723929349195,58.7758916056689,0.5470167705125264,0.22791322948747358,0.048186749160094855,0.051674879675912604,-0.0034881305158177486,0.03620000000000001,0.08225714285714288,4156093366.0899982,-0.09759999999999996,34.141169342623456,-56.29251700680271,43.70748299319729,48.93069644622443,0.44316666666666654,0.4370749011459103,0.4261571428571429,0.43087226196057216,0.387465,0.39003463261004223,490500.0,54482171.333333336,1050810.0,50876020.85714286
2023-02-19,0.4322,0.4428,0.4082,0.4142,44392792.0,65676.0,20496117.0,0.4296999999999999,0.4306142857142857,0.40203,0.42439372528647756,0.4269343973528218,0.3959607763542523,46.76950998185118,0.5433993795476308,0.2606606204523692,0.04194637640945997,0.04878614596289961,-0.006839769553439637,0.03460000000000002,0.07427857142857144,4069679009.0899982,0.0252,-7.914628723877271,-79.54918032786885,20.45081967213115,33.840183125674734,-4.164738546968987,0.4428,0.4549,0.4294,0.4321,42021565.0,61772.0,20256879.0,-2.4164408310749868,57.708845208845204,0.5483158752500432,0.24091412474995672,0.04578092305264714,0.050496088351259516,-0.004715165298612378,0.025500000000000023,0.08147857142857143,4114071801.0899982,-0.04500000000000004,30.268314742236967,-62.637753288304296,37.3622467116957,41.26139442963729,0.42939999999999995,0.4345874505729551,0.4283285714285715,0.43117919647042907,0.394615,0.3940408580757525,350415.0,38512845.0,1001932.0,48860501.28571428
2023-02-20,0.4144,0.43,0.4048,0.4175,45824089.0,75303.0,21951640.0,0.4212666666666665,0.4351857142857143,0.409155,0.4209468626432388,0.4245757980146163,0.3980121309871807,48.56717528842575,0.5373140865825837,0.28099591341741625,0.038727328453578735,0.04677438246103544,-0.008047054007456707,0.0252,0.07113571428571429,4115503098.0899982,-0.004300000000000026,-3.55740355740356,-78.19672131147541,21.803278688524582,26.53878169078384,0.7480694980694961,0.4322,0.4428,0.4082,0.4142,44392792.0,65676.0,20496117.0,-4.164738546968987,46.76950998185118,0.5433993795476308,0.2606606204523692,0.04194637640945997,0.04878614596289961,-0.006839769553439637,0.03460000000000002,0.07427857142857144,4069679009.0899982,0.0252,-7.914628723877271,-79.54918032786885,20.45081967213115,33.840183125674734,0.4296999999999999,0.42439372528647756,0.4306142857142857,0.4269343973528218,0.40203,0.3959607763542523,232895.0,25443882.666666668,972487.0,47380650.14285714
2023-02-21,0.4175,0.5016,0.4048,0.4347,260311353.0,369740.0,128844380.0,0.4221333333333332,0.4325714285714285,0.41646,0.4278234313216194,0.42710684851096226,0.4015062137503063,38.17937821516439,0.531689152013205,0.30123084798679506,0.0371360250299842,0.0448467109748252,-0.007710685944840999,0.09680000000000005,0.06652142857142858,4375814451.089998,0.017799999999999983,-19.55958549222798,-71.14754098360656,28.852459016393432,23.702185792349752,4.119760479041915,0.4144,0.43,0.4048,0.4175,45824089.0,75303.0,21951640.0,0.7480694980694961,48.56717528842575,0.5373140865825837,0.28099591341741625,0.038727328453578735,0.04677438246103544,-0.008047054007456707,0.0252,0.07113571428571429,4115503098.0899982,-0.004300000000000026,-3.55740355740356,-78.19672131147541,21.803278688524582,26.53878169078384,0.4212666666666665,0.4209468626432388,0.4351857142857143,0.4245757980146163,0.409155,0.3980121309871807,202751.0,20901545.333333332,926503.0,44907386.0
2023-02-22,0.4346,0.4417,0.4031,0.4377,105005098.0,160909.0,51440401.0,0.42996666666666655,0.4274714285714286,0.424605,0.4327617156608097,0.4297551363832217,0.4049532410121819,44.90692864529471,0.5187785346664717,0.33043146533352835,0.03570539100830783,0.04301844698152173,-0.007313055973213897,0.03859999999999997,0.0576,4480819549.089998,0.03949999999999998,-8.258226786837152,-46.54042243262932,53.45957756737069,34.705105090762935,0.713299585826045,0.4175,0.5016,0.4048,0.4347,260311353.0,369740.0,128844380.0,4.119760479041915,38.17937821516439,0.531689152013205,0.30123084798679506,0.0371360250299842,0.0448467109748252,-0.007710685944840999,0.09680000000000005,0.06652142857142858,4375814451.089998,0.017799999999999983,-19.55958549222798,-71.14754098360656,28.852459016393432,23.702185792349752,0.4221333333333332,0.4278234313216194,0.4325714285714285,0.42710684851096226,0.41646,0.4015062137503063,510719.0,57097379.0,1062991.0,50713647.14285714
2023-02-23,0.4377,0.4724,0.4262,0.4363,93687832.0,151125.0,47011491.0,0.4362333333333332,0.43075714285714284,0.429915,0.43453085783040485,0.4313913522874163,0.40793864663006935,57.88070643118961,0.5129720704236953,0.3468579295763046,0.03406594394279722,0.04122794637377683,-0.007162002430979614,0.04619999999999996,0.05145,4387131717.089998,0.05080000000000001,12.159383033419036,-47.87390029325515,52.12609970674485,44.81271209683635,-0.31985378112861707,0.4346,0.4417,0.4031,0.4377,105005098.0,160909.0,51440401.0,0.713299585826045,44.90692864529471,0.5187785346664717,0.33043146533352835,0.03570539100830783,0.04301844698152173,-0.007313055973213897,0.03859999999999997,0.0576,4480819549.089998,0.03949999999999998,-8.258226786837152,-46.54042243262932,53.45957756737069,34.705105090762935,0.42996666666666655,0.4327617156608097,0.4274714285714286,0.4297551363832217,0.424605,0.4049532410121819,605952.0,67412140.33333333,1022043.0,48324439.0
2023-02-24,0.4363,0.4811,0.431,0.4738,167569885.0,280945.0,87696112.0,0.44926666666666654,0.4351857142857143,0.43701999999999996,0.4541654289152024,0.44199351421556227,0.41421115647482465,58.53018372703412,0.5081578972211788,0.3658821027788212,0.035384713974744186,0.04005929989397031,-0.004674585919226121,0.05010000000000003,0.04974285714285715,4554701602.089998,0.020799999999999985,12.328117591275479,-20.381231671554286,79.61876832844573,61.73481520085378,8.59500343800137,0.4377,0.4724,0.4262,0.4363,93687832.0,151125.0,47011491.0,-0.31985378112861707,57.88070643118961,0.5129720704236953,0.3468579295763046,0.03406594394279722,0.04122794637377683,-0.007162002430979614,0.04619999999999996,0.05145,4387131717.089998,0.05080000000000001,12.159383033419036,-47.87390029325515,52.12609970674485,44.81271209683635,0.4362333333333332,0.43453085783040485,0.43075714285714284,0.4313913522874163,0.429915,0.40793864663006935,681774.0,75765424.0,989972.0,46511365.71428572
2023-02-25,0.4738,0.4827,0.4035,0.4261,113103161.0,181840.0,53716228.0,0.44539999999999985,0.43432857142857145,0.435835,0.44013271445760116,0.4380201356616717,0.4153434272867461,51.32336018411968,0.506866031765578,0.36480396823442196,0.03220956554991927,0.0384893530251601,-0.006279787475240828,0.07919999999999999,0.05298571428571429,4441598441.089998,-0.04730000000000001,2.2067642120412456,-55.351906158357814,44.648093841642186,58.797653958944274,-10.067539046010978,0.4363,0.4811,0.431,0.4738,167569885.0,280945.0,87696112.0,8.59500343800137,58.53018372703412,0.5081578972211788,0.3658821027788212,0.035384713974744186,0.04005929989397031,-0.004674585919226121,0.05010000000000003,0.04974285714285715,4554701602.089998,0.020799999999999985,12.328117591275479,-20.381231671554286,79.61876832844573,61.73481520085378,0.44926666666666654,0.4541654289152024,0.4351857142857143,0.44199351421556227,0.43701999999999996,0.41421115647482465,592979.0,62049334.666666664,1165470.0,53956717.14285714
2023-02-26,0.4262,0.437,0.4164,0.4337,49154909.0,84407.0,24263826.0,0.4445333333333332,0.43711428571428573,0.43587499999999996,0.43691635722880057,0.43694010174625375,0.417091672307056,55.27488855869242,0.5068999733692565,0.36485002663074334,0.029961120880327985,0.03678370659619368,-0.006822585715865692,0.020600000000000007,0.05185000000000001,4490753350.089998,0.020399999999999974,8.915118031140135,-49.78005865102644,50.21994134897356,58.16226783968719,1.7597372125762438,0.4738,0.4827,0.4035,0.4261,113103161.0,181840.0,53716228.0,-10.067539046010978,51.32336018411968,0.506866031765578,0.36480396823442196,0.03220956554991927,0.0384893530251601,-0.006279787475240828,0.07919999999999999,0.05298571428571429,4441598441.089998,-0.04730000000000001,2.2067642120412456,-55.351906158357814,44.648093841642186,58.797653958944274,0.44539999999999985,0.44013271445760116,0.43432857142857145,0.4380201356616717,0.435835,0.4153434272867461,613910.0,62807943.666666664,1285538.0,58736624.14285714
2023-02-27,0.4337,0.4507,0.4199,0.4344,61490914.0,109093.0,31307211.0,0.43139999999999984,0.43952857142857144,0.430575,0.43565817861440026,0.4363050763096903,0.41874008446828875,57.5346687211094,0.48182566880178107,0.3793243311982189,0.027913922112068945,0.035009749699368736,-0.007095827587299791,0.030799999999999994,0.05093571428571429,4552244264.089998,-0.008400000000000019,12.684824902723735,-54.36893203883496,45.63106796116504,46.83303438392696,0.16140189070787042,0.4262,0.437,0.4164,0.4337,49154909.0,84407.0,24263826.0,1.7597372125762438,55.27488855869242,0.5068999733692565,0.36485002663074334,0.029961120880327985,0.03678370659619368,-0.006822585715865692,0.020600000000000007,0.05185000000000001,4490753350.089998,0.020399999999999974,8.915118031140135,-49.78005865102644,50.21994134897356,58.16226783968719,0.4445333333333332,0.43691635722880057,0.43711428571428573,0.43694010174625375,0.43587499999999996,0.417091672307056,547192.0,55225388.666666664,1304269.0,59274868.28571428
2023-02-28,0.4346,0.4917,0.4321,0.4398,187269486.0,278767.0,89292810.0,0.43596666666666656,0.4402571428571429,0.42871,0.4377290893072001,0.4371788072322677,0.42074579070940415,47.484756097560975,0.47533833563627137,0.3820816643637286,0.026422653309449207,0.03329233042138483,-0.006869677111935625,0.05960000000000004,0.04912142857142859,4739513750.089998,0.00770000000000004,-2.9139072847682135,-62.74111675126903,37.25888324873096,44.369964186289884,1.1965025310630553,0.4337,0.4507,0.4199,0.4344,61490914.0,109093.0,31307211.0,0.16140189070787042,57.5346687211094,0.48182566880178107,0.3793243311982189,0.027913922112068945,0.035009749699368736,-0.007095827587299791,0.030799999999999994,0.05093571428571429,4552244264.089998,-0.008400000000000019,12.684824902723735,-54.36893203883496,45.63106796116504,46.83303438392696,0.43139999999999984,0.43565817861440026,0.43952857142857144,0.4363050763096903,0.430575,0.41874008446828875,375340.0,36429088.333333336,1338059.0,60611378.428571425
2023-03-01,0.4398,0.494,0.4389,0.4838,150818579.0,228416.0,78666217.0,0.45266666666666655,0.44684285714285715,0.43345,0.46076454465360006,0.44883410542420077,0.42675095349898473,51.81818181818182,0.48230236620890377,0.38459763379109624,0.02846313896768793,0.03232649213064545,-0.0038633531629575224,0.05509999999999998,0.048135714285714296,4890332329.089998,0.0696,2.1968736797634225,-18.07106598984775,81.92893401015226,54.93962840668278,10.004547521600724,0.4346,0.4917,0.4321,0.4398,187269486.0,278767.0,89292810.0,1.1965025310630553,47.484756097560975,0.47533833563627137,0.3820816643637286,0.026422653309449207,0.03329233042138483,-0.006869677111935625,0.05960000000000004,0.04912142857142859,4739513750.089998,0.00770000000000004,-2.9139072847682135,-62.74111675126903,37.25888324873096,44.369964186289884,0.43596666666666656,0.4377290893072001,0.4402571428571429,0.4371788072322677,0.42871,0.42074579070940415,472267.0,48287949.0,1247086.0,54961154.14285714
2023-03-02,0.4837,0.4876,0.4482,0.4683,92519152.0,141898.0,45532532.0,0.4639666666666666,0.4514142857142857,0.435775,0.46453227232680006,0.4537005790681506,0.43070800554670047,61.391880695940344,0.4866759719687824,0.3848740280312177,0.028500976574938275,0.03156138901950402,-0.003060412444565744,0.03939999999999999,0.045564285714285724,4797813177.089998,0.05080000000000001,13.307524800387128,-33.80710659898482,66.19289340101518,61.79357021996617,-3.1837916063675884,0.4398,0.494,0.4389,0.4838,150818579.0,228416.0,78666217.0,10.004547521600724,51.81818181818182,0.48230236620890377,0.38459763379109624,0.02846313896768793,0.03232649213064545,-0.0038633531629575224,0.05509999999999998,0.048135714285714296,4890332329.089998,0.0696,2.1968736797634225,-18.07106598984775,81.92893401015226,54.93962840668278,0.45266666666666655,0.46076454465360006,0.44684285714285715,0.44883410542420077,0.43345,0.42675095349898473,616276.0,66422079.333333336,1314593.0,58850556.428571425
2023-03-03,0.4684,0.47,0.4,0.44,115546761.0,170805.0,54490963.0,0.46403333333333324,0.4465857142857143,0.43693,0.45226613616340006,0.45027543430111294,0.4315929573993956,49.41715237302248,0.48707027060996444,0.38678972939003553,0.025948274112528313,0.03043876603810888,-0.004490491925580566,0.06999999999999995,0.047978571428571426,4682266416.089998,0.005300000000000027,-0.6323396567299078,-60.62992125984255,39.370078740157446,62.497302050441654,-6.063193851409048,0.4837,0.4876,0.4482,0.4683,92519152.0,141898.0,45532532.0,-3.1837916063675884,61.391880695940344,0.4866759719687824,0.3848740280312177,0.028500976574938275,0.03156138901950402,-0.003060412444565744,0.03939999999999999,0.045564285714285724,4797813177.089998,0.05080000000000001,13.307524800387128,-33.80710659898482,66.19289340101518,61.79357021996617,0.4639666666666666,0.46453227232680006,0.4514142857142857,0.4537005790681506,0.435775,0.43070800554670047,649081.0,71163853.0,1305366.0,58639276.571428575
2023-03-04,0.4402,0.451,0.4086,0.4298,81935638.0,125350.0,39830660.0,0.4460333333333332,0.4471142857142857,0.43850999999999996,0.44103306808170006,0.4451565757258347,0.43142219955183414,49.52023362536505,0.4853975878536657,0.3916224121463342,0.022838911509642734,0.028918795132415652,-0.006079883622772918,0.04239999999999999,0.04918571428571428,4600330778.089998,-0.007899999999999963,-0.532284193473731,-70.6692913385827,29.330708661417308,44.964560267530004,-2.3625624716038085,0.4684,0.47,0.4,0.44,115546761.0,170805.0,54490963.0,-6.063193851409048,49.41715237302248,0.48707027060996444,0.38678972939003553,0.025948274112528313,0.03043876603810888,-0.004490491925580566,0.06999999999999995,0.047978571428571426,4682266416.089998,0.005300000000000027,-0.6323396567299078,-60.62992125984255,39.370078740157446,62.497302050441654,0.46403333333333324,0.45226613616340006,0.4465857142857143,0.45027543430111294,0.43693,0.4315929573993956,541119.0,59563237.333333336,1195226.0,53895683.85714286
2023-03-05,0.4297,0.4449,0.4236,0.4317,59462344.0,99651.0,29668111.0,0.43383333333333324,0.44682857142857146,0.44082,0.43636653404085,0.44179243179437605,0.43144865673737376,53.911488600804645,0.4807468067184849,0.40089319328151507,0.02029409566396717,0.02719385523872596,-0.0068997595747587875,0.02130000000000004,0.048235714285714285,4659793122.089998,-0.0046000000000000485,4.225012071463041,-68.79921259842526,31.200787401574747,33.3005249343832,0.46544100535255906,0.4402,0.451,0.4086,0.4298,81935638.0,125350.0,39830660.0,-2.3625624716038085,49.52023362536505,0.4853975878536657,0.3916224121463342,0.022838911509642734,0.028918795132415652,-0.006079883622772918,0.04239999999999999,0.04918571428571428,4600330778.089998,-0.007899999999999963,-0.532284193473731,-70.6692913385827,29.330708661417308,44.964560267530004,0.4460333333333332,0.44103306808170006,0.4471142857142857,0.4451565757258347,0.43850999999999996,0.43142219955183414,438053.0,46618051.666666664,1138736.0,51912031.28571428
2023-03-06,0.4316,0.4316,0.4116,0.4198,46035201.0,78977.0,22872284.0,0.42709999999999987,0.44474285714285716,0.43915999999999994,0.428083267020425,0.43629432384578204,0.4303392608576239,50.49504950495051,0.4797103923012819,0.398609607698718,0.017119734580728907,0.025179031107126548,-0.008059296526397641,0.019999999999999962,0.047864285714285706,4613757921.089998,-0.05399999999999999,0.55089820359282,-80.51181102362207,19.48818897637793,26.673228346456693,-2.7340129749768254,0.4297,0.4449,0.4236,0.4317,59462344.0,99651.0,29668111.0,0.46544100535255906,53.911488600804645,0.4807468067184849,0.40089319328151507,0.02029409566396717,0.02719385523872596,-0.0068997595747587875,0.02130000000000004,0.048235714285714285,4659793122.089998,-0.0046000000000000485,4.225012071463041,-68.79921259842526,31.200787401574747,33.3005249343832,0.43383333333333324,0.43636653404085,0.44682857142857146,0.44179243179437605,0.44082,0.43144865673737376,395806.0,41329911.333333336,1153980.0,52684072.0
2023-03-07,0.42,0.4264,0.386,0.4004,66296331.0,115693.0,32192648.0,0.41729999999999984,0.4391142857142857,0.43551,0.4142416335102125,0.4273207428843365,0.42748790268070735,42.6865671641791,0.4762249216148528,0.3947950783851472,0.012890024506046704,0.02272122978691058,-0.009831205280863876,0.04039999999999999,0.043835714285714276,4547461590.089998,-0.0257,-7.890499194847022,-86.66666666666669,13.333333333333306,21.340769903762023,-4.666666666666668,0.4316,0.4316,0.4116,0.4198,46035201.0,78977.0,22872284.0,-2.7340129749768254,50.49504950495051,0.4797103923012819,0.398609607698718,0.017119734580728907,0.025179031107126548,-0.008059296526397641,0.019999999999999962,0.047864285714285706,4613757921.089998,-0.05399999999999999,0.55089820359282,-80.51181102362207,19.48818897637793,26.673228346456693,0.42709999999999987,0.428083267020425,0.44474285714285716,0.43629432384578204,0.43915999999999994,0.4303392608576239,303978.0,30790351.666666668,1123864.0,51479082.428571425
2023-03-08,0.4006,0.4056,0.3389,0.3477,71397545.0,121186.0,33782489.0,0.3892999999999999,0.4196714285714286,0.43223,0.38097081675510625,0.4074155571632524,0.41988905480635424,34.166080225193525,0.48819284857877526,0.37626715142122474,0.005225265621255304,0.019222036953779525,-0.013996771332524222,0.06670000000000004,0.045842857142857144,4476064045.089998,-0.08599999999999997,-20.56202878684029,-94.32624113475175,5.673758865248246,12.831760391653189,-13.205192211682476,0.42,0.4264,0.386,0.4004,66296331.0,115693.0,32192648.0,-4.666666666666668,42.6865671641791,0.4762249216148528,0.3947950783851472,0.012890024506046704,0.02272122978691058,-0.009831205280863876,0.04039999999999999,0.043835714285714276,4547461590.089998,-0.0257,-7.890499194847022,-86.66666666666669,13.333333333333306,21.340769903762023,0.41729999999999984,0.4142416335102125,0.4391142857142857,0.4273207428843365,0.43551,0.42748790268070735,294321.0,28244347.666666668,960790.0,43321916.428571425
2023-03-09,0.3476,0.3723,0.3131,0.3197,105962302.0,148316.0,52788463.0,0.3559333333333332,0.3984428571428572,0.426075,0.3503354083775531,0.38548666787243935,0.41034724006289197,31.24195624195623,0.5010063194303768,0.3511436805696232,-0.0030730527713448974,0.014763019008754642,-0.01783607178009954,0.05920000000000003,0.046771428571428575,4370101743.089998,-0.11470000000000002,-26.724730689892283,-96.35157545605307,3.648424543946929,7.551838914176188,-8.026467203682405,0.4006,0.4056,0.3389,0.3477,71397545.0,121186.0,33782489.0,-13.205192211682476,34.166080225193525,0.48819284857877526,0.37626715142122474,0.005225265621255304,0.019222036953779525,-0.013996771332524222,0.06670000000000004,0.045842857142857144,4476064045.089998,-0.08599999999999997,-20.56202878684029,-94.32624113475175,5.673758865248246,12.831760391653189,0.3892999999999999,0.38097081675510625,0.4196714285714286,0.4074155571632524,0.43223,0.41988905480635424,315856.0,29615807.0,853560.0,36909955.28571428
2023-03-10,0.3198,0.3414,0.2956,0.334,117911805.0,173714.0,60963113.0,0.3337999999999999,0.3832999999999999,0.42117000000000004,0.34216770418877657,0.37261500090432953,0.40307607434261655,25.695410292072324,0.5065547786262329,0.3357852213737672,-0.008398822990375254,0.010130650608928662,-0.018529473599303917,0.04580000000000001,0.04646428571428572,4488013548.089998,-0.1058,-29.50612072604474,-80.64516129032256,19.35483870967744,9.559007372957566,4.4402751719825035,0.3476,0.3723,0.3131,0.3197,105962302.0,148316.0,52788463.0,-8.026467203682405,31.24195624195623,0.5010063194303768,0.3511436805696232,-0.0030730527713448974,0.014763019008754642,-0.01783607178009954,0.05920000000000003,0.046771428571428575,4370101743.089998,-0.11470000000000002,-26.724730689892283,-96.35157545605307,3.648424543946929,7.551838914176188,0.3559333333333332,0.3503354083775531,0.3984428571428572,0.38548666787243935,0.426075,0.41034724006289197,385195.0,39587866.666666664,859978.0,37946516.85714286
2023-03-11,0.334,0.3411,0.3024,0.3154,66005000.0,115541.0,32890289.0,0.32303333333333323,0.36695714285714287,0.41622999999999993,0.3287838520943883,0.3583112506782471,0.3947259720242721,28.588007736943922,0.5138660610689038,0.3185939389310961,-0.013959482586591354,0.00531262396982466,-0.019272106556416015,0.03870000000000001,0.04357142857142858,4422008548.089998,-0.1684,-25.97981694437924,-90.02016129032256,9.979838709677438,10.994367321100631,-5.568862275449103,0.3198,0.3414,0.2956,0.334,117911805.0,173714.0,60963113.0,4.4402751719825035,25.695410292072324,0.5065547786262329,0.3357852213737672,-0.008398822990375254,0.010130650608928662,-0.018529473599303917,0.04580000000000001,0.04646428571428572,4488013548.089998,-0.1058,-29.50612072604474,-80.64516129032256,19.35483870967744,9.559007372957566,0.3337999999999999,0.34216770418877657,0.3832999999999999,0.37261500090432953,0.42117000000000004,0.40307607434261655,443216.0,49178021.666666664,862887.0,38871109.71428572
2023-03-12,0.3154,0.3871,0.3084,0.3799,80663003.0,133481.0,40068847.0,0.3430999999999999,0.3595571428571428,0.41434999999999994,0.35434192604719417,0.36370843800868535,0.39331397468862717,41.471147748890296,0.5133219471152686,0.3153780528847313,-0.013011743152440525,0.0016477505453716228,-0.014659493697812147,0.07869999999999999,0.047721428571428574,4502671551.089998,-0.08839999999999998,-12.404888171547146,-57.510080645161274,42.489919354838726,23.941532258064566,20.450221940393153,0.334,0.3411,0.3024,0.3154,66005000.0,115541.0,32890289.0,-5.568862275449103,28.588007736943922,0.5138660610689038,0.3185939389310961,-0.013959482586591354,0.00531262396982466,-0.019272106556416015,0.03870000000000001,0.04357142857142858,4422008548.089998,-0.1684,-25.97981694437924,-90.02016129032256,9.979838709677438,10.994367321100631,0.32303333333333323,0.3287838520943883,0.36695714285714287,0.3583112506782471,0.41622999999999993,0.3947259720242721,437571.0,48880621.666666664,853078.0,37879628.14285714
2023-03-13,0.3799,0.4025,0.3531,0.3886,135524820.0,214639.0,68120759.0,0.3612999999999999,0.3551,0.412045,0.37147096302359706,0.36993132850651406,0.3928650247182817,42.91898577612863,0.5111685799659254,0.3129214200340747,-0.01142691318947403,-0.000967182201597508,-0.010459730987876522,0.0494,0.049049999999999996,4638196371.089998,-0.0514,-10.543278084714547,-53.124999999999986,46.875000000000014,33.114919354838754,2.290076335877859,0.3154,0.3871,0.3084,0.3799,80663003.0,133481.0,40068847.0,20.450221940393153,41.471147748890296,0.5133219471152686,0.3153780528847313,-0.013011743152440525,0.0016477505453716228,-0.014659493697812147,0.07869999999999999,0.047721428571428574,4502671551.089998,-0.08839999999999998,-12.404888171547146,-57.510080645161274,42.489919354838726,23.941532258064566,0.3430999999999999,0.35434192604719417,0.3595571428571428,0.36370843800868535,0.41434999999999994,0.39331397468862717,422736.0,44640749.666666664,886908.0,39365447.571428575
2023-03-14,0.3887,0.4834,0.3741,0.4505,215203819.0,351034.0,110407688.0,0.40633333333333327,0.3622571428571429,0.412685,0.41098548151179853,0.39007349637988553,0.39835406998320727,51.40826533298236,0.5126675937482601,0.31270240625173995,-0.0051171243217427165,-0.0017971706256265498,-0.003319953696116167,0.10930000000000001,0.052599999999999994,4853400190.089998,0.020699999999999996,2.432924056389263,-21.92540322580644,78.07459677419357,55.8131720430108,15.89915101620788,0.3799,0.4025,0.3531,0.3886,135524820.0,214639.0,68120759.0,2.290076335877859,42.91898577612863,0.5111685799659254,0.3129214200340747,-0.01142691318947403,-0.000967182201597508,-0.010459730987876522,0.0494,0.049049999999999996,4638196371.089998,-0.0514,-10.543278084714547,-53.124999999999986,46.875000000000014,33.114919354838754,0.3612999999999999,0.37147096302359706,0.3551,0.36993132850651406,0.412045,0.3928650247182817,463661.0,47026631.666666664,1022570.0,45829515.428571425
2023-03-15,0.4505,0.4819,0.378,0.4095,209960065.0,361203.0,100223946.0,0.4161999999999999,0.3710857142857143,0.411345,0.4102427407558993,0.39493012228491414,0.39941558712766373,40.143274078004765,0.5107114451464912,0.3119785548535088,-0.0033858980086000634,-0.002114916102221253,-0.0012709819063788106,0.10389999999999999,0.056085714285714294,4643440125.089998,-0.022199999999999998,-15.357585779247628,-40.677083333333336,59.32291666666667,61.42417114695345,-9.100998890122094,0.3887,0.4834,0.3741,0.4505,215203819.0,351034.0,110407688.0,15.89915101620788,51.40826533298236,0.5126675937482601,0.31270240625173995,-0.0051171243217427165,-0.0017971706256265498,-0.003319953696116167,0.10930000000000001,0.052599999999999994,4853400190.089998,0.020699999999999996,2.432924056389263,-21.92540322580644,78.07459677419357,55.8131720430108,0.40633333333333327,0.41098548151179853,0.3622571428571429,0.39007349637988553,0.412685,0.39835406998320727,699154.0,72865764.66666667,1257911.0,57003092.571428575
2023-03-16,0.4095,0.4374,0.3959,0.4215,119134724.0,209954.0,58789441.0,0.42716666666666653,0.3856285714285714,0.40873,0.41587137037794963,0.4015725917136856,0.4015188645440767,43.733261917514724,0.5038374317755734,0.3136225682244266,-0.0010336734269800196,-0.0018986675671730062,0.0008649941401929866,0.04150000000000004,0.056235714285714285,4762574849.089998,0.0016999999999999793,-9.993593850096094,-32.960596379126734,67.03940362087327,68.14563902057786,2.9304029304029333,0.4505,0.4819,0.378,0.4095,209960065.0,361203.0,100223946.0,-9.100998890122094,40.143274078004765,0.5107114451464912,0.3119785548535088,-0.0033858980086000634,-0.002114916102221253,-0.0012709819063788106,0.10389999999999999,0.056085714285714294,4643440125.089998,-0.022199999999999998,-15.357585779247628,-40.677083333333336,59.32291666666667,61.42417114695345,0.4161999999999999,0.4102427407558993,0.3710857142857143,0.39493012228491414,0.411345,0.39941558712766373,926876.0,92917464.33333333,1497928.0,66494729.28571428
2023-03-17,0.4214,0.4513,0.41,0.4509,108992136.0,174968.0,54812833.0,0.42729999999999985,0.4023285714285714,0.40997000000000006,0.4333856851889748,0.4139044437852642,0.4062218298255932,51.45527369826436,0.5066644204562313,0.31327557954376883,0.003166316469468522,-0.0008856707598447006,0.004051987229313223,0.0413,0.05418571428571429,4871566985.089998,0.050500000000000045,2.477272727272739,-17.305644302449398,82.6943556975506,69.68555866169687,7.000474608448036,0.4095,0.4374,0.3959,0.4215,119134724.0,209954.0,58789441.0,2.9304029304029333,43.733261917514724,0.5038374317755734,0.3136225682244266,-0.0010336734269800196,-0.0018986675671730062,0.0008649941401929866,0.04150000000000004,0.056235714285714285,4762574849.089998,0.0016999999999999793,-9.993593850096094,-32.960596379126734,67.03940362087327,68.14563902057786,0.42716666666666653,0.41587137037794963,0.3856285714285714,0.4015725917136856,0.40873,0.4015188645440767,922191.0,89807025.0,1559566.0,67352011.85714285
2023-03-18,0.4511,0.4611,0.4115,0.417,98009133.0,169558.0,46916266.0,0.4297999999999999,0.4168428571428571,0.409135,0.4251928425944874,0.41467833283894817,0.4072483222231557,48.39276745354093,0.5052533103209028,0.3130166896790973,0.003716549961335913,3.477338439142211e-05,0.003681776576944491,0.04960000000000003,0.05470000000000002,4773557852.089998,0.06929999999999997,-2.9781293624941862,-35.35676251331204,64.64323748668797,71.4589989350373,-7.5592994901352295,0.4214,0.4513,0.41,0.4509,108992136.0,174968.0,54812833.0,7.000474608448036,51.45527369826436,0.5066644204562313,0.31327557954376883,0.003166316469468522,-0.0008856707598447006,0.004051987229313223,0.0413,0.05418571428571429,4871566985.089998,0.050500000000000045,2.477272727272739,-17.305644302449398,82.6943556975506,69.68555866169687,0.42729999999999985,0.4333856851889748,0.4023285714285714,0.4139044437852642,0.40997000000000006,0.4062218298255932,746125.0,71275406.66666667,1560820.0,66473400.428571425
2023-03-19,0.417,0.435,0.4117,0.4196,63295706.0,110809.0,30757046.0,0.42916666666666653,0.42251428571428573,0.40839499999999995,0.4223964212972437,0.4159087496292111,0.40842467248761705,48.48332915517674,0.503920372215135,0.31286962778486493,0.004312698139165516,0.000890358335346241,0.003422339803819275,0.023299999999999987,0.054842857142857145,4836853558.089998,0.09989999999999999,-2.802872365068332,-33.97231096911609,66.0276890308839,71.12176073837419,0.6235011990407653,0.4511,0.4611,0.4115,0.417,98009133.0,169558.0,46916266.0,-7.5592994901352295,48.39276745354093,0.5052533103209028,0.3130166896790973,0.003716549961335913,3.477338439142211e-05,0.003681776576944491,0.04960000000000003,0.05470000000000002,4773557852.089998,0.06929999999999997,-2.9781293624941862,-35.35676251331204,64.64323748668797,71.4589989350373,0.4297999999999999,0.4251928425944874,0.4168428571428571,0.41467833283894817,0.409135,0.4072483222231557,554480.0,53506180.0,1614837.0,68477111.42857143
2023-03-20,0.4196,0.4223,0.3834,0.3921,78233834.0,143136.0,39618114.0,0.40956666666666647,0.42301428571428573,0.40601000000000004,0.4072482106486218,0.40995656222190835,0.40686994177451064,46.65862484921593,0.5006113219001781,0.311408678099822,0.00253688604898461,0.001219663878073915,0.0013172221709106952,0.03889999999999999,0.05619285714285715,4758619724.089998,0.058099999999999985,-6.598380181038587,-48.61554845580404,51.38445154419596,60.68512602058931,-6.553860819828401,0.417,0.435,0.4117,0.4196,63295706.0,110809.0,30757046.0,0.6235011990407653,48.48332915517674,0.503920372215135,0.31286962778486493,0.004312698139165516,0.000890358335346241,0.003422339803819275,0.023299999999999987,0.054842857142857145,4836853558.089998,0.09989999999999999,-2.802872365068332,-33.97231096911609,66.0276890308839,71.12176073837419,0.42916666666666653,0.4223964212972437,0.42251428571428573,0.4159087496292111,0.40839499999999995,0.40842467248761705,455335.0,44162048.333333336,1592165.0,67146854.14285715
2023-03-21,0.392,0.4147,0.3787,0.3955,48974306.0,98699.0,24533372.0,0.40239999999999987,0.41515714285714284,0.40159500000000004,0.40137410532431095,0.40634242166643125,0.4057870901769382,49.385194479297375,0.4888683509696493,0.31432164903035076,0.0013878949692247566,0.0012533100963040833,0.00013458487292067334,0.03600000000000003,0.055878571428571444,4807594030.089998,0.0801,-1.2237762237762184,-46.80511182108624,53.19488817891376,56.869009584664575,0.8928571428571437,0.4196,0.4223,0.3834,0.3921,78233834.0,143136.0,39618114.0,-6.553860819828401,46.65862484921593,0.5006113219001781,0.311408678099822,0.00253688604898461,0.001219663878073915,0.0013172221709106952,0.03889999999999999,0.05619285714285715,4758619724.089998,0.058099999999999985,-6.598380181038587,-48.61554845580404,51.38445154419596,60.68512602058931,0.40956666666666647,0.4072482106486218,0.42301428571428573,0.40995656222190835,0.40601000000000004,0.40686994177451064,423503.0,39097142.0,1520662.0,63075047.71428572
2023-03-22,0.3956,0.4036,0.3599,0.3794,80688530.0,148040.0,40812077.0,0.38899999999999996,0.41085714285714287,0.39715,0.39038705266215545,0.3996068162498234,0.40327403396961076,54.37966289030119,0.47900600964979484,0.31529399035020517,-0.000812458668412952,0.0008401563433606762,-0.0016526150117736282,0.04370000000000002,0.05423571428571429,4726905500.089998,-0.0005000000000000004,9.117054932412994,-55.378061767838105,44.62193823216189,49.73375931842389,-4.0950455005055595,0.392,0.4147,0.3787,0.3955,48974306.0,98699.0,24533372.0,0.8928571428571437,49.385194479297375,0.4888683509696493,0.31432164903035076,0.0013878949692247566,0.0012533100963040833,0.00013458487292067334,0.03600000000000003,0.055878571428571444,4807594030.089998,0.0801,-1.2237762237762184,-46.80511182108624,53.19488817891376,56.869009584664575,0.40239999999999987,0.40137410532431095,0.41515714285714284,0.40634242166643125,0.40159500000000004,0.4057870901769382,352644.0,31636177.333333332,1268327.0,50807288.28571428
2023-03-23,0.3791,0.4063,0.3733,0.3867,53441147.0,90874.0,27494377.0,0.38719999999999993,0.4058857142857143,0.394485,0.3885435263310777,0.3963801121873676,0.4016955545439336,59.81828839390387,0.47390124585222443,0.3150687541477755,-0.0019447874880048066,0.00028316757708757957,-0.002227955065092386,0.032999999999999974,0.05236428571428572,4780346647.089998,-0.0019000000000000128,20.957147325617775,-51.490947816826406,48.50905218317359,48.775292864749765,2.0047480875758366,0.3956,0.4036,0.3599,0.3794,80688530.0,148040.0,40812077.0,-4.0950455005055595,54.37966289030119,0.47900600964979484,0.31529399035020517,-0.000812458668412952,0.0008401563433606762,-0.0016526150117736282,0.04370000000000002,0.05423571428571429,4726905500.089998,-0.0005000000000000004,9.117054932412994,-55.378061767838105,44.62193823216189,49.73375931842389,0.38899999999999996,0.39038705266215545,0.41085714285714287,0.3996068162498234,0.39715,0.40327403396961076,389875.0,34987854.333333336,1055164.0,42319878.428571425
2023-03-24,0.3867,0.3884,0.3587,0.3676,40818451.0,72110.0,19823146.0,0.3778999999999999,0.39398571428571433,0.391375,0.3780717631655388,0.38918508414052566,0.3984483588730828,54.85549132947976,0.4698340774996942,0.31291592250030575,-0.004333423600357267,-0.0006401506584013898,-0.003693272941955877,0.029700000000000004,0.05121428571428572,4739528196.089998,-0.08290000000000003,10.059880239520957,-63.9779005524862,36.0220994475138,43.051029954283116,-4.939229376777866,0.3791,0.4063,0.3733,0.3867,53441147.0,90874.0,27494377.0,2.0047480875758366,59.81828839390387,0.47390124585222443,0.3150687541477755,-0.0019447874880048066,0.00028316757708757957,-0.002227955065092386,0.032999999999999974,0.05236428571428572,4780346647.089998,-0.0019000000000000128,20.957147325617775,-51.490947816826406,48.50905218317359,48.775292864749765,0.38719999999999993,0.3885435263310777,0.4058857142857143,0.3963801121873676,0.394485,0.4016955545439336,337613.0,30946608.666666668,936084.0,37849155.0
2023-03-25,0.3677,0.3776,0.356,0.3638,25459602.0,48607.0,12253771.0,0.37269999999999986,0.3863857142857143,0.38798000000000005,0.3709358815827694,0.38283881310539425,0.3951485151708844,57.306763285024154,0.4649542704790841,0.311005729520916,-0.006458612308321732,-0.0018038429883854583,-0.004654769319936273,0.021600000000000008,0.04999285714285715,4714068594.089998,-0.04569999999999996,15.345592897907423,-68.34285714285714,31.657142857142862,38.729431495943444,-1.0606472667935856,0.3867,0.3884,0.3587,0.3676,40818451.0,72110.0,19823146.0,-4.939229376777866,54.85549132947976,0.4698340774996942,0.31291592250030575,-0.004333423600357267,-0.0006401506584013898,-0.003693272941955877,0.029700000000000004,0.05121428571428572,4739528196.089998,-0.08290000000000003,10.059880239520957,-63.9779005524862,36.0220994475138,43.051029954283116,0.3778999999999999,0.3780717631655388,0.39398571428571433,0.38918508414052566,0.391375,0.3984483588730828,311024.0,29376533.333333332,833226.0,32850628.285714287
2023-03-26,0.3638,0.3784,0.3606,0.3724,24558557.0,45376.0,11975882.0,0.3679333333333332,0.3796428571428571,0.38561,0.3716679407913847,0.38022910982904573,0.39298198991651445,48.6378496185979,0.4613683665693819,0.3098516334306181,-0.007364003890820092,-0.002915875168872385,-0.004448128721947707,0.017800000000000038,0.04564285714285715,4738627151.089998,-0.04909999999999998,-1.9742037378257415,-85.1880276285495,14.81197237145049,27.497071558702416,2.3639362286970855,0.3677,0.3776,0.356,0.3638,25459602.0,48607.0,12253771.0,-1.0606472667935856,57.306763285024154,0.4649542704790841,0.311005729520916,-0.006458612308321732,-0.0018038429883854583,-0.004654769319936273,0.021600000000000008,0.04999285714285715,4714068594.089998,-0.04569999999999996,15.345592897907423,-68.34285714285714,31.657142857142862,38.729431495943444,0.37269999999999986,0.3709358815827694,0.3863857142857143,0.38283881310539425,0.38798000000000005,0.3951485151708844,211591.0,19857098.0,712275.0,27898843.285714287
2023-03-27,0.3726,0.3742,0.3325,0.3459,40960874.0,67626.0,21092919.0,0.36069999999999985,0.3730428571428571,0.382885,0.3587839703956923,0.3716468323717843,0.38849799087684644,42.71579665643125,0.4603058533039609,0.30546414669603905,-0.01010339611197042,-0.004353379357491992,-0.005750016754478428,0.04169999999999996,0.04509285714285715,4697666277.089998,-0.10500000000000004,-10.988162635100363,-91.11994698475814,8.880053015241863,18.4497227479451,-7.165861513687602,0.3638,0.3784,0.3606,0.3724,24558557.0,45376.0,11975882.0,2.3639362286970855,48.6378496185979,0.4613683665693819,0.3098516334306181,-0.007364003890820092,-0.002915875168872385,-0.004448128721947707,0.017800000000000038,0.04564285714285715,4738627151.089998,-0.04909999999999998,-1.9742037378257415,-85.1880276285495,14.81197237145049,27.497071558702416,0.3679333333333332,0.3716679407913847,0.3796428571428571,0.38022910982904573,0.38561,0.39298198991651445,166093.0,14684266.333333334,646842.0,25215819.85714286
2023-03-28,0.3459,0.3591,0.3327,0.3563,47219888.0,72149.0,23841932.0,0.3581999999999999,0.3674428571428571,0.38331499999999996,0.3575419851978462,0.36781012427883825,0.385431515555242,30.504966887417226,0.4600051153309299,0.30662488466907,-0.011304875531823577,-0.0057436785923583086,-0.005561196939465269,0.02639999999999998,0.03917142857142857,4744886165.089998,-0.060699999999999976,-20.910099889012212,-84.06961178045516,15.930388219544842,13.207471202079093,3.0066493206128997,0.3726,0.3742,0.3325,0.3459,40960874.0,67626.0,21092919.0,-7.165861513687602,42.71579665643125,0.4603058533039609,0.30546414669603905,-0.01010339611197042,-0.004353379357491992,-0.005750016754478428,0.04169999999999996,0.04509285714285715,4697666277.089998,-0.10500000000000004,-10.988162635100363,-91.11994698475814,8.880053015241863,18.4497227479451,0.36069999999999985,0.3587839703956923,0.3730428571428571,0.3716468323717843,0.382885,0.38849799087684644,161609.0,15107524.0,571332.0,22569363.42857143
2023-03-29,0.3561,0.4042,0.3539,0.3849,95460456.0,154856.0,49069099.0,0.3623666666666665,0.36822857142857146,0.386575,0.3712209925989231,0.3720825932091287,0.38538089502617134,44.63350785340315,0.4571808257623027,0.3159691742376973,-0.009835893589750455,-0.006562121591836738,-0.003273771997913717,0.05030000000000001,0.03534285714285715,4840346621.089998,-0.03469999999999995,-6.007326007325997,-59.25349922239502,40.746500777604986,21.85231400413059,8.08761583824768,0.3459,0.3591,0.3327,0.3563,47219888.0,72149.0,23841932.0,3.0066493206128997,30.504966887417226,0.4600051153309299,0.30662488466907,-0.011304875531823577,-0.0057436785923583086,-0.005561196939465269,0.02639999999999998,0.03917142857142857,4744886165.089998,-0.060699999999999976,-20.910099889012212,-84.06961178045516,15.930388219544842,13.207471202079093,0.3581999999999999,0.3575419851978462,0.3674428571428571,0.36781012427883825,0.38331499999999996,0.385431515555242,185151.0,18970244.333333332,544782.0,22470586.285714287
2023-03-30,0.385,0.3902,0.3553,0.3652,49547502.0,83200.0,24648591.0,0.36879999999999996,0.36515714285714285,0.388135,0.36821049629946156,0.3703619449068465,0.38345890502367885,38.11734909244408,0.45513650116148485,0.32113349883851516,-0.010144401827844152,-0.007278577639038221,-0.0028658241888059304,0.03489999999999999,0.034871428571428574,4790799119.089998,-0.02689999999999998,-13.357058125741395,-74.57231726283048,25.427682737169526,27.368190578106482,-5.142857142857139,0.3561,0.4042,0.3539,0.3849,95460456.0,154856.0,49069099.0,8.08761583824768,44.63350785340315,0.4571808257623027,0.3159691742376973,-0.009835893589750455,-0.006562121591836738,-0.003273771997913717,0.05030000000000001,0.03534285714285715,4840346621.089998,-0.03469999999999995,-6.007326007325997,-59.25349922239502,40.746500777604986,21.85231400413059,0.3623666666666665,0.3712209925989231,0.36822857142857146,0.3720825932091287,0.386575,0.38538089502617134,294631.0,31334650.0,551598.0,23650160.85714286
2023-03-31,0.3652,0.3707,0.3542,0.3664,34554932.0,53812.0,17387930.0,0.3721666666666666,0.3649857142857143,0.390685,0.36730524814973076,0.3693714586801349,0.3818342474023761,29.755630091039762,0.4494005238147447,0.3319694761852553,-0.010174778346831004,-0.007857817780596778,-0.002316960566234226,0.01649999999999996,0.0331,4825354051.089998,-0.029100000000000015,-18.74029718341096,-73.63919129082427,26.360808709175732,30.844997407983445,0.32858707557502154,0.385,0.3902,0.3553,0.3652,49547502.0,83200.0,24648591.0,-5.142857142857139,38.11734909244408,0.45513650116148485,0.32113349883851516,-0.010144401827844152,-0.007278577639038221,-0.0028658241888059304,0.03489999999999999,0.034871428571428574,4790799119.089998,-0.02689999999999998,-13.357058125741395,-74.57231726283048,25.427682737169526,27.368190578106482,0.36879999999999996,0.36821049629946156,0.36515714285714285,0.3703619449068465,0.388135,0.38345890502367885,310205.0,32519874.0,543924.0,23243620.0
2023-04-01,0.3664,0.3764,0.3586,0.3634,23399404.0,39911.0,11024141.0,0.36499999999999994,0.36492857142857144,0.38986,0.36535262407486535,0.36787859401010115,0.380078604792626,34.92688413948257,0.4496671074811422,0.3300528925188578,-0.010321941963167325,-0.008350642617110889,-0.0019712993460564363,0.017800000000000038,0.030828571428571427,4801954647.089998,-0.016000000000000014,-12.853717026378897,-69.85365853658537,30.146341463414622,27.311610969919986,-0.81877729257642,0.3652,0.3707,0.3542,0.3664,34554932.0,53812.0,17387930.0,0.32858707557502154,29.755630091039762,0.4494005238147447,0.3319694761852553,-0.010174778346831004,-0.007857817780596778,-0.002316960566234226,0.01649999999999996,0.0331,4825354051.089998,-0.029100000000000015,-18.74029718341096,-73.63919129082427,26.360808709175732,30.844997407983445,0.3721666666666666,0.36730524814973076,0.3649857142857143,0.3693714586801349,0.390685,0.3818342474023761,291868.0,30368540.0,525626.0,22895732.0
2023-04-02,0.3634,0.3641,0.3427,0.3491,21601827.0,39898.0,10210275.0,0.35963333333333325,0.36160000000000003,0.38788500000000004,0.3572263120374327,0.3631839455075758,0.37712826147904255,31.398416886543544,0.4504141603552659,0.3253558396447342,-0.01146035286527508,-0.008972584666743728,-0.0024877681985313524,0.021399999999999975,0.03069285714285714,4780352820.089998,-0.03759999999999997,-16.801715919923723,-81.51447661469933,18.485523385300674,24.99755785263037,-3.9350577875619095,0.3664,0.3764,0.3586,0.3634,23399404.0,39911.0,11024141.0,-0.81877729257642,34.92688413948257,0.4496671074811422,0.3300528925188578,-0.010321941963167325,-0.008350642617110889,-0.0019712993460564363,0.017800000000000038,0.030828571428571427,4801954647.089998,-0.016000000000000014,-12.853717026378897,-69.85365853658537,30.146341463414622,27.311610969919986,0.36499999999999994,0.36535262407486535,0.36492857142857144,0.36787859401010115,0.38986,0.380078604792626,176923.0,17686887.333333332,516930.0,22720070.57142857
2023-04-03,0.3494,0.3601,0.3366,0.3512,46136394.0,76022.0,23087625.0,0.35456666666666653,0.3623571428571428,0.38292,0.3542131560187164,0.36018795913068186,0.37465890324294326,37.53808653260207,0.4400516706343454,0.32578832936565455,-0.012054146559345058,-0.009588897045263995,-0.0024652495140810634,0.023499999999999965,0.02959285714285714,4826489214.089998,-0.01639999999999997,-10.43101249681203,-77.25060827250608,22.74939172749391,23.793752192069764,0.5151688609044144,0.3634,0.3641,0.3427,0.3491,21601827.0,39898.0,10210275.0,-3.9350577875619095,31.398416886543544,0.4504141603552659,0.3253558396447342,-0.01146035286527508,-0.008972584666743728,-0.0024877681985313524,0.021399999999999975,0.03069285714285714,4780352820.089998,-0.03759999999999997,-16.801715919923723,-81.51447661469933,18.485523385300674,24.99755785263037,0.35963333333333325,0.3572263120374327,0.36160000000000003,0.3631839455075758,0.38788500000000004,0.37712826147904255,133621.0,12874115.333333334,511452.0,22467841.0
2023-04-04,0.3512,0.3633,0.345,0.3607,44429707.0,67236.0,22739683.0,0.3536666666666666,0.3629857142857143,0.38048000000000004,0.3574565780093582,0.3603159693480114,0.37332948388647247,39.77673325499412,0.4369969597274988,0.3239630402725013,-0.011624165589635194,-0.009995950754138234,-0.0016282148354969592,0.01830000000000004,0.028328571428571425,4870918921.089998,-0.0030999999999999917,-8.798988621997472,-61.78861788617884,38.21138211382115,26.48209907553861,2.7050113895216423,0.3494,0.3601,0.3366,0.3512,46136394.0,76022.0,23087625.0,0.5151688609044144,37.53808653260207,0.4400516706343454,0.32578832936565455,-0.012054146559345058,-0.009588897045263995,-0.0024652495140810634,0.023499999999999965,0.02959285714285714,4826489214.089998,-0.01639999999999997,-10.43101249681203,-77.25060827250608,22.74939172749391,23.793752192069764,0.35456666666666653,0.3542131560187164,0.3623571428571428,0.36018795913068186,0.38292,0.37465890324294326,155831.0,14774013.666666666,519848.0,22752799.0
2023-04-05,0.361,0.3752,0.3519,0.3638,48884104.0,66581.0,23776945.0,0.35856666666666653,0.35997142857142855,0.377595,0.36062828900467914,0.36118697701100855,0.3724219139925227,45.038167938931295,0.4311062570547219,0.32408374294527814,-0.010907523341690095,-0.010178265271648607,-0.0007292580700414882,0.023299999999999987,0.026871428571428567,4919803025.089998,-0.008599999999999997,-4.1117554032683135,-57.58807588075881,42.4119241192412,34.45756598685212,0.7756232686980679,0.3512,0.3633,0.345,0.3607,44429707.0,67236.0,22739683.0,2.7050113895216423,39.77673325499412,0.4369969597274988,0.3239630402725013,-0.011624165589635194,-0.009995950754138234,-0.0016282148354969592,0.01830000000000004,0.028328571428571425,4870918921.089998,-0.0030999999999999917,-8.798988621997472,-61.78861788617884,38.21138211382115,26.48209907553861,0.3536666666666666,0.3574565780093582,0.3629857142857143,0.3603159693480114,0.38048000000000004,0.37332948388647247,183156.0,18679194.333333332,514935.0,22595334.85714286
2023-04-06,0.3639,0.3646,0.3484,0.3526,28482178.0,45368.0,13636498.0,0.35903333333333326,0.3581714285714286,0.37268,0.3566141445023396,0.3590402327582564,0.3705341126599015,39.41651148355061,0.4146559128924602,0.33070408710753985,-0.011115196528152571,-0.010365651522949399,-0.000749545005203172,0.016199999999999992,0.025671428571428567,4891320847.089998,0.006700000000000039,-8.818205327126961,-71.9665271966527,28.033472803347298,36.21892634546991,-3.1052486946963387,0.361,0.3752,0.3519,0.3638,48884104.0,66581.0,23776945.0,0.7756232686980679,45.038167938931295,0.4311062570547219,0.32408374294527814,-0.010907523341690095,-0.010178265271648607,-0.0007292580700414882,0.023299999999999987,0.026871428571428567,4919803025.089998,-0.008599999999999997,-4.1117554032683135,-57.58807588075881,42.4119241192412,34.45756598685212,0.35856666666666653,0.36062828900467914,0.35997142857142855,0.36118697701100855,0.377595,0.3724219139925227,209839.0,23201417.666666668,426660.0,18982170.0
2023-04-07,0.3526,0.3535,0.3416,0.3451,26754762.0,38101.0,12785375.0,0.3538333333333332,0.3551285714285714,0.369085,0.3508570722511698,0.3555551745686923,0.36811181621610134,42.47491638795988,0.40721857548073387,0.3309514245192661,-0.011749525132609961,-0.010642426244881513,-0.0011070988877284488,0.011899999999999966,0.024399999999999995,4864566085.089998,-0.011199999999999988,-6.120783460282908,-82.42677824267783,17.57322175732218,29.33953955997025,-2.127056154282475,0.3639,0.3646,0.3484,0.3526,28482178.0,45368.0,13636498.0,-3.1052486946963387,39.41651148355061,0.4146559128924602,0.33070408710753985,-0.011115196528152571,-0.010365651522949399,-0.000749545005203172,0.016199999999999992,0.025671428571428567,4891320847.089998,0.006700000000000039,-8.818205327126961,-71.9665271966527,28.033472803347298,36.21892634546991,0.35903333333333326,0.3566141445023396,0.3581714285714286,0.3590402327582564,0.37268,0.3705341126599015,179185.0,20051042.0,388828.0,17409013.85714286
2023-04-08,0.345,0.3482,0.3353,0.3391,21310828.0,32885.0,10476267.0,0.3455999999999999,0.3516571428571429,0.36506000000000005,0.34497853612558493,0.3514413809265192,0.36534878610028215,41.85893210283455,0.39727842558794313,0.332841574412057,-0.012591240989291985,-0.011032189193763607,-0.001559051795528378,0.012900000000000023,0.023778571428571423,4843255257.089998,-0.04580000000000001,-6.789444749862561,-90.79497907949792,9.205020920502086,18.270571827057214,-1.7101449275362206,0.3526,0.3535,0.3416,0.3451,26754762.0,38101.0,12785375.0,-2.127056154282475,42.47491638795988,0.40721857548073387,0.3309514245192661,-0.011749525132609961,-0.010642426244881513,-0.0011070988877284488,0.011899999999999966,0.024399999999999995,4864566085.089998,-0.011199999999999988,-6.120783460282908,-82.42677824267783,17.57322175732218,29.33953955997025,0.3538333333333332,0.3508570722511698,0.3551285714285714,0.3555551745686923,0.369085,0.36811181621610134,150050.0,16732939.333333334,373117.0,16751506.0
2023-04-09,0.3391,0.352,0.3254,0.3438,33744981.0,50277.0,15565490.0,0.3426666666666665,0.35090000000000005,0.362645,0.34438926806279246,0.3495310356948894,0.3632965207573981,40.32476319350473,0.3935431672084199,0.33174683279158007,-0.012732286278837157,-0.011372208610778319,-0.0013600776680588386,0.026599999999999957,0.024407142857142846,4877000238.089998,-0.02140000000000003,-7.679914070891513,-76.64974619289343,23.35025380710657,16.709498828310306,1.3860218224712422,0.345,0.3482,0.3353,0.3391,21310828.0,32885.0,10476267.0,-1.7101449275362206,41.85893210283455,0.39727842558794313,0.332841574412057,-0.012591240989291985,-0.011032189193763607,-0.001559051795528378,0.012900000000000023,0.023778571428571423,4843255257.089998,-0.04580000000000001,-6.789444749862561,-90.79497907949792,9.205020920502086,18.270571827057214,0.3455999999999999,0.34497853612558493,0.3516571428571429,0.3514413809265192,0.36506000000000005,0.36534878610028215,116354.0,12299380.0,366091.0,16673238.285714285
2023-04-10,0.3437,0.3576,0.3362,0.3554,51035182.0,139316.0,25640292.0,0.34609999999999985,0.35150000000000003,0.36064,0.3498946340313962,0.350998276771167,0.3625444711614554,53.57411587659895,0.38750201779459886,0.33377798220540117,-0.011772338442682106,-0.011452234577159076,-0.0003201038655230304,0.021399999999999975,0.022957142857142846,4928035420.089998,-0.01100000000000001,2.7464585140213993,-61.92893401015232,38.07106598984768,23.542113572485476,3.40413151003782,0.3391,0.352,0.3254,0.3438,33744981.0,50277.0,15565490.0,1.3860218224712422,40.32476319350473,0.3935431672084199,0.33174683279158007,-0.012732286278837157,-0.011372208610778319,-0.0013600776680588386,0.026599999999999957,0.024407142857142846,4877000238.089998,-0.02140000000000003,-7.679914070891513,-76.64974619289343,23.35025380710657,16.709498828310306,0.3426666666666665,0.34438926806279246,0.35090000000000005,0.3495310356948894,0.362645,0.3632965207573981,121263.0,12942377.333333334,376470.0,17438269.0
2023-04-11,0.3554,0.3644,0.3505,0.3521,58857473.0,126947.0,28996475.0,0.3504333333333332,0.3502714285714286,0.359275,0.35099731701569814,0.3512737075783753,0.3615497596222692,48.33068362480128,0.38486766959188573,0.3336823304081143,-0.011149332719851968,-0.011391654205697654,0.0002423214858456868,0.013900000000000023,0.022064285714285706,4869177947.089998,-0.011299999999999977,-1.178781925343808,-66.11675126903552,33.883248730964475,31.768189509306268,-0.9285312324141726,0.3437,0.3576,0.3362,0.3554,51035182.0,139316.0,25640292.0,3.40413151003782,53.57411587659895,0.38750201779459886,0.33377798220540117,-0.011772338442682106,-0.011452234577159076,-0.0003201038655230304,0.021399999999999975,0.022957142857142846,4928035420.089998,-0.01100000000000001,2.7464585140213993,-61.92893401015232,38.07106598984768,23.542113572485476,0.34609999999999985,0.3498946340313962,0.35150000000000003,0.350998276771167,0.36064,0.3625444711614554,222478.0,17227349.666666668,439764.0,17802935.714285713
2023-04-12,0.3521,0.3539,0.3317,0.3417,55487850.0,133632.0,27541256.0,0.34973333333333323,0.34711428571428565,0.35702500000000004,0.34634865850784907,0.3488802806837814,0.3596593063249102,29.925650557620784,0.3802704975832318,0.3337795024167683,-0.011363794529944071,-0.01138608227054694,2.228774060286827e-05,0.022199999999999998,0.02005714285714285,4813690097.089998,-0.007400000000000018,-11.223694466095091,-74.8456790123457,25.154320987654305,32.36954523615552,-2.9537063334280087,0.3554,0.3644,0.3505,0.3521,58857473.0,126947.0,28996475.0,-0.9285312324141726,48.33068362480128,0.38486766959188573,0.3336823304081143,-0.011149332719851968,-0.011391654205697654,0.0002423214858456868,0.013900000000000023,0.022064285714285706,4869177947.089998,-0.011299999999999977,-1.178781925343808,-66.11675126903552,33.883248730964475,31.768189509306268,0.3504333333333332,0.35099731701569814,0.3502714285714286,0.3512737075783753,0.359275,0.3615497596222692,316540.0,23400752.333333332,499475.0,18696763.14285714
2023-04-13,0.3417,0.3646,0.3377,0.3611,65908690.0,147636.0,33536824.0,0.35163333333333324,0.34832857142857143,0.3567,0.3537243292539245,0.35193521051283605,0.35979651524634737,48.089468779123926,0.37950046167578344,0.3338995383242166,-0.00985473988508806,-0.011079813793455164,0.001225073908367104,0.02689999999999998,0.019485714285714276,4879598787.089998,0.009899999999999964,-1.1226725082146949,-30.000000000000078,69.99999999999993,43.0125232395396,5.677494878548426,0.3521,0.3539,0.3317,0.3417,55487850.0,133632.0,27541256.0,-2.9537063334280087,29.925650557620784,0.3802704975832318,0.3337795024167683,-0.011363794529944071,-0.01138608227054694,2.228774060286827e-05,0.022199999999999998,0.02005714285714285,4813690097.089998,-0.007400000000000018,-11.223694466095091,-74.8456790123457,25.154320987654305,32.36954523615552,0.34973333333333323,0.34634865850784907,0.34711428571428565,0.3488802806837814,0.35702500000000004,0.3596593063249102,399895.0,27392674.333333332,566526.0,19234521.85714286
2023-04-14,0.3611,0.4148,0.3603,0.405,193057890.0,348508.0,95367110.0,0.3692666666666666,0.3568857142857143,0.35876,0.37936216462696226,0.365201407884627,0.36410160903240957,62.866666666666674,0.3901051011869219,0.32741489881307817,-0.0050581330848722406,-0.00987547765173858,0.00481734456686634,0.05449999999999999,0.022199999999999994,5072656677.089998,0.044300000000000006,10.534934497816595,-10.961968680089461,89.03803131991054,61.39745076918829,12.157297147604556,0.3417,0.3646,0.3377,0.3611,65908690.0,147636.0,33536824.0,5.677494878548426,48.089468779123926,0.37950046167578344,0.3338995383242166,-0.00985473988508806,-0.011079813793455164,0.001225073908367104,0.02689999999999998,0.019485714285714276,4879598787.089998,0.009899999999999964,-1.1226725082146949,-30.000000000000078,69.99999999999993,43.0125232395396,0.35163333333333324,0.3537243292539245,0.34832857142857143,0.35193521051283605,0.3567,0.35979651524634737,408215.0,30024851.666666668,668794.0,22077425.57142857
2023-04-15,0.405,0.4259,0.3912,0.4072,133914759.0,271408.0,66315982.0,0.39109999999999995,0.3666142857142857,0.3605,0.39328108231348113,0.37570105591347025,0.3682062176959896,64.67828418230563,0.3982436784528911,0.32275632154710887,-0.001066966696271543,-0.008113775460645173,0.00704680876437363,0.03470000000000001,0.02340714285714285,5206571436.089998,0.043399999999999994,12.052834342322516,-18.606965174129353,81.39303482587064,80.1436887152604,0.5432098765432049,0.3611,0.4148,0.3603,0.405,193057890.0,348508.0,95367110.0,12.157297147604556,62.866666666666674,0.3901051011869219,0.32741489881307817,-0.0050581330848722406,-0.00987547765173858,0.00481734456686634,0.05449999999999999,0.022199999999999994,5072656677.089998,0.044300000000000006,10.534934497816595,-10.961968680089461,89.03803131991054,61.39745076918829,0.3692666666666666,0.37936216462696226,0.3568857142857143,0.365201407884627,0.35876,0.36410160903240957,629776.0,52148396.666666664,979201.0,33874816.28571428
2023-04-16,0.4072,0.4124,0.3947,0.4053,73533756.0,200826.0,34871464.0,0.40583333333333327,0.3754,0.36347,0.39929054115674056,0.3831007919351027,0.37173895886780006,70.54093567251462,0.4054831357904257,0.3214568642095743,0.001920607730082513,-0.0061068988224996365,0.00802750655258215,0.017699999999999994,0.023142857142857135,5133037680.089998,0.05269999999999997,16.09853910054424,-20.497512437810958,79.50248756218905,83.31118456932343,-0.46660117878192847,0.405,0.4259,0.3912,0.4072,133914759.0,271408.0,66315982.0,0.5432098765432049,64.67828418230563,0.3982436784528911,0.32275632154710887,-0.001066966696271543,-0.008113775460645173,0.00704680876437363,0.03470000000000001,0.02340714285714285,5206571436.089998,0.043399999999999994,12.052834342322516,-18.606965174129353,81.39303482587064,80.1436887152604,0.39109999999999995,0.39328108231348113,0.3666142857142857,0.37570105591347025,0.3605,0.3682062176959896,767552.0,65073305.333333336,1217724.0,41851918.428571425
2023-04-17,0.4052,0.448,0.3915,0.4262,156038088.0,204844.0,78777984.0,0.4128999999999999,0.38551428571428575,0.36696500000000004,0.4127452705783703,0.3938755939513271,0.3769257246899143,74.10025706940874,0.41727683914241426,0.3166531608575858,0.005906649144119647,-0.00370418922917578,0.009610838373295426,0.056499999999999995,0.025499999999999995,5289075768.089998,0.0811,21.355353075170846,-17.781402936378456,82.21859706362154,81.0380398172271,5.182625863770982,0.4072,0.4124,0.3947,0.4053,73533756.0,200826.0,34871464.0,-0.46660117878192847,70.54093567251462,0.4054831357904257,0.3214568642095743,0.001920607730082513,-0.0061068988224996365,0.00802750655258215,0.017699999999999994,0.023142857142857135,5133037680.089998,0.05269999999999997,16.09853910054424,-20.497512437810958,79.50248756218905,83.31118456932343,0.40583333333333327,0.39929054115674056,0.3754,0.3831007919351027,0.36347,0.37173895886780006,820742.0,65518185.333333336,1368273.0,44609914.71428572
2023-04-18,0.4262,0.4446,0.4108,0.4245,92941512.0,131226.0,46677523.0,0.4186666666666666,0.39585714285714285,0.368945,0.41862263528918514,0.4015316954634953,0.3814566080527796,71.58322056833558,0.4250159879011239,0.31287401209887616,0.008826691287378119,-0.0011980131258650004,0.01002470441324312,0.0338,0.02660714285714285,5196134256.089998,0.08539999999999998,17.687829220959237,-19.168026101141944,80.83197389885805,80.8510195082229,-0.39887376818395937,0.4052,0.448,0.3915,0.4262,156038088.0,204844.0,78777984.0,5.182625863770982,74.10025706940874,0.41727683914241426,0.3166531608575858,0.005906649144119647,-0.00370418922917578,0.009610838373295426,0.056499999999999995,0.025499999999999995,5289075768.089998,0.0811,21.355353075170846,-17.781402936378456,82.21859706362154,81.0380398172271,0.4128999999999999,0.4127452705783703,0.38551428571428575,0.3938755939513271,0.36696500000000004,0.3769257246899143,677078.0,59988476.666666664,1433801.0,52201013.571428575
2023-04-19,0.4246,0.4281,0.3645,0.373,96969302.0,147889.0,44061493.0,0.40789999999999993,0.4003285714285715,0.36933499999999997,0.39581131764459254,0.3943987715976215,0.3806512168096577,52.344546381243624,0.42540481644153055,0.3132651835584694,0.006905622410587731,0.0004227139814255459,0.006482908429162185,0.06359999999999999,0.02948571428571428,5099164954.089998,0.029200000000000004,2.528862012094546,-61.17455138662318,38.825448613376814,67.2920065252855,-12.152614225153082,0.4262,0.4446,0.4108,0.4245,92941512.0,131226.0,46677523.0,-0.39887376818395937,71.58322056833558,0.4250159879011239,0.31287401209887616,0.008826691287378119,-0.0011980131258650004,0.01002470441324312,0.0338,0.02660714285714285,5196134256.089998,0.08539999999999998,17.687829220959237,-19.168026101141944,80.83197389885805,80.8510195082229,0.4186666666666666,0.41862263528918514,0.39585714285714285,0.4015316954634953,0.368945,0.3814566080527796,536896.0,53442323.666666664,1438080.0,54726877.571428575
2023-04-20,0.373,0.3813,0.351,0.3641,76782915.0,109235.0,36952300.0,0.3871999999999998,0.4007571428571429,0.36922,0.37995565882229626,0.3868240786982161,0.37907491044683317,52.965446106240314,0.42532458654670224,0.31311541345329774,0.004611843405574356,0.0012605398662553081,0.003351303539319048,0.030299999999999994,0.030492857142857134,5022382039.089998,0.008699999999999986,3.2614861032331133,-68.43393148450248,31.56606851549752,50.40783034257749,-2.386058981233249,0.4246,0.4281,0.3645,0.373,96969302.0,147889.0,44061493.0,-12.152614225153082,52.344546381243624,0.42540481644153055,0.3132651835584694,0.006905622410587731,0.0004227139814255459,0.006482908429162185,0.06359999999999999,0.02948571428571428,5099164954.089998,0.029200000000000004,2.528862012094546,-61.17455138662318,38.825448613376814,67.2920065252855,0.40789999999999993,0.39581131764459254,0.4003285714285715,0.3943987715976215,0.36933499999999997,0.3806512168096577,483959.0,56505666.666666664,1452337.0,57086911.428571425
2023-04-21,0.3639,0.3671,0.329,0.3333,67026978.0,97876.0,32651723.0,0.35679999999999995,0.3905142857142857,0.36771499999999996,0.3566278294111481,0.37344305902366204,0.37471539516618235,47.283609576427246,0.42604755929308813,0.3093824407069118,0.00030518642551452535,0.0010694691781071516,-0.0007642827525926263,0.03809999999999997,0.03236428571428571,4955355061.089998,-0.01880000000000004,-3.4192987539843567,-93.55628058727572,6.443719412724278,25.611745513866236,-8.40890354492993,0.373,0.3813,0.351,0.3641,76782915.0,109235.0,36952300.0,-2.386058981233249,52.965446106240314,0.42532458654670224,0.31311541345329774,0.004611843405574356,0.0012605398662553081,0.003351303539319048,0.030299999999999994,0.030492857142857134,5022382039.089998,0.008699999999999986,3.2614861032331133,-68.43393148450248,31.56606851549752,50.40783034257749,0.3871999999999998,0.37995565882229626,0.4007571428571429,0.3868240786982161,0.36922,0.37907491044683317,388350.0,42563772.0,1413936.0,57574836.571428575
2023-04-22,0.3333,0.3483,0.3292,0.3481,28417291.0,44393.0,14011282.0,0.34849999999999987,0.38207142857142856,0.367665,0.35236391470557404,0.3671072942677466,0.37218059562654593,51.99115044247788,0.42606641580833887,0.30926358419166117,-0.001891826153455567,0.0004772101117946079,-0.002369036265250175,0.019100000000000006,0.03280714285714285,4983772352.089998,0.006400000000000017,2.654084340902396,-81.48450244698205,18.515497553017944,18.841761827079942,4.440444044404451,0.3639,0.3671,0.329,0.3333,67026978.0,97876.0,32651723.0,-8.40890354492993,47.283609576427246,0.42604755929308813,0.3093824407069118,0.00030518642551452535,0.0010694691781071516,-0.0007642827525926263,0.03809999999999997,0.03236428571428571,4955355061.089998,-0.01880000000000004,-3.4192987539843567,-93.55628058727572,6.443719412724278,25.611745513866236,0.35679999999999995,0.3566278294111481,0.3905142857142857,0.37344305902366204,0.36771499999999996,0.37471539516618235,355000.0,37888505.333333336,1163304.0,48615495.571428575
2023-04-23,0.348,0.3481,0.3238,0.3354,35267293.0,53368.0,16673808.0,0.33893333333333314,0.3720857142857143,0.366875,0.34388195735278704,0.35918047070080994,0.3686776817573511,48.205128205128204,0.4266260581275834,0.3071239418724166,-0.0046046784457716705,-0.0005391675997186479,-0.004065510846053022,0.024300000000000044,0.03264285714285714,4948505059.089998,-0.0257,-2.443280977312401,-90.66022544283415,9.339774557165859,11.432997174302722,-3.620689655172414,0.3333,0.3483,0.3292,0.3481,28417291.0,44393.0,14011282.0,4.440444044404451,51.99115044247788,0.42606641580833887,0.30926358419166117,-0.001891826153455567,0.0004772101117946079,-0.002369036265250175,0.019100000000000006,0.03280714285714285,4983772352.089998,0.006400000000000017,2.654084340902396,-81.48450244698205,18.515497553017944,18.841761827079942,0.34849999999999987,0.35236391470557404,0.38207142857142856,0.3671072942677466,0.367665,0.37218059562654593,251504.0,27871768.333333332,936289.0,41143395.571428575
2023-04-24,0.3354,0.345,0.3247,0.3319,34615425.0,63875.0,18060020.0,0.3384666666666665,0.3586142857142857,0.365435,0.3378909786763935,0.3523603530256074,0.3651750453995081,44.79858344400177,0.4271679486365736,0.30370205136342643,-0.00695685983210742,-0.0018227060461964025,-0.0051341537859110175,0.020299999999999985,0.03256428571428571,4913889634.089998,-0.07310000000000005,-6.6122678671919015,-93.47826086956522,6.521739130434778,11.459003746872888,-1.0435301132975563,0.348,0.3481,0.3238,0.3354,35267293.0,53368.0,16673808.0,-3.620689655172414,48.205128205128204,0.4266260581275834,0.3071239418724166,-0.0046046784457716705,-0.0005391675997186479,-0.004065510846053022,0.024300000000000044,0.03264285714285714,4948505059.089998,-0.0257,-2.443280977312401,-90.66022544283415,9.339774557165859,11.432997174302722,0.33893333333333314,0.34388195735278704,0.3720857142857143,0.35918047070080994,0.366875,0.3686776817573511,195637.0,21112271.0,788831.0,38543730.428571425
2023-04-25,0.3319,0.3478,0.3186,0.3448,41611509.0,69522.0,21255360.0,0.33736666666666654,0.34722857142857144,0.364485,0.34134548933819675,0.35047026476920556,0.36323456488526923,48.45010615711252,0.4269048441792818,0.3020651558207182,-0.007691396703656983,-0.002996444177688519,-0.004694952525968464,0.029200000000000004,0.03365714285714285,4955501143.089998,-0.06240000000000001,-2.073274637886968,-79.75270479134467,20.24729520865533,12.03626963208535,3.886712865320887,0.3354,0.345,0.3247,0.3319,34615425.0,63875.0,18060020.0,-1.0435301132975563,44.79858344400177,0.4271679486365736,0.30370205136342643,-0.00695685983210742,-0.0018227060461964025,-0.0051341537859110175,0.020299999999999985,0.03256428571428571,4913889634.089998,-0.07310000000000005,-6.6122678671919015,-93.47826086956522,6.521739130434778,11.459003746872888,0.3384666666666665,0.3378909786763935,0.3586142857142857,0.3523603530256074,0.365435,0.3651750453995081,161636.0,16248370.0,647862.0,29869735.57142857
2023-04-26,0.3448,0.3632,0.311,0.3341,88956605.0,125674.0,45857491.0,0.33693333333333325,0.3416714285714285,0.36356,0.33772274466909835,0.3463776985769042,0.3604598444200055,48.38846480067854,0.427256662723432,0.299863337276568,-0.009032798563661237,-0.004203715054883063,-0.004829083508778175,0.052200000000000024,0.0358,4866544538.089998,-0.07119999999999999,-2.2241732513901047,-83.13868613138685,16.861313868613145,14.543449402567779,-3.103248259860785,0.3319,0.3478,0.3186,0.3448,41611509.0,69522.0,21255360.0,3.886712865320887,48.45010615711252,0.4269048441792818,0.3020651558207182,-0.007691396703656983,-0.002996444177688519,-0.004694952525968464,0.029200000000000004,0.03365714285714285,4955501143.089998,-0.06240000000000001,-2.073274637886968,-79.75270479134467,20.24729520865533,12.03626963208535,0.33736666666666654,0.34134548933819675,0.34722857142857144,0.35047026476920556,0.364485,0.36323456488526923,186765.0,18663062.666666668,586158.0,26237998.0
2023-04-27,0.3342,0.348,0.3294,0.344,55472544.0,85236.0,27971917.0,0.3409666666666666,0.3388,0.363505,0.34086137233454916,0.34578327393267816,0.3588922401895288,46.22182942996023,0.42727063915495156,0.2997393608450485,-0.009191072971771075,-0.005201186638260665,-0.00398988633351041,0.01859999999999995,0.035207142857142854,4922017082.089998,-0.08220000000000005,-4.735530324009973,-75.9124087591241,24.08759124087589,20.398733439381484,2.932375822860555,0.3448,0.3632,0.311,0.3341,88956605.0,125674.0,45857491.0,-3.103248259860785,48.38846480067854,0.427256662723432,0.299863337276568,-0.009032798563661237,-0.004203715054883063,-0.004829083508778175,0.052200000000000024,0.0358,4866544538.089998,-0.07119999999999999,-2.2241732513901047,-83.13868613138685,16.861313868613145,14.543449402567779,0.33693333333333325,0.33772274466909835,0.3416714285714285,0.3463776985769042,0.36356,0.3604598444200055,259071.0,28390957.0,563943.0,26494569.14285714
2023-04-28,0.3439,0.3474,0.3301,0.3329,33445792.0,49939.0,14966710.0,0.3369999999999999,0.3387428571428571,0.363195,0.33688068616727457,0.3425624554495086,0.356416788742907,31.36950904392765,0.4275180489916043,0.2988719510083957,-0.010095805650811251,-0.006180110440770782,-0.00391569521004047,0.017299999999999982,0.032549999999999996,4888571290.089998,-0.09160000000000001,-17.80246913580248,-84.014598540146,15.985401459853996,18.97810218978104,-3.1986042454201833,0.3342,0.348,0.3294,0.344,55472544.0,85236.0,27971917.0,2.932375822860555,46.22182942996023,0.42727063915495156,0.2997393608450485,-0.009191072971771075,-0.005201186638260665,-0.00398988633351041,0.01859999999999995,0.035207142857142854,4922017082.089998,-0.08220000000000005,-4.735530324009973,-75.9124087591241,24.08759124087589,20.398733439381484,0.3409666666666666,0.34086137233454916,0.3388,0.34578327393267816,0.363505,0.3588922401895288,280432.0,31694922.666666668,539944.0,25211657.285714287
2023-04-29,0.3329,0.3478,0.3315,0.341,27918552.0,37335.0,13287685.0,0.3392999999999999,0.3377285714285714,0.363055,0.3389403430836373,0.34217184158713143,0.35494852314834446,33.40020060180544,0.4275676988722907,0.29854230112770935,-0.010043436032955988,-0.006952775559207824,-0.0030906604737481642,0.01629999999999998,0.03123571428571428,4916489842.089998,-0.03199999999999997,-16.257367387033394,-78.10218978102188,21.89781021897812,20.656934306569365,2.4331631120456754,0.3439,0.3474,0.3301,0.3329,33445792.0,49939.0,14966710.0,-3.1986042454201833,31.36950904392765,0.4275180489916043,0.2988719510083957,-0.010095805650811251,-0.006180110440770782,-0.00391569521004047,0.017299999999999982,0.032549999999999996,4888571290.089998,-0.09160000000000001,-17.80246913580248,-84.014598540146,15.985401459853996,18.97810218978104,0.3369999999999999,0.33688068616727457,0.3387428571428571,0.3425624554495086,0.363195,0.356416788742907,260849.0,29598706.0,492007.0,22685226.85714286
2023-04-30,0.341,0.3411,0.3264,0.3272,28744009.0,41791.0,12508836.0,0.3336999999999999,0.33655714285714283,0.361645,0.3330701715418186,0.33842888119034853,0.35230580665802597,31.519167061050652,0.42806660317561157,0.2952233968243884,-0.01098880529494456,-0.0077599815063551705,-0.0032288237885893887,0.01469999999999999,0.031021428571428564,4887745833.089998,-0.03689999999999999,-19.269676782630153,-88.17518248175183,11.824817518248167,16.569343065693456,-4.046920821114379,0.3329,0.3478,0.3315,0.341,27918552.0,37335.0,13287685.0,2.4331631120456754,33.40020060180544,0.4275676988722907,0.29854230112770935,-0.010043436032955988,-0.006952775559207824,-0.0030906604737481642,0.01629999999999998,0.03123571428571428,4916489842.089998,-0.03199999999999997,-16.257367387033394,-78.10218978102188,21.89781021897812,20.656934306569365,0.3392999999999999,0.3389403430836373,0.3377285714285714,0.34217184158713143,0.363055,0.35494852314834446,172510.0,18742104.0,484949.0,22581855.85714286
2023-05-01,0.3274,0.3304,0.3134,0.3184,35841025.0,50049.0,16080894.0,0.3288666666666666,0.33462857142857144,0.35995999999999995,0.3257350857709093,0.3334216608927614,0.34907668221440447,22.94176706827311,0.42905707587687175,0.29086292412312814,-0.012306244969779556,-0.008669234199040048,-0.0036370107707395082,0.017000000000000015,0.028199999999999996,4851904808.089998,-0.014899999999999969,-25.293289535429373,-94.46107784431136,5.538922155688636,13.087183297638338,-2.7489309712889454,0.341,0.3411,0.3264,0.3272,28744009.0,41791.0,12508836.0,-4.046920821114379,31.519167061050652,0.42806660317561157,0.2952233968243884,-0.01098880529494456,-0.0077599815063551705,-0.0032288237885893887,0.01469999999999999,0.031021428571428564,4887745833.089998,-0.03689999999999999,-19.269676782630153,-88.17518248175183,11.824817518248167,16.569343065693456,0.3336999999999999,0.3330701715418186,0.33655714285714283,0.33842888119034853,0.361645,0.35230580665802597,129065.0,13587743.666666666,473372.0,21986859.85714286
2023-05-02,0.3183,0.3212,0.3112,0.3187,23953321.0,37161.0,12216685.0,0.32143333333333324,0.3309,0.35880999999999996,0.3222175428854547,0.329741245669571,0.34618366486065166,23.255813953488385,0.42992286507337957,0.28769713492662036,-0.01317425331935368,-0.009570238023102775,-0.0036040152962509044,0.010000000000000009,0.026499999999999996,4875858129.089998,-0.029400000000000037,-24.923439340400478,-93.42442356959864,6.575576430401354,7.9797720347794145,0.1256676091737216,0.3274,0.3304,0.3134,0.3184,35841025.0,50049.0,16080894.0,-2.7489309712889454,22.94176706827311,0.42905707587687175,0.29086292412312814,-0.012306244969779556,-0.008669234199040048,-0.0036370107707395082,0.017000000000000015,0.028199999999999996,4851904808.089998,-0.014899999999999969,-25.293289535429373,-94.46107784431136,5.538922155688636,13.087183297638338,0.3288666666666666,0.3257350857709093,0.33462857142857144,0.3334216608927614,0.35995999999999995,0.34907668221440447,129175.0,13959138.333333334,459546.0,21704127.57142857
2023-05-03,0.3187,0.3287,0.2989,0.325,51493255.0,72050.0,26968412.0,0.32069999999999993,0.3296,0.35700499999999996,0.32360877144272737,0.32855593425217827,0.344166172969161,34.27260812581915,0.42968837897308204,0.2843216210269179,-0.013201618797574366,-0.010296514177997094,-0.002905104619577272,0.029799999999999993,0.024085714285714283,4927351384.089998,-0.010399999999999965,-12.868632707774797,-68.32524271844657,31.674757281553422,14.596418622547832,1.9767806714778877,0.3183,0.3212,0.3112,0.3187,23953321.0,37161.0,12216685.0,0.1256676091737216,23.255813953488385,0.42992286507337957,0.28769713492662036,-0.01317425331935368,-0.009570238023102775,-0.0036040152962509044,0.010000000000000009,0.026499999999999996,4875858129.089998,-0.029400000000000037,-24.923439340400478,-93.42442356959864,6.575576430401354,7.9797720347794145,0.32143333333333324,0.3222175428854547,0.3309,0.329741245669571,0.35880999999999996,0.34618366486065166,129001.0,13602138.333333334,427185.0,20412888.285714287
2023-05-04,0.325,0.326,0.307,0.3103,24973819.0,37447.0,11635164.0,0.3179999999999999,0.32478571428571434,0.35227,0.3169543857213637,0.3239919506891337,0.34094082316257424,33.017676767676804,0.42412230758479785,0.2804176924152022,-0.014245262761450106,-0.011086263894687698,-0.003158998866762408,0.019000000000000017,0.023278571428571426,4902377565.089998,-0.021599999999999953,-14.77616039549573,-83.28445747800582,16.71554252199417,18.321958744649677,-4.52307692307692,0.3187,0.3287,0.2989,0.325,51493255.0,72050.0,26968412.0,1.9767806714778877,34.27260812581915,0.42968837897308204,0.2843216210269179,-0.013201618797574366,-0.010296514177997094,-0.002905104619577272,0.029799999999999993,0.024085714285714283,4927351384.089998,-0.010399999999999965,-12.868632707774797,-68.32524271844657,31.674757281553422,14.596418622547832,0.32069999999999993,0.32360877144272737,0.3296,0.32855593425217827,0.35700499999999996,0.344166172969161,159260.0,18421997.0,373561.0,17714448.42857143
2023-05-05,0.3102,0.3136,0.2993,0.3103,31426604.0,48029.0,15322213.0,0.3151999999999999,0.3215571428571429,0.347425,0.31362719286068186,0.3205689630168503,0.33802264952804334,40.98746081504704,0.4167036554810378,0.27814634451896214,-0.01490059335694871,-0.011849129787139902,-0.0030514635698088086,0.01429999999999998,0.021578571428571426,4870950961.089998,-0.034499999999999975,-6.900690069006887,-82.27060653188177,17.729393468118225,22.039897757221965,0.03223726627983382,0.325,0.326,0.307,0.3103,24973819.0,37447.0,11635164.0,-4.52307692307692,33.017676767676804,0.42412230758479785,0.2804176924152022,-0.014245262761450106,-0.011086263894687698,-0.003158998866762408,0.019000000000000017,0.023278571428571426,4902377565.089998,-0.021599999999999953,-14.77616039549573,-83.28445747800582,16.71554252199417,18.321958744649677,0.3179999999999999,0.3169543857213637,0.32478571428571434,0.3239919506891337,0.35227,0.34094082316257424,146658.0,16940087.0,325772.0,15380626.57142857
2023-05-06,0.3103,0.3136,0.277,0.2879,53326902.0,70006.0,23576749.0,0.30283333333333323,0.31397142857142857,0.341555,0.3007635964303409,0.31240172226263774,0.3332490638587059,27.736686390532554,0.41007675912570624,0.27303324087429376,-0.017031116263884094,-0.01288552708248874,-0.0041455891813953535,0.036599999999999966,0.022828571428571424,4817624059.089998,-0.04620000000000002,-17.293881068658436,-87.35498839907197,12.645011600928033,15.696649197013505,-7.218820496293919,0.3102,0.3136,0.2993,0.3103,31426604.0,48029.0,15322213.0,0.03223726627983382,40.98746081504704,0.4167036554810378,0.27814634451896214,-0.01490059335694871,-0.011849129787139902,-0.0030514635698088086,0.01429999999999998,0.021578571428571426,4870950961.089998,-0.034499999999999975,-6.900690069006887,-82.27060653188177,17.729393468118225,22.039897757221965,0.3151999999999999,0.31362719286068186,0.3215571428571429,0.3205689630168503,0.347425,0.33802264952804334,157526.0,17975263.0,323862.0,15431412.714285715
2023-05-07,0.2881,0.2984,0.2868,0.2897,26239589.0,41863.0,12241571.0,0.29596666666666654,0.3086142857142857,0.33472999999999997,0.2952317982151704,0.3067262916969783,0.32910153396740055,31.617055510860837,0.3943690935015046,0.2750909064984953,-0.018362652828988635,-0.01398095223178872,-0.004381700597199915,0.0116,0.021921428571428564,4843863648.089998,-0.05429999999999996,-13.625521765056636,-85.26682134570767,14.733178654292331,15.035861241112892,0.5553627212773309,0.3103,0.3136,0.277,0.2879,53326902.0,70006.0,23576749.0,-7.218820496293919,27.736686390532554,0.41007675912570624,0.27303324087429376,-0.017031116263884094,-0.01288552708248874,-0.0041455891813953535,0.036599999999999966,0.022828571428571424,4817624059.089998,-0.04620000000000002,-17.293881068658436,-87.35498839907197,12.645011600928033,15.696649197013505,0.30283333333333323,0.3007635964303409,0.31397142857142857,0.31240172226263774,0.341555,0.3332490638587059,155482.0,16844708.666666668,356533.0,16901279.0
2023-05-08,0.2898,0.293,0.2416,0.2597,63899970.0,98814.0,27813371.0,0.2790999999999999,0.3002285714285714,0.32649,0.27746589910758523,0.2949697187727337,0.32249186406574337,26.06100795755971,0.3790212899237162,0.2739587100762838,-0.021589780874822828,-0.015502717960395544,-0.006087062914427285,0.051399999999999973,0.024142857142857133,4779963678.089998,-0.07319999999999999,-21.753540222958723,-85.11513157894738,14.88486842105261,14.087686225424354,-10.386473429951696,0.2881,0.2984,0.2868,0.2897,26239589.0,41863.0,12241571.0,0.5553627212773309,31.617055510860837,0.3943690935015046,0.2750909064984953,-0.018362652828988635,-0.01398095223178872,-0.004381700597199915,0.0116,0.021921428571428564,4843863648.089998,-0.05429999999999996,-13.625521765056636,-85.26682134570767,14.733178654292331,15.035861241112892,0.29596666666666654,0.2952317982151704,0.3086142857142857,0.3067262916969783,0.33472999999999997,0.32910153396740055,159898.0,17046844.333333332,356605.0,16863098.285714287
2023-05-09,0.2596,0.2649,0.2474,0.2633,49100258.0,58964.0,21944565.0,0.27089999999999986,0.2923142857142857,0.32100500000000004,0.2703829495537926,0.28705228907955027,0.3168545436785297,21.201413427561846,0.3759420730927379,0.26606792690726216,-0.023584940672843113,-0.017119162502885057,-0.0064657781699580565,0.017500000000000016,0.023307142857142853,4829063936.089998,-0.07770000000000005,-23.63689095127611,-82.15460526315792,17.845394736842078,15.821147270729034,1.4252696456086213,0.2898,0.293,0.2416,0.2597,63899970.0,98814.0,27813371.0,-10.386473429951696,26.06100795755971,0.3790212899237162,0.2739587100762838,-0.021589780874822828,-0.015502717960395544,-0.006087062914427285,0.051399999999999973,0.024142857142857133,4779963678.089998,-0.07319999999999999,-21.753540222958723,-85.11513157894738,14.88486842105261,14.087686225424354,0.2790999999999999,0.27746589910758523,0.3002285714285714,0.2949697187727337,0.32649,0.32249186406574337,210683.0,21210563.666666668,405370.0,18539166.42857143
2023-05-10,0.2632,0.2736,0.2465,0.2626,72497770.0,93909.0,35171325.0,0.2618666666666665,0.2834,0.31593,0.2664914747768963,0.2809392168096627,0.31168744428057454,22.813688212927758,0.37282277449264045,0.2590372255073595,-0.024935166261914887,-0.018682363254691026,-0.006252803007223862,0.027100000000000013,0.021514285714285708,4756566166.089998,-0.06459999999999999,-21.400778210116734,-80.26315789473685,19.736842105263154,17.48903508771931,-0.22796352583586227,0.2596,0.2649,0.2474,0.2633,49100258.0,58964.0,21944565.0,1.4252696456086213,21.201413427561846,0.3759420730927379,0.26606792690726216,-0.023584940672843113,-0.017119162502885057,-0.0064657781699580565,0.017500000000000016,0.023307142857142853,4829063936.089998,-0.07770000000000005,-23.63689095127611,-82.15460526315792,17.845394736842078,15.821147270729034,0.27089999999999986,0.2703829495537926,0.2923142857142857,0.28705228907955027,0.32100500000000004,0.3168545436785297,199641.0,20666502.333333332,427173.0,19928863.57142857
2023-05-11,0.2627,0.2629,0.2329,0.2414,49909320.0,64577.0,24228154.0,0.25576666666666653,0.2735571428571429,0.31133500000000003,0.25394573738844817,0.27105441260724705,0.30499340196813884,14.07563025210088,0.3765560258315753,0.24611397416842473,-0.027400041965467803,-0.02042589899684638,-0.006974142968621422,0.030000000000000027,0.022328571428571427,4706656846.089998,-0.07700000000000001,-29.825581395348834,-92.60226283724977,7.397737162750224,14.993324668285181,-8.108108108108103,0.2632,0.2736,0.2465,0.2626,72497770.0,93909.0,35171325.0,-0.22796352583586227,22.813688212927758,0.37282277449264045,0.2590372255073595,-0.024935166261914887,-0.018682363254691026,-0.006252803007223862,0.027100000000000013,0.021514285714285708,4756566166.089998,-0.06459999999999999,-21.400778210116734,-80.26315789473685,19.736842105263154,17.48903508771931,0.2618666666666665,0.2664914747768963,0.2834,0.2809392168096627,0.31593,0.31168744428057454,251687.0,28309753.666666668,449032.0,21100708.285714287
2023-05-12,0.2414,0.2468,0.2275,0.2453,50330447.0,68380.0,25138485.0,0.24976666666666658,0.26427142857142855,0.306195,0.24962286869422406,0.2646158094554353,0.29930831606641134,17.69911504424782,0.3753036551057315,0.2370863448942685,-0.028707850086878595,-0.022082289214852825,-0.00662556087202577,0.019299999999999984,0.02247142857142857,4756987293.089998,-0.07339999999999999,-26.314208471012314,-85.20365752285953,14.79634247714047,13.97697391505131,1.6155758077878983,0.2627,0.2629,0.2329,0.2414,49909320.0,64577.0,24228154.0,-8.108108108108103,14.07563025210088,0.3765560258315753,0.24611397416842473,-0.027400041965467803,-0.02042589899684638,-0.006974142968621422,0.030000000000000027,0.022328571428571427,4706656846.089998,-0.07700000000000001,-29.825581395348834,-92.60226283724977,7.397737162750224,14.993324668285181,0.25576666666666653,0.25394573738844817,0.2735571428571429,0.27105441260724705,0.31133500000000003,0.30499340196813884,217450.0,27114681.333333332,476162.0,22899706.85714286
2023-05-13,0.2453,0.246,0.2367,0.2381,25352168.0,32194.0,12219286.0,0.2415999999999999,0.25715714285714286,0.30133,0.24386143434711205,0.2579868570915765,0.293478952631515,11.804008908685972,0.37530960174048505,0.22735039825951492,-0.029979690067050868,-0.023661769385292436,-0.006317920681758432,0.009300000000000003,0.02197142857142857,4731635125.089998,-0.0869,-30.175953079178885,-90.66901408450705,9.330985915492956,10.508355185127911,-2.935181410517727,0.2414,0.2468,0.2275,0.2453,50330447.0,68380.0,25138485.0,1.6155758077878983,17.69911504424782,0.3753036551057315,0.2370863448942685,-0.028707850086878595,-0.022082289214852825,-0.00662556087202577,0.019299999999999984,0.02247142857142857,4756987293.089998,-0.07339999999999999,-26.314208471012314,-85.20365752285953,14.79634247714047,13.97697391505131,0.24976666666666658,0.24962286869422406,0.26427142857142855,0.2646158094554353,0.306195,0.29930831606641134,226866.0,28179321.333333332,496513.0,24302031.42857143
2023-05-14,0.238,0.2474,0.2329,0.2414,21707908.0,26718.0,10611014.0,0.2415999999999999,0.25025714285714284,0.296805,0.24263071717355603,0.2538401428186824,0.28851905238089454,15.45893719806763,0.3739163064274227,0.2196936935725773,-0.0303712491390713,-0.02500366533604821,-0.005367583803023088,0.014500000000000013,0.02195714285714286,4753343033.089998,-0.06890000000000002,-26.22249388753056,-86.49173955296405,13.50826044703595,12.54519627988982,1.4285714285714346,0.2453,0.246,0.2367,0.2381,25352168.0,32194.0,12219286.0,-2.935181410517727,11.804008908685972,0.37530960174048505,0.22735039825951492,-0.029979690067050868,-0.023661769385292436,-0.006317920681758432,0.009300000000000003,0.02197142857142857,4731635125.089998,-0.0869,-30.175953079178885,-90.66901408450705,9.330985915492956,10.508355185127911,0.2415999999999999,0.24386143434711205,0.25715714285714286,0.2579868570915765,0.30133,0.293478952631515,165151.0,20528641.666666668,458701.0,22679536.714285713
2023-05-15,0.2413,0.2536,0.2351,0.2464,41311978.0,49458.0,20913177.0,0.24196666666666658,0.2483571428571429,0.29188500000000006,0.24451535858677803,0.2519801071140118,0.2845077140589046,20.09966777408637,0.3686584130240729,0.21511158697592725,-0.029933054689639194,-0.02598954320676641,-0.003943511482872784,0.01849999999999999,0.02206428571428571,4794655011.089998,-0.06390000000000001,-22.613065326633162,-81.32411067193675,18.675889328063246,13.838378563530744,2.1135515955242523,0.238,0.2474,0.2329,0.2414,21707908.0,26718.0,10611014.0,1.4285714285714346,15.45893719806763,0.3739163064274227,0.2196936935725773,-0.0303712491390713,-0.02500366533604821,-0.005367583803023088,0.014500000000000013,0.02195714285714286,4753343033.089998,-0.06890000000000002,-26.22249388753056,-86.49173955296405,13.50826044703595,12.54519627988982,0.2415999999999999,0.24263071717355603,0.25025714285714284,0.2538401428186824,0.296805,0.28851905238089454,127292.0,15989595.0,443556.0,22446600.0
2023-05-16,0.2463,0.2489,0.2391,0.2446,35274398.0,40764.0,16989455.0,0.24413333333333323,0.24568571428571429,0.28741,0.244557679293389,0.25013508033550885,0.280706979386628,19.606234618539816,0.364256392237999,0.210563607762001,-0.029392212261284856,-0.026670077017670102,-0.002722135243614754,0.009800000000000003,0.022049999999999997,4759380613.089998,-0.04329999999999998,-23.250705993096954,-83.10276679841897,16.897233201581034,16.360460992226766,-0.6902151847340557,0.2413,0.2536,0.2351,0.2464,41311978.0,49458.0,20913177.0,2.1135515955242523,20.09966777408637,0.3686584130240729,0.21511158697592725,-0.029933054689639194,-0.02598954320676641,-0.003943511482872784,0.01849999999999999,0.02206428571428571,4794655011.089998,-0.06390000000000001,-22.613065326633162,-81.32411067193675,18.675889328063246,13.838378563530744,0.24196666666666658,0.24451535858677803,0.2483571428571429,0.2519801071140118,0.29188500000000006,0.2845077140589046,108370.0,14581159.0,394200.0,21460858.0
2023-05-17,0.2447,0.2606,0.2365,0.2569,44416282.0,54406.0,22417671.0,0.24929999999999994,0.2448714285714286,0.283055,0.2507288396466945,0.2518263102516316,0.278439648016473,23.377638780297104,0.356180140755575,0.209929859244425,-0.02765232474891277,-0.026866526563918636,-0.0007857981849941353,0.02410000000000001,0.02164285714285714,4803796895.089998,-0.032799999999999996,-20.953846153846158,-70.15228426395939,29.84771573604062,21.80694608856166,4.9856967715570155,0.2463,0.2489,0.2391,0.2446,35274398.0,40764.0,16989455.0,-0.6902151847340557,19.606234618539816,0.364256392237999,0.210563607762001,-0.029392212261284856,-0.026670077017670102,-0.002722135243614754,0.009800000000000003,0.022049999999999997,4759380613.089998,-0.04329999999999998,-23.250705993096954,-83.10276679841897,16.897233201581034,16.360460992226766,0.24413333333333323,0.244557679293389,0.24568571428571429,0.25013508033550885,0.28741,0.280706979386628,116940.0,16171215.333333334,376000.0,20752985.14285714
2023-05-18,0.2569,0.2589,0.241,0.2468,37443993.0,44363.0,19197786.0,0.24943333333333326,0.24564285714285714,0.27875,0.24876441982334724,0.2505697326887237,0.2754263482053803,24.249797242497976,0.34962253198150867,0.20787746801849133,-0.026779736814730504,-0.02684916861408101,6.943179935050767e-05,0.017900000000000027,0.021564285714285713,4766352902.089998,-0.012899999999999995,-20.46406703190462,-77.58420441347272,22.415795586527278,23.05358150804967,-3.9314908524717884,0.2447,0.2606,0.2365,0.2569,44416282.0,54406.0,22417671.0,4.9856967715570155,23.377638780297104,0.356180140755575,0.209929859244425,-0.02765232474891277,-0.026866526563918636,-0.0007857981849941353,0.02410000000000001,0.02164285714285714,4803796895.089998,-0.032799999999999996,-20.953846153846158,-70.15228426395939,29.84771573604062,21.80694608856166,0.24929999999999994,0.2507288396466945,0.2448714285714286,0.2518263102516316,0.283055,0.278439648016473,144628.0,20106767.666666668,336497.0,18931034.57142857
2023-05-19,0.2467,0.2842,0.2419,0.265,173819173.0,179713.0,84444010.0,0.25623333333333326,0.2484571428571429,0.27495,0.25688220991167365,0.2541772995165428,0.27443336266201074,33.99293286219081,0.3396501993000789,0.2102498006999212,-0.02433905126157082,-0.026347145143578977,0.0020080938820081565,0.042300000000000004,0.023564285714285715,4940172075.089998,0.0017000000000000348,-14.598775378665806,-56.44599303135887,43.554006968641126,31.939172763736366,7.417916497770576,0.2569,0.2589,0.241,0.2468,37443993.0,44363.0,19197786.0,-3.9314908524717884,24.249797242497976,0.34962253198150867,0.20787746801849133,-0.026779736814730504,-0.02684916861408101,6.943179935050767e-05,0.017900000000000027,0.021564285714285713,4766352902.089998,-0.012899999999999995,-20.46406703190462,-77.58420441347272,22.415795586527278,23.05358150804967,0.24943333333333326,0.24876441982334724,0.24564285714285714,0.2505697326887237,0.27875,0.2754263482053803,139533.0,19534970.666666668,316283.0,18212410.57142857
2023-05-20,0.265,0.2667,0.254,0.2588,70676094.0,68768.0,33808628.0,0.2568666666666666,0.2514142857142857,0.27153,0.2578411049558368,0.25533297463740706,0.2729444709799145,38.3878691141261,0.3316717308486369,0.2113882691513631,-0.022644052024633043,-0.025606526519789792,0.0029624744951567486,0.012699999999999989,0.02185714285714286,4869495981.089998,-0.0038000000000000256,-10.1076762764849,-55.85331452750357,44.146685472496436,36.70549600922164,-2.3396226415094485,0.2467,0.2842,0.2419,0.265,173819173.0,179713.0,84444010.0,7.417916497770576,33.99293286219081,0.3396501993000789,0.2102498006999212,-0.02433905126157082,-0.026347145143578977,0.0020080938820081565,0.042300000000000004,0.023564285714285715,4940172075.089998,0.0017000000000000348,-14.598775378665806,-56.44599303135887,43.554006968641126,31.939172763736366,0.25623333333333326,0.25688220991167365,0.2484571428571429,0.2541772995165428,0.27495,0.27443336266201074,278482.0,42019822.333333336,427616.0,26684628.42857143
2023-05-21,0.2589,0.259,0.24,0.243,55040599.0,49418.0,23939240.0,0.2555999999999999,0.25164285714285717,0.26776,0.2504205524779184,0.25224973097805525,0.270092616600875,33.23761665470208,0.3249094587163789,0.2106105412836211,-0.02231840815495656,-0.02494890284682315,0.002630494691866589,0.019000000000000017,0.02238571428571429,4814455382.089998,0.0015999999999999903,-16.12012426648257,-76.33587786259544,23.66412213740457,37.12160485951407,-6.141367323290855,0.265,0.2667,0.254,0.2588,70676094.0,68768.0,33808628.0,-2.3396226415094485,38.3878691141261,0.3316717308486369,0.2113882691513631,-0.022644052024633043,-0.025606526519789792,0.0029624744951567486,0.012699999999999989,0.02185714285714286,4869495981.089998,-0.0038000000000000256,-10.1076762764849,-55.85331452750357,44.146685472496436,36.70549600922164,0.2568666666666666,0.2578411049558368,0.2514142857142857,0.25533297463740706,0.27153,0.2729444709799145,292844.0,45816808.0,464190.0,29768820.14285714
2023-05-22,0.243,0.2452,0.2344,0.2394,43763573.0,45331.0,21804491.0,0.24706666666666655,0.2506428571428571,0.263795,0.2449102762389592,0.24903729823354143,0.26716951025793456,41.00974313551817,0.31692595935611706,0.21066404064388294,-0.02209611272253248,-0.024378344821965017,0.002282232099432537,0.010800000000000004,0.019485714285714297,4770691809.089998,-0.005899999999999989,-7.816711590296488,-79.01234567901236,20.987654320987644,29.59948731029624,-1.4814814814814783,0.2589,0.259,0.24,0.243,55040599.0,49418.0,23939240.0,-6.141367323290855,33.23761665470208,0.3249094587163789,0.2106105412836211,-0.02231840815495656,-0.02494890284682315,0.002630494691866589,0.019000000000000017,0.02238571428571429,4814455382.089998,0.0015999999999999903,-16.12012426648257,-76.33587786259544,23.66412213740457,37.12160485951407,0.2555999999999999,0.2504205524779184,0.25164285714285717,0.25224973097805525,0.26776,0.270092616600875,297899.0,47397292.666666664,486890.0,31672852.42857143
2023-05-23,0.2395,0.2485,0.2369,0.2452,41604930.0,37787.0,20212631.0,0.24253333333333324,0.25072857142857147,0.259805,0.2450551381194796,0.24807797367515608,0.26507717594765506,42.1372719374457,0.3049715677476307,0.21463843225236934,-0.021207464019379285,-0.02374416866144787,0.0025367046420685865,0.0116,0.019064285714285718,4812296739.089998,0.007099999999999995,-6.8742878845423405,-68.78306878306879,31.216931216931204,25.28956922510783,2.37995824634656,0.243,0.2452,0.2344,0.2394,43763573.0,45331.0,21804491.0,-1.4814814814814783,41.00974313551817,0.31692595935611706,0.21066404064388294,-0.02209611272253248,-0.024378344821965017,0.002282232099432537,0.010800000000000004,0.019485714285714297,4770691809.089998,-0.005899999999999989,-7.816711590296488,-79.01234567901236,20.987654320987644,29.59948731029624,0.24706666666666655,0.2449102762389592,0.2506428571428571,0.24903729823354143,0.263795,0.26716951025793456,163517.0,26517453.0,482763.0,31800183.0
2023-05-24,0.2452,0.2453,0.22,0.2315,60268042.0,60950.0,29720978.0,0.2386999999999999,0.24710000000000004,0.25586499999999995,0.2382775690597398,0.24393348025636707,0.261879349666926,37.86104605776738,0.2959466154206993,0.21578338457930066,-0.02136242627167373,-0.023267820183493045,0.0019053939118193162,0.02529999999999999,0.01893571428571429,4752028697.089998,-0.009899999999999992,-11.843107387661844,-82.0872274143302,17.912772585669796,23.37245270786291,-5.587275693311578,0.2395,0.2485,0.2369,0.2452,41604930.0,37787.0,20212631.0,2.37995824634656,42.1372719374457,0.3049715677476307,0.21463843225236934,-0.021207464019379285,-0.02374416866144787,0.0025367046420685865,0.0116,0.019064285714285718,4812296739.089998,0.007099999999999995,-6.8742878845423405,-68.78306878306879,31.216931216931204,25.28956922510783,0.24253333333333324,0.2450551381194796,0.25072857142857147,0.24807797367515608,0.259805,0.26507717594765506,132536.0,21985454.0,479786.0,32260636.714285713
2023-05-25,0.2316,0.247,0.2231,0.237,95327798.0,83050.0,47036473.0,0.2378999999999999,0.2457,0.2522,0.2376387845298699,0.2422001101922753,0.2595098877938854,48.04270462633452,0.28383981502368166,0.2205601849763183,-0.020801642551714405,-0.022774584657137317,0.001972942105422912,0.023900000000000005,0.0185,4847356495.089998,-0.00940000000000002,-1.822700911350461,-73.52024922118382,26.479750778816175,25.203151527139084,2.3316062176165753,0.2452,0.2453,0.22,0.2315,60268042.0,60950.0,29720978.0,-5.587275693311578,37.86104605776738,0.2959466154206993,0.21578338457930066,-0.02136242627167373,-0.023267820183493045,0.0019053939118193162,0.02529999999999999,0.01893571428571429,4752028697.089998,-0.009899999999999992,-11.843107387661844,-82.0872274143302,17.912772585669796,23.37245270786291,0.2386999999999999,0.2382775690597398,0.24710000000000004,0.24393348025636707,0.25586499999999995,0.261879349666926,144068.0,23912700.0,486330.0,33303966.285714287
2023-05-26,0.237,0.25,0.2305,0.2453,77061615.0,63001.0,37331293.0,0.23793333333333322,0.2428857142857143,0.25007,0.24146939226493494,0.24297508264420647,0.2581565651468487,50.0,0.2769713871682275,0.22316861283177256,-0.01946311806967549,-0.022112291339644954,0.0026491732699694646,0.01949999999999999,0.018514285714285716,4924418110.089998,0.0006999999999999784,0.0,-60.5919003115265,39.4080996884735,27.933541017653184,3.5021097046413514,0.2316,0.247,0.2231,0.237,95327798.0,83050.0,47036473.0,2.3316062176165753,48.04270462633452,0.28383981502368166,0.2205601849763183,-0.020801642551714405,-0.022774584657137317,0.001972942105422912,0.023900000000000005,0.0185,4847356495.089998,-0.00940000000000002,-1.822700911350461,-73.52024922118382,26.479750778816175,25.203151527139084,0.2378999999999999,0.2376387845298699,0.2457,0.2422001101922753,0.2522,0.2595098877938854,181787.0,32323360.666666668,525017.0,37280921.571428575
2023-05-27,0.2452,0.2637,0.2416,0.255,89773447.0,81236.0,44964696.0,0.24576666666666655,0.24234285714285714,0.24833500000000003,0.24823469613246746,0.24598131198315484,0.25785593989476785,57.08298407376362,0.2679688349203643,0.22870116507963578,-0.0174188254632954,-0.021173598164375047,0.0037547727010796457,0.02209999999999998,0.01942857142857143,5014191557.089998,-0.0019000000000000128,7.097858042839134,-45.482866043613704,54.51713395638629,40.134994807892014,3.996737357259381,0.237,0.25,0.2305,0.2453,77061615.0,63001.0,37331293.0,3.5021097046413514,50.0,0.2769713871682275,0.22316861283177256,-0.01946311806967549,-0.022112291339644954,0.0026491732699694646,0.01949999999999999,0.018514285714285716,4924418110.089998,0.0006999999999999784,0.0,-60.5919003115265,39.4080996884735,27.933541017653184,0.23793333333333322,0.24146939226493494,0.2428857142857143,0.24297508264420647,0.25007,0.2581565651468487,207001.0,38029581.333333336,408305.0,30550533.42857143
2023-05-28,0.255,0.2725,0.2533,0.2681,82895728.0,76544.0,38462002.0,0.2561333333333332,0.24592857142857144,0.24875499999999998,0.25816734806623376,0.25151098398736615,0.2588315646666947,60.34082106893881,0.26972630621126004,0.22778369378873992,-0.014573652333358944,-0.019853608998171828,0.005279956664812884,0.019199999999999995,0.019764285714285713,5097087285.089998,0.021300000000000013,11.06048053024027,-25.0778816199377,74.9221183800623,56.28245067497406,5.137254901960785,0.2452,0.2637,0.2416,0.255,89773447.0,81236.0,44964696.0,3.996737357259381,57.08298407376362,0.2679688349203643,0.22870116507963578,-0.0174188254632954,-0.021173598164375047,0.0037547727010796457,0.02209999999999998,0.01942857142857143,5014191557.089998,-0.0019000000000000128,7.097858042839134,-45.482866043613704,54.51713395638629,40.134994807892014,0.24576666666666655,0.24823469613246746,0.24234285714285714,0.24598131198315484,0.24833500000000003,0.25785593989476785,227287.0,43110820.666666664,420773.0,32144257.42857143
2023-05-29,0.2681,0.2708,0.256,0.2607,43054819.0,41795.0,19207595.0,0.26126666666666654,0.24897142857142857,0.248625,0.2594336740331169,0.2538082379905246,0.2590095108889143,55.43726235741445,0.26924597807665807,0.22800402192334193,-0.012768759968498633,-0.01843663919223719,0.005667879223738556,0.01479999999999998,0.019499999999999997,5054032466.089998,-0.004300000000000026,5.803571428571419,-36.60436137071654,63.395638629283454,64.27829698857738,-2.7601641178664744,0.255,0.2725,0.2533,0.2681,82895728.0,76544.0,38462002.0,5.137254901960785,60.34082106893881,0.26972630621126004,0.22778369378873992,-0.014573652333358944,-0.019853608998171828,0.005279956664812884,0.019199999999999995,0.019764285714285713,5097087285.089998,0.021300000000000013,11.06048053024027,-25.0778816199377,74.9221183800623,56.28245067497406,0.2561333333333332,0.25816734806623376,0.24592857142857144,0.25151098398736615,0.24875499999999998,0.2588315646666947,220781.0,40252663.666666664,447899.0,34218937.71428572
2023-05-30,0.2607,0.2843,0.2566,0.2765,84890149.0,94393.0,41948144.0,0.26843333333333325,0.25344285714285714,0.24931999999999999,0.26796683701655843,0.2594811784928934,0.26067527175663674,60.96219931271477,0.27267930784834626,0.22596069215165374,-0.009948758714337425,-0.016739063096657236,0.006790304382319812,0.027700000000000002,0.020778571428571427,5138922615.089998,0.01770000000000005,13.041700735895345,-12.13063763608083,87.86936236391917,75.395706457755,6.060606060606075,0.2681,0.2708,0.256,0.2607,43054819.0,41795.0,19207595.0,-2.7601641178664744,55.43726235741445,0.26924597807665807,0.22800402192334193,-0.012768759968498633,-0.01843663919223719,0.005667879223738556,0.01479999999999998,0.019499999999999997,5054032466.089998,-0.004300000000000026,5.803571428571419,-36.60436137071654,63.395638629283454,64.27829698857738,0.26126666666666654,0.2594336740331169,0.24897142857142857,0.2538082379905246,0.248625,0.2590095108889143,199575.0,34211431.0,444363.0,33847952.571428575
2023-05-31,0.2764,0.2896,0.2585,0.2639,72552861.0,88008.0,33861321.0,0.26703333333333323,0.25807142857142856,0.25044500000000003,0.26593341850827923,0.2605858838696701,0.26098238873219515,52.400548696845,0.2743589223927498,0.2265310776072503,-0.008631108059774295,-0.015117472089280649,0.006486364029506354,0.031100000000000017,0.021278571428571428,5066369754.089998,0.02090000000000003,2.7247956403269713,-36.92528735632183,63.074712643678176,71.44657121229362,-4.522431259044847,0.2607,0.2843,0.2566,0.2765,84890149.0,94393.0,41948144.0,6.060606060606075,60.96219931271477,0.27267930784834626,0.22596069215165374,-0.009948758714337425,-0.016739063096657236,0.006790304382319812,0.027700000000000002,0.020778571428571427,5138922615.089998,0.01770000000000005,13.041700735895345,-12.13063763608083,87.86936236391917,75.395706457755,0.26843333333333325,0.26796683701655843,0.25344285714285714,0.2594811784928934,0.24931999999999999,0.26067527175663674,212732.0,33205913.666666668,500969.0,36953025.85714286
2023-06-01,0.2639,0.2698,0.253,0.2626,53480251.0,59371.0,25479458.0,0.26766666666666655,0.2617285714285714,0.25131000000000003,0.26426670925413964,0.26108941290225257,0.26113644694817656,55.76642335766423,0.2756873751878371,0.226932624812163,-0.007604104178737359,-0.013614798507171991,0.006010694328434632,0.01679999999999998,0.021199999999999997,5012889503.089998,0.0232,6.4019448946515345,-38.793103448275886,61.20689655172412,70.71699051977384,-0.4926108374384324,0.2764,0.2896,0.2585,0.2639,72552861.0,88008.0,33861321.0,-4.522431259044847,52.400548696845,0.2743589223927498,0.2265310776072503,-0.008631108059774295,-0.015117472089280649,0.006486364029506354,0.031100000000000017,0.021278571428571428,5066369754.089998,0.02090000000000003,2.7247956403269713,-36.92528735632183,63.074712643678176,71.44657121229362,0.26703333333333323,0.26593341850827923,0.25807142857142856,0.2605858838696701,0.25044500000000003,0.26098238873219515,224196.0,31672353.333333332,528027.0,37544503.428571425
2023-06-02,0.2626,0.2795,0.2574,0.2731,54792369.0,61722.0,25286564.0,0.26653333333333323,0.2657,0.25305999999999995,0.2686833546270698,0.2640920596766895,0.26227583295311213,53.132250580046396,0.2784486340089038,0.2276713659910961,-0.005875208212925032,-0.0120668804483226,0.006191672235397568,0.02210000000000001,0.019757142857142855,5067681872.089998,0.027900000000000008,3.0566037735848983,-23.706896551724153,76.29310344827584,66.85823754789274,3.9984767707540017,0.2639,0.2698,0.253,0.2626,53480251.0,59371.0,25479458.0,-0.4926108374384324,55.76642335766423,0.2756873751878371,0.226932624812163,-0.007604104178737359,-0.013614798507171991,0.006010694328434632,0.01679999999999998,0.021199999999999997,5012889503.089998,0.0232,6.4019448946515345,-38.793103448275886,61.20689655172412,70.71699051977384,0.26766666666666655,0.26426670925413964,0.2617285714285714,0.26108941290225257,0.25131000000000003,0.26113644694817656,241772.0,33762974.333333336,504348.0,34464929.85714286
2023-06-03,0.2732,0.2751,0.2653,0.2685,22952819.0,26153.0,11148578.0,0.26806666666666656,0.26762857142857144,0.254415,0.26859167731353495,0.2651940447575171,0.26286861076710144,53.79796397807363,0.2800746570514101,0.2287553429485899,-0.0048206577187652755,-0.010617635902411136,0.00579697818364586,0.009800000000000031,0.01955,5044729053.089998,0.037000000000000005,3.7480680061823923,-30.31609195402299,69.683908045977,69.06130268199236,-1.7203513909223946,0.2626,0.2795,0.2574,0.2731,54792369.0,61722.0,25286564.0,3.9984767707540017,53.132250580046396,0.2784486340089038,0.2276713659910961,-0.005875208212925032,-0.0120668804483226,0.006191672235397568,0.02210000000000001,0.019757142857142855,5067681872.089998,0.027900000000000008,3.0566037735848983,-23.706896551724153,76.29310344827584,66.85823754789274,0.26653333333333323,0.2686833546270698,0.2657,0.2640920596766895,0.25305999999999995,0.26227583295311213,209101.0,28209114.333333332,503069.0,32744254.285714287
2023-06-04,0.2685,0.2797,0.2651,0.2708,26161132.0,30547.0,12753734.0,0.2707999999999999,0.2680142857142857,0.25563499999999995,0.2696958386567675,0.2665955335681378,0.2636239811702346,62.171628721541154,0.2820006295401537,0.22926937045984622,-0.003756030890363582,-0.009245314900001626,0.005489284009638044,0.014600000000000002,0.019235714285714283,5070890185.089998,0.0338,11.440329218106982,-27.011494252873607,72.98850574712638,72.98850574712644,0.8566108007448673,0.2732,0.2751,0.2653,0.2685,22952819.0,26153.0,11148578.0,-1.7203513909223946,53.79796397807363,0.2800746570514101,0.2287553429485899,-0.0048206577187652755,-0.010617635902411136,0.00579697818364586,0.009800000000000031,0.01955,5044729053.089998,0.037000000000000005,3.7480680061823923,-30.31609195402299,69.683908045977,69.06130268199236,0.26806666666666656,0.26859167731353495,0.26762857142857144,0.2651940447575171,0.254415,0.26286861076710144,147246.0,20638200.0,447986.0,27913380.285714287
2023-06-05,0.2708,0.2719,0.2253,0.241,69980745.0,89028.0,32328584.0,0.26009999999999994,0.2652,0.25545500000000004,0.25534791932838374,0.2601966501761034,0.2614693162968789,50.569800569800556,0.28218448106287763,0.22872551893712248,-0.005256325758249858,-0.008447517071651273,0.0031911913134014154,0.046599999999999975,0.021792857142857138,5000909440.089998,-0.004299999999999998,0.6683375104427736,-69.82758620689657,30.172413793103424,57.61494252873563,-11.004431314623336,0.2685,0.2797,0.2651,0.2708,26161132.0,30547.0,12753734.0,0.8566108007448673,62.171628721541154,0.2820006295401537,0.22926937045984622,-0.003756030890363582,-0.009245314900001626,0.005489284009638044,0.014600000000000002,0.019235714285714283,5070890185.089998,0.0338,11.440329218106982,-27.011494252873607,72.98850574712638,72.98850574712644,0.2707999999999999,0.2696958386567675,0.2680142857142857,0.2665955335681378,0.25563499999999995,0.2636239811702346,118422.0,16396292.0,401989.0,24240770.57142857
2023-06-06,0.2412,0.2518,0.2327,0.246,39636526.0,52507.0,18232366.0,0.2525999999999999,0.2608428571428571,0.25490999999999997,0.25067395966419187,0.25664748763207756,0.25999604807812854,50.286532951289395,0.28195801967643913,0.2278619803235608,-0.005973008908209176,-0.007952615438962855,0.001979606530753679,0.019100000000000034,0.022328571428571427,5040545966.089998,-0.009000000000000008,0.32626427406199365,-62.643678160919556,37.356321839080444,46.839080459770116,1.9900497512437807,0.2708,0.2719,0.2253,0.241,69980745.0,89028.0,32328584.0,-11.004431314623336,50.569800569800556,0.28218448106287763,0.22872551893712248,-0.005256325758249858,-0.008447517071651273,0.0031911913134014154,0.046599999999999975,0.021792857142857138,5000909440.089998,-0.004299999999999998,0.6683375104427736,-69.82758620689657,30.172413793103424,57.61494252873563,0.26009999999999994,0.25534791932838374,0.2652,0.2601966501761034,0.25545500000000004,0.2614693162968789,145728.0,18743632.0,449222.0,26115197.57142857
2023-06-07,0.2459,0.2477,0.2256,0.2288,48679183.0,54899.0,23951785.0,0.2385999999999999,0.2558285714285714,0.25401,0.23973697983209594,0.24968561572405817,0.25702499588021155,49.056603773584904,0.2832992579553481,0.2247207420446519,-0.007838524095120758,-0.007929797170194436,9.127307507367753e-05,0.02210000000000001,0.0221,4991866783.089998,-0.0393,-1.1663066954643697,-91.42857142857142,8.571428571428584,25.366721401204178,-6.95404636030907,0.2412,0.2518,0.2327,0.246,39636526.0,52507.0,18232366.0,1.9900497512437807,50.286532951289395,0.28195801967643913,0.2278619803235608,-0.005973008908209176,-0.007952615438962855,0.001979606530753679,0.019100000000000034,0.022328571428571427,5040545966.089998,-0.009000000000000008,0.32626427406199365,-62.643678160919556,37.356321839080444,46.839080459770116,0.2525999999999999,0.25067395966419187,0.2608428571428571,0.25664748763207756,0.25490999999999997,0.25999604807812854,172082.0,21104894.666666668,407336.0,22727229.285714287
2023-06-08,0.2287,0.2322,0.2218,0.2276,26816459.0,38064.0,12576175.0,0.23413333333333322,0.25082857142857146,0.25214,0.23366848991604797,0.24416421179304365,0.2542226153201914,46.61383285302594,0.2831971900310947,0.22108280996890523,-0.009306508653582929,-0.008205139466872135,-0.001101369186710794,0.010399999999999993,0.021135714285714285,4965050324.089998,-0.03309999999999999,-3.966244725738388,-91.44542772861357,8.554572271386427,18.160774227298514,-0.48097944905989937,0.2459,0.2477,0.2256,0.2288,48679183.0,54899.0,23951785.0,-6.95404636030907,49.056603773584904,0.2832992579553481,0.2247207420446519,-0.007838524095120758,-0.007929797170194436,9.127307507367753e-05,0.02210000000000001,0.0221,4991866783.089998,-0.0393,-1.1663066954643697,-91.42857142857142,8.571428571428584,25.366721401204178,0.2385999999999999,0.23973697983209594,0.2558285714285714,0.24968561572405817,0.25401,0.25702499588021155,196434.0,24837578.333333332,374227.0,21311581.285714287
2023-06-09,0.2276,0.23,0.2159,0.2191,28953420.0,41095.0,13244874.0,0.22516666666666654,0.2431142857142857,0.250155,0.22638424495802398,0.23789815884478274,0.25087760433731604,40.57553956834533,0.28433745009844624,0.21597254990155376,-0.011028644605043797,-0.008769840494506468,-0.002258804110537329,0.014100000000000001,0.020749999999999998,4936096904.089998,-0.057400000000000034,-10.680799021606202,-95.6580732700136,4.341926729986404,7.1559758576005,-3.734622144112482,0.2287,0.2322,0.2218,0.2276,26816459.0,38064.0,12576175.0,-0.48097944905989937,46.61383285302594,0.2831971900310947,0.22108280996890523,-0.009306508653582929,-0.008205139466872135,-0.001101369186710794,0.010399999999999993,0.021135714285714285,4965050324.089998,-0.03309999999999999,-3.966244725738388,-91.44542772861357,8.554572271386427,18.160774227298514,0.23413333333333322,0.23366848991604797,0.25082857142857146,0.24416421179304365,0.25214,0.2542226153201914,145470.0,18253442.0,352920.0,19468255.14285714
2023-06-10,0.2193,0.2197,0.1722,0.188,93235305.0,118193.0,46429137.0,0.21156666666666654,0.23161428571428574,0.247405,0.20719212247901198,0.22542361913358705,0.24488926106709547,29.11471321695761,0.2914406064063485,0.20336939359365155,-0.014733125540176417,-0.009962497503640458,-0.004770628036535959,0.047500000000000014,0.02256428571428572,4842861599.089998,-0.07590000000000002,-26.274509803921575,-86.54173764906304,13.458262350936973,8.784920450769963,-14.27268581851345,0.2276,0.23,0.2159,0.2191,28953420.0,41095.0,13244874.0,-3.734622144112482,40.57553956834533,0.28433745009844624,0.21597254990155376,-0.011028644605043797,-0.008769840494506468,-0.002258804110537329,0.014100000000000001,0.020749999999999998,4936096904.089998,-0.057400000000000034,-10.680799021606202,-95.6580732700136,4.341926729986404,7.1559758576005,0.22516666666666654,0.22638424495802398,0.2431142857142857,0.23789815884478274,0.250155,0.25087760433731604,134058.0,16590944.666666666,332293.0,17748013.714285713
2023-06-11,0.1881,0.1898,0.1791,0.183,42313518.0,50983.0,19601659.0,0.19669999999999987,0.21907142857142856,0.244585,0.19509606123950599,0.21481771435019031,0.2389950457273721,22.061720288903487,0.29717230184926136,0.19199769815073864,-0.017866458175506222,-0.011543289638013612,-0.00632316853749261,0.010699999999999987,0.02195714285714286,4800548081.089998,-0.0796,-31.74188735546438,-90.80068143100512,9.19931856899489,8.999835883306117,-2.7113237639553396,0.2193,0.2197,0.1722,0.188,93235305.0,118193.0,46429137.0,-14.27268581851345,29.11471321695761,0.2914406064063485,0.20336939359365155,-0.014733125540176417,-0.009962497503640458,-0.004770628036535959,0.047500000000000014,0.02256428571428572,4842861599.089998,-0.07590000000000002,-26.274509803921575,-86.54173764906304,13.458262350936973,8.784920450769963,0.21156666666666654,0.20719212247901198,0.23161428571428574,0.22542361913358705,0.247405,0.24488926106709547,197352.0,24083395.333333332,424333.0,22788093.57142857
2023-06-12,0.1829,0.1898,0.1758,0.1852,41300578.0,50202.0,19316318.0,0.1853999999999999,0.2111,0.241585,0.190148030619753,0.20741328576264273,0.23387170803905094,24.337185588035368,0.30049075076917386,0.18267924923082612,-0.019942243480388505,-0.013223080406488591,-0.006719163073899914,0.013999999999999985,0.021900000000000003,4841848659.089998,-0.0879,-28.96049098580744,-88.9267461669506,11.07325383304941,11.24361158432712,1.2575177692728248,0.1881,0.1898,0.1791,0.183,42313518.0,50983.0,19601659.0,-2.7113237639553396,22.061720288903487,0.29717230184926136,0.19199769815073864,-0.017866458175506222,-0.011543289638013612,-0.00632316853749261,0.010699999999999987,0.02195714285714286,4800548081.089998,-0.0796,-31.74188735546438,-90.80068143100512,9.19931856899489,8.999835883306117,0.19669999999999987,0.19509606123950599,0.21907142857142856,0.21481771435019031,0.244585,0.2389950457273721,210271.0,26425223.333333332,444769.0,23766368.57142857
2023-06-13,0.1852,0.1946,0.1829,0.1896,58392945.0,64561.0,29130176.0,0.1859333333333332,0.20304285714285714,0.23949000000000004,0.1898740153098765,0.20295996432198204,0.22965535489247466,17.980840088430355,0.30272709437710554,0.17625290562289453,-0.020990311813496976,-0.014776526687890269,-0.006213785125606707,0.011699999999999988,0.02075714285714286,4900241604.089998,-0.07890000000000003,-31.428571428571438,-85.17887563884156,14.821124361158427,11.697898921067605,2.3758099352051767,0.1829,0.1898,0.1758,0.1852,41300578.0,50202.0,19316318.0,1.2575177692728248,24.337185588035368,0.30049075076917386,0.18267924923082612,-0.019942243480388505,-0.013223080406488591,-0.006719163073899914,0.013999999999999985,0.021900000000000003,4841848659.089998,-0.0879,-28.96049098580744,-88.9267461669506,11.07325383304941,11.24361158432712,0.1853999999999999,0.190148030619753,0.2111,0.20741328576264273,0.241585,0.23387170803905094,219378.0,28449038.0,405943.0,21907473.42857143
2023-06-14,0.1896,0.1931,0.1762,0.1798,36410283.0,44079.0,16259052.0,0.18486666666666654,0.19604285714285713,0.23663000000000003,0.18483700765493824,0.19716997324148652,0.22490722585509612,18.35966892400299,0.30528324310962623,0.16797675689037384,-0.02235400852104924,-0.016292023054522063,-0.006061985466527177,0.0169,0.019742857142857142,4863831321.089998,-0.091,-31.868131868131876,-92.93023255813954,7.06976744186046,10.988048545356127,-5.168776371308019,0.1852,0.1946,0.1829,0.1896,58392945.0,64561.0,29130176.0,2.3758099352051767,17.980840088430355,0.30272709437710554,0.17625290562289453,-0.020990311813496976,-0.014776526687890269,-0.006213785125606707,0.011699999999999988,0.02075714285714286,4900241604.089998,-0.07890000000000003,-31.428571428571438,-85.17887563884156,14.821124361158427,11.697898921067605,0.1859333333333332,0.1898740153098765,0.20304285714285714,0.20295996432198204,0.23949000000000004,0.22965535489247466,165746.0,22682717.666666668,417997.0,23464303.42857143
2023-06-15,0.1798,0.1887,0.1728,0.1822,39458717.0,46214.0,19095979.0,0.18386666666666654,0.18955714285714284,0.23347500000000002,0.18351850382746912,0.1934274799311149,0.22083987101175365,20.0,0.3061333895977821,0.16081661040221795,-0.022976232340116642,-0.01762886491164098,-0.005347367428475663,0.015899999999999997,0.01967857142857143,4903290038.089998,-0.05879999999999999,-30.616907844630614,-90.69767441860465,9.302325581395356,10.39773912813811,1.3348164627363812,0.1896,0.1931,0.1762,0.1798,36410283.0,44079.0,16259052.0,-5.168776371308019,18.35966892400299,0.30528324310962623,0.16797675689037384,-0.02235400852104924,-0.016292023054522063,-0.006061985466527177,0.0169,0.019742857142857142,4863831321.089998,-0.091,-31.868131868131876,-92.93023255813954,7.06976744186046,10.988048545356127,0.18486666666666654,0.18483700765493824,0.19604285714285713,0.19716997324148652,0.23663000000000003,0.22490722585509612,158842.0,21568515.333333332,407177.0,22365341.57142857
2023-06-16,0.1823,0.1955,0.1804,0.1906,52221449.0,60461.0,25411071.0,0.1841999999999999,0.18548571428571428,0.23025500000000002,0.18705925191373457,0.19272060994833617,0.21795988329634852,18.72630780894616,0.30458565458155196,0.15592434541844805,-0.02253180675858696,-0.018609453281030176,-0.003922353477556782,0.015100000000000002,0.01917857142857143,4955511487.089998,-0.055400000000000005,-30.208714756499454,-82.88372093023256,17.11627906976744,11.162790697674447,4.5529347229840935,0.1798,0.1887,0.1728,0.1822,39458717.0,46214.0,19095979.0,1.3348164627363812,20.0,0.3061333895977821,0.16081661040221795,-0.022976232340116642,-0.01762886491164098,-0.005347367428475663,0.015899999999999997,0.01967857142857143,4903290038.089998,-0.05879999999999999,-30.616907844630614,-90.69767441860465,9.302325581395356,10.39773912813811,0.18386666666666654,0.18351850382746912,0.18955714285714284,0.1934274799311149,0.23347500000000002,0.22083987101175365,154854.0,21495069.0,415327.0,23296742.14285714
2023-06-17,0.1907,0.2007,0.1889,0.1976,30805626.0,38257.0,13635653.0,0.19013333333333324,0.18685714285714283,0.22672999999999996,0.19232962595686728,0.19394045746125213,0.2160208467919344,23.60387192851823,0.30018541003325433,0.1532745899667456,-0.021368432792903153,-0.019161249183404772,-0.0022071836094983803,0.011799999999999977,0.01932142857142857,4986317113.089998,-0.031200000000000006,-26.405959031657357,-76.37209302325581,23.62790697674419,16.682170542635692,3.6182485579444097,0.1823,0.1955,0.1804,0.1906,52221449.0,60461.0,25411071.0,4.5529347229840935,18.72630780894616,0.30458565458155196,0.15592434541844805,-0.02253180675858696,-0.018609453281030176,-0.003922353477556782,0.015100000000000002,0.01917857142857143,4955511487.089998,-0.055400000000000005,-30.208714756499454,-82.88372093023256,17.11627906976744,11.162790697674447,0.1841999999999999,0.18705925191373457,0.18548571428571428,0.19272060994833617,0.23025500000000002,0.21795988329634852,150754.0,20255367.333333332,434693.0,25034770.285714287
2023-06-18,0.1977,0.1977,0.1796,0.183,40434023.0,47106.0,18958060.0,0.19039999999999987,0.18685714285714286,0.22284499999999996,0.18766481297843363,0.19120534309593912,0.2128760042403216,20.05457025920873,0.2969516791506165,0.1487383208493834,-0.021378114924713226,-0.019604622331666464,-0.0017734925930467625,0.018099999999999977,0.019571428571428566,4945883090.089998,-0.0446,-32.42245199409158,-89.16750250752257,10.832497492477438,17.19222784632972,-7.435508345978752,0.1907,0.2007,0.1889,0.1976,30805626.0,38257.0,13635653.0,3.6182485579444097,23.60387192851823,0.30018541003325433,0.1532745899667456,-0.021368432792903153,-0.019161249183404772,-0.0022071836094983803,0.011799999999999977,0.01932142857142857,4986317113.089998,-0.031200000000000006,-26.405959031657357,-76.37209302325581,23.62790697674419,16.682170542635692,0.19013333333333324,0.19232962595686728,0.18685714285714283,0.19394045746125213,0.22672999999999996,0.2160208467919344,144932.0,19380901.0,354757.0,20349986.85714286
2023-06-19,0.183,0.1932,0.181,0.1896,39361579.0,41696.0,20957299.0,0.19006666666666652,0.18748571428571428,0.2185,0.1886324064892168,0.19080400732195435,0.21065924193171953,29.17341977309563,0.2894853061147591,0.1475146938852409,-0.02061557967271585,-0.019806813799876345,-0.000808765872839505,0.012200000000000016,0.017114285714285714,4985244669.089998,-0.0295,-21.32780082987552,-78.14070351758795,21.85929648241205,18.773233650544586,3.6065573770491777,0.1977,0.1977,0.1796,0.183,40434023.0,47106.0,18958060.0,-7.435508345978752,20.05457025920873,0.2969516791506165,0.1487383208493834,-0.021378114924713226,-0.019604622331666464,-0.0017734925930467625,0.018099999999999977,0.019571428571428566,4945883090.089998,-0.0446,-32.42245199409158,-89.16750250752257,10.832497492477438,17.19222784632972,0.19039999999999987,0.18766481297843363,0.18685714285714286,0.19120534309593912,0.22284499999999996,0.2128760042403216,145824.0,19334928.0,350880.0,20258044.14285714
2023-06-20,0.1897,0.1998,0.1821,0.1997,44418359.0,55571.0,21461527.0,0.19076666666666653,0.18892857142857142,0.21528999999999998,0.1941662032446084,0.19302800549146576,0.2096155046048891,31.98443579766537,0.2833782368694879,0.1472017631305121,-0.018977518382145647,-0.019640954716330206,0.0006634363341845584,0.017699999999999994,0.01701428571428571,5029663028.089998,0.011699999999999988,-18.821138211382117,-63.57615894039736,36.423841059602644,23.038545011497405,5.271481286241424,0.183,0.1932,0.181,0.1896,39361579.0,41696.0,20957299.0,3.6065573770491777,29.17341977309563,0.2894853061147591,0.1475146938852409,-0.02061557967271585,-0.019806813799876345,-0.000808765872839505,0.012200000000000016,0.017114285714285714,4985244669.089998,-0.0295,-21.32780082987552,-78.14070351758795,21.85929648241205,18.773233650544586,0.19006666666666652,0.1886324064892168,0.18748571428571428,0.19080400732195435,0.2185,0.21065924193171953,127059.0,17850337.333333332,342374.0,20492470.0
2023-06-21,0.1997,0.229,0.1989,0.222,96692530.0,116823.0,44031336.0,0.20376666666666657,0.19495714285714286,0.21326,0.2080831016223042,0.20027100411859933,0.2107949803568044,47.455089820359284,0.27773424291913373,0.14878575708086628,-0.015698951634466496,-0.018852554099957466,0.0031536024654909706,0.030100000000000016,0.01758571428571428,5126355558.089998,0.03900000000000001,-2.9720279720279685,-16.99999999999998,83.00000000000001,47.0943791806716,11.16675012518779,0.1897,0.1998,0.1821,0.1997,44418359.0,55571.0,21461527.0,5.271481286241424,31.98443579766537,0.2833782368694879,0.1472017631305121,-0.018977518382145647,-0.019640954716330206,0.0006634363341845584,0.017699999999999994,0.01701428571428571,5029663028.089998,0.011699999999999988,-18.821138211382117,-63.57615894039736,36.423841059602644,23.038545011497405,0.19076666666666653,0.1941662032446084,0.18892857142857142,0.19302800549146576,0.21528999999999998,0.2096155046048891,144373.0,20458962.0,333384.0,19396948.714285713
2023-06-22,0.222,0.2542,0.2217,0.2286,133292761.0,177402.0,65337546.0,0.21676666666666655,0.20158571428571426,0.211035,0.21834155081115209,0.2073532530889495,0.21249069651329924,50.35971223021583,0.2696162714817329,0.1524537285182671,-0.012424872824923383,-0.017567017844950652,0.005142145020027269,0.03249999999999997,0.01916428571428571,5259648319.089998,0.043399999999999994,0.4393673110720586,-31.219512195121936,68.78048780487806,62.73477628816027,2.9729729729729706,0.1997,0.229,0.1989,0.222,96692530.0,116823.0,44031336.0,11.16675012518779,47.455089820359284,0.27773424291913373,0.14878575708086628,-0.015698951634466496,-0.018852554099957466,0.0031536024654909706,0.030100000000000016,0.01758571428571428,5126355558.089998,0.03900000000000001,-2.9720279720279685,-16.99999999999998,83.00000000000001,47.0943791806716,0.20376666666666657,0.2080831016223042,0.19495714285714286,0.20027100411859933,0.21326,0.2107949803568044,214090.0,28816720.666666668,406128.0,23364417.85714286
2023-06-23,0.2287,0.2492,0.2286,0.2381,74330290.0,87395.0,34912532.0,0.22956666666666656,0.2083714285714286,0.20951499999999998,0.22822077540557606,0.21503993981671213,0.2149296777977469,56.78571428571429,0.26319037022151287,0.1558396297784871,-0.008960282614313558,-0.015845670798823236,0.006885388184509678,0.020600000000000007,0.019628571428571422,5333978609.089998,0.048500000000000015,8.671839342765875,-19.63414634146339,80.36585365853661,77.38211382113826,4.110188019239187,0.222,0.2542,0.2217,0.2286,133292761.0,177402.0,65337546.0,2.9729729729729706,50.35971223021583,0.2696162714817329,0.1524537285182671,-0.012424872824923383,-0.017567017844950652,0.005142145020027269,0.03249999999999997,0.01916428571428571,5259648319.089998,0.043399999999999994,0.4393673110720586,-31.219512195121936,68.78048780487806,62.73477628816027,0.21676666666666655,0.21834155081115209,0.20158571428571426,0.2073532530889495,0.211035,0.21249069651329924,349796.0,43610136.333333336,537316.0,29970356.0
2023-06-24,0.2381,0.2405,0.2211,0.2298,42172895.0,49780.0,18971702.0,0.23216666666666655,0.2129714285714286,0.207465,0.22901038770278803,0.2187299548625341,0.21634589895986625,67.83276450511946,0.25393297538991233,0.16099702461008766,-0.006805856863957543,-0.014037708011850098,0.007231851147892555,0.0194,0.017621428571428566,5291805714.089998,0.05000000000000002,22.2340425531915,-29.975429975429957,70.02457002457004,73.05697049599492,-3.4859302813943724,0.2287,0.2492,0.2286,0.2381,74330290.0,87395.0,34912532.0,4.110188019239187,56.78571428571429,0.26319037022151287,0.1558396297784871,-0.008960282614313558,-0.015845670798823236,0.006885388184509678,0.020600000000000007,0.019628571428571422,5333978609.089998,0.048500000000000015,8.671839342765875,-19.63414634146339,80.36585365853661,77.38211382113826,0.22956666666666656,0.22822077540557606,0.2083714285714286,0.21503993981671213,0.20951499999999998,0.2149296777977469,381620.0,48093804.666666664,564250.0,31327707.57142857
2023-06-25,0.2299,0.24,0.2253,0.2275,34223144.0,42328.0,14894874.0,0.2317999999999999,0.2193285714285714,0.20678999999999997,0.22825519385139403,0.2209224661469006,0.21740819429702185,69.43231441048036,0.25156837353943856,0.16201162646056141,-0.00522383262235146,-0.012274932933950372,0.007051100311598913,0.01469999999999999,0.01790714285714285,5257582570.089998,0.04530000000000001,24.316939890710398,-32.80098280098278,67.19901719901722,72.52981362737465,-1.043932144410607,0.2381,0.2405,0.2211,0.2298,42172895.0,49780.0,18971702.0,-3.4859302813943724,67.83276450511946,0.25393297538991233,0.16099702461008766,-0.006805856863957543,-0.014037708011850098,0.007231851147892555,0.0194,0.017621428571428566,5291805714.089998,0.05000000000000002,22.2340425531915,-29.975429975429957,70.02457002457004,73.05697049599492,0.23216666666666655,0.22901038770278803,0.2129714285714286,0.2187299548625341,0.207465,0.21634589895986625,314577.0,39740593.333333336,575773.0,32090000.285714287
2023-06-26,0.2274,0.2331,0.2152,0.2201,48076452.0,52834.0,22034520.0,0.2257999999999999,0.22368571428571427,0.20549499999999998,0.224177596925697,0.22071684961017543,0.21766455674492455,64.578111946533,0.24686732611802753,0.16412267388197244,-0.004515137474399661,-0.010722973842040231,0.00620783636764057,0.0179,0.01818571428571428,5209506118.089998,0.0295,18.844492440604753,-41.891891891891895,58.108108108108105,65.11056511056515,-3.210202286719438,0.2299,0.24,0.2253,0.2275,34223144.0,42328.0,14894874.0,-1.043932144410607,69.43231441048036,0.25156837353943856,0.16201162646056141,-0.00522383262235146,-0.012274932933950372,0.007051100311598913,0.01469999999999999,0.01790714285714285,5257582570.089998,0.04530000000000001,24.316939890710398,-32.80098280098278,67.19901719901722,72.52981362737465,0.2317999999999999,0.22825519385139403,0.2193285714285714,0.2209224661469006,0.20678999999999997,0.21740819429702185,179503.0,22926369.333333332,570995.0,31509545.14285714
2023-06-27,0.2201,0.2378,0.2188,0.234,71257385.0,63238.0,34229093.0,0.22719999999999987,0.2285857142857143,0.205755,0.22908879846284852,0.22403763720763156,0.21922031324540794,67.18266253869969,0.2478038174938006,0.1637061825061994,-0.002799605521167925,-0.009138300177865771,0.006338694656697846,0.019000000000000017,0.018707142857142856,5280763503.089998,0.036400000000000016,23.417721518987356,-24.815724815724785,75.18427518427522,66.83046683046688,6.315311222171752,0.2274,0.2331,0.2152,0.2201,48076452.0,52834.0,22034520.0,-3.210202286719438,64.578111946533,0.24686732611802753,0.16412267388197244,-0.004515137474399661,-0.010722973842040231,0.00620783636764057,0.0179,0.01818571428571428,5209506118.089998,0.0295,18.844492440604753,-41.891891891891895,58.108108108108105,65.11056511056515,0.2257999999999999,0.224177596925697,0.22368571428571427,0.22071684961017543,0.20549499999999998,0.21766455674492455,144942.0,18633698.666666668,582133.0,31663433.85714286
2023-06-28,0.2341,0.2349,0.205,0.2142,53080357.0,54758.0,24096954.0,0.22276666666666656,0.22747142857142857,0.20508500000000002,0.22164439923142426,0.22157822790572368,0.2187421881744167,62.35632183908046,0.24608211286363055,0.1640878871363695,-0.0030031106230955507,-0.007911262266911728,0.004908151643816177,0.02990000000000001,0.019635714285714284,5227683146.089998,0.031200000000000006,19.132369299221374,-49.14004914004913,50.859950859950864,61.384111384111414,-8.500640751815464,0.2201,0.2378,0.2188,0.234,71257385.0,63238.0,34229093.0,6.315311222171752,67.18266253869969,0.2478038174938006,0.1637061825061994,-0.002799605521167925,-0.009138300177865771,0.006338694656697846,0.019000000000000017,0.018707142857142856,5280763503.089998,0.036400000000000016,23.417721518987356,-24.815724815724785,75.18427518427522,66.83046683046688,0.22719999999999987,0.22908879846284852,0.2285857142857143,0.22403763720763156,0.205755,0.21922031324540794,158400.0,23719495.666666668,589800.0,33487371.85714286
2023-06-29,0.2143,0.225,0.2139,0.2182,28009285.0,27472.0,13187265.0,0.2221333333333332,0.2259857142857143,0.20503999999999997,0.21992219961571213,0.22073367092929275,0.21869055120542463,62.78409090909091,0.24597426823316665,0.1641057317668333,-0.0028092401402970146,-0.006890857841588786,0.004081617701291771,0.011099999999999999,0.019292857142857143,5255692431.089998,0.028600000000000014,19.75850713501648,-48.25737265415548,51.74262734584452,59.2622844633569,1.819878674755023,0.2341,0.2349,0.205,0.2142,53080357.0,54758.0,24096954.0,-8.500640751815464,62.35632183908046,0.24608211286363055,0.1640878871363695,-0.0030031106230955507,-0.007911262266911728,0.004908151643816177,0.02990000000000001,0.019635714285714284,5227683146.089998,0.031200000000000006,19.132369299221374,-49.14004914004913,50.859950859950864,61.384111384111414,0.22276666666666656,0.22164439923142426,0.22747142857142857,0.22157822790572368,0.20508500000000002,0.2187421881744167,170830.0,26786855.666666668,527735.0,30639603.0
2023-06-30,0.218,0.2315,0.2051,0.2272,83043558.0,73734.0,39585915.0,0.21986666666666657,0.22442857142857142,0.207,0.22356109980785607,0.22235025319696955,0.21950097490014608,62.94200848656294,0.24825157732225928,0.1657484226777407,-0.001907384461291961,-0.005894163165529422,0.003986778704237461,0.026400000000000007,0.0201,5338735989.089998,0.027500000000000024,19.202518363064016,-36.19302949061659,63.80697050938341,55.469849571726286,4.220183486238539,0.2143,0.225,0.2139,0.2182,28009285.0,27472.0,13187265.0,1.819878674755023,62.78409090909091,0.24597426823316665,0.1641057317668333,-0.0028092401402970146,-0.006890857841588786,0.004081617701291771,0.011099999999999999,0.019292857142857143,5255692431.089998,0.028600000000000014,19.75850713501648,-48.25737265415548,51.74262734584452,59.2622844633569,0.2221333333333332,0.21992219961571213,0.2259857142857143,0.22073367092929275,0.20503999999999997,0.21869055120542463,145468.0,23837770.666666668,377805.0,23189562.85714286
2023-07-01,0.2271,0.2413,0.2221,0.2366,63579264.0,51922.0,30843020.0,0.22733333333333325,0.22540000000000002,0.20968,0.23008054990392804,0.22591268989772717,0.22112945348108454,63.56050069541028,0.25132903992064176,0.16803096007935825,-0.0004292082516863527,-0.0048011721827608085,0.004371963931074456,0.019199999999999995,0.020628571428571423,5402315253.089998,0.014600000000000002,19.736842105263165,-23.592493297587108,76.40750670241289,63.98570151921363,4.183179216204319,0.218,0.2315,0.2051,0.2272,83043558.0,73734.0,39585915.0,4.220183486238539,62.94200848656294,0.24825157732225928,0.1657484226777407,-0.001907384461291961,-0.005894163165529422,0.003986778704237461,0.026400000000000007,0.0201,5338735989.089998,0.027500000000000024,19.202518363064016,-36.19302949061659,63.80697050938341,55.469849571726286,0.21986666666666657,0.22356109980785607,0.22442857142857142,0.22235025319696955,0.207,0.21950097490014608,155964.0,25623378.0,364144.0,23857189.0
2023-07-02,0.2366,0.2385,0.2255,0.2359,42961838.0,40682.0,18864335.0,0.23323333333333326,0.2266,0.212215,0.232990274951964,0.22840951742329538,0.22253617219717173,70.3618167821401,0.2537620449895522,0.17066795501044782,0.0006779578185366897,-0.003705346182501309,0.004383304001037999,0.012999999999999984,0.020264285714285714,5359353415.089998,0.007300000000000001,28.907103825136616,-24.999999999999982,75.00000000000003,71.7381590705988,-0.2958579881656831,0.2271,0.2413,0.2221,0.2366,63579264.0,51922.0,30843020.0,4.183179216204319,63.56050069541028,0.25132903992064176,0.16803096007935825,-0.0004292082516863527,-0.0048011721827608085,0.004371963931074456,0.019199999999999995,0.020628571428571423,5402315253.089998,0.014600000000000002,19.736842105263165,-23.592493297587108,76.40750670241289,63.98570151921363,0.22733333333333325,0.23008054990392804,0.22540000000000002,0.22591268989772717,0.20968,0.22112945348108454,153128.0,27872066.666666668,366286.0,25553091.57142857
2023-07-03,0.2359,0.251,0.2359,0.2453,56303241.0,52663.0,27352140.0,0.23926666666666654,0.2302,0.215,0.23914513747598198,0.23263213806747152,0.22470415579744107,70.98718914845514,0.25761776254340446,0.1723822374565955,0.0022875271576739686,-0.002506771514466254,0.004794298672140223,0.015100000000000002,0.020471428571428568,5415656656.089998,0.007199999999999984,29.37763713080168,-12.343966712898744,87.65603328710125,79.68784666317141,3.9847392963119934,0.2366,0.2385,0.2255,0.2359,42961838.0,40682.0,18864335.0,-0.2958579881656831,70.3618167821401,0.2537620449895522,0.17066795501044782,0.0006779578185366897,-0.003705346182501309,0.004383304001037999,0.012999999999999984,0.020264285714285714,5359353415.089998,0.007300000000000001,28.907103825136616,-24.999999999999982,75.00000000000003,71.7381590705988,0.23323333333333326,0.232990274951964,0.2266,0.22840951742329538,0.212215,0.22253617219717173,166338.0,29764423.333333332,364640.0,26120157.42857143
2023-07-04,0.2452,0.2494,0.2338,0.2386,52852127.0,44273.0,24585754.0,0.23993333333333322,0.23085714285714284,0.21794000000000002,0.238872568737991,0.23412410355060365,0.22602756953101813,65.04253673627224,0.25839100480172533,0.1774889951982747,0.002988044136682688,-0.0014078083842364655,0.004395852520919154,0.015600000000000003,0.020321428571428574,5362804529.089998,0.008800000000000002,19.479218828242374,-28.20976491862564,71.79023508137436,78.14875612282523,-2.691680261011417,0.2359,0.251,0.2359,0.2453,56303241.0,52663.0,27352140.0,3.9847392963119934,70.98718914845514,0.25761776254340446,0.1723822374565955,0.0022875271576739686,-0.002506771514466254,0.004794298672140223,0.015100000000000002,0.020471428571428568,5415656656.089998,0.007199999999999984,29.37763713080168,-12.343966712898744,87.65603328710125,79.68784666317141,0.23926666666666654,0.23914513747598198,0.2302,0.23263213806747152,0.215,0.22470415579744107,145267.0,25686498.333333332,364469.0,26879817.42857143
2023-07-05,0.2387,0.2429,0.2228,0.2263,37567241.0,35717.0,18415996.0,0.23673333333333324,0.23258571428571426,0.22014499999999998,0.2325862843689955,0.23216807766295272,0.22605351528996878,51.802179379715,0.2570450057052594,0.18324499429474056,0.002521633859419614,-0.0006219199355052496,0.0031435537949248637,0.020100000000000007,0.019607142857142854,5325237288.089998,-0.0012000000000000066,1.9369369369369283,-56.70731707317071,43.2926829268293,67.57965043176831,-5.194805194805192,0.2452,0.2494,0.2338,0.2386,52852127.0,44273.0,24585754.0,-2.691680261011417,65.04253673627224,0.25839100480172533,0.1774889951982747,0.002988044136682688,-0.0014078083842364655,0.004395852520919154,0.015600000000000003,0.020321428571428574,5362804529.089998,0.008800000000000002,19.479218828242374,-28.20976491862564,71.79023508137436,78.14875612282523,0.23993333333333322,0.238872568737991,0.23085714285714284,0.23412410355060365,0.21794000000000002,0.22602756953101813,137618.0,23600743.0,345504.0,25502197.57142857
2023-07-06,0.2264,0.2366,0.2126,0.2132,46958669.0,43759.0,23873041.0,0.22603333333333323,0.23187142857142856,0.22127500000000003,0.22289314218449774,0.22742605824721457,0.22482937097663844,43.879173290938,0.255664219546948,0.18688578045305204,0.001082461888807007,-0.0002810435706427983,0.0013635054594498053,0.023999999999999994,0.019,5278278619.089998,-0.0068999999999999895,-6.73665791776028,-82.17391304347824,17.82608695652176,44.30300165490849,-5.8303886925795005,0.2387,0.2429,0.2228,0.2263,37567241.0,35717.0,18415996.0,-5.194805194805192,51.802179379715,0.2570450057052594,0.18324499429474056,0.002521633859419614,-0.0006219199355052496,0.0031435537949248637,0.020100000000000007,0.019607142857142854,5325237288.089998,-0.0012000000000000066,1.9369369369369283,-56.70731707317071,43.2926829268293,67.57965043176831,0.23673333333333324,0.2325862843689955,0.23258571428571426,0.23216807766295272,0.22014499999999998,0.22605351528996878,132653.0,23451296.666666668,326463.0,24690632.14285714
2023-07-07,0.2129,0.2241,0.2105,0.2234,32923187.0,30209.0,16558443.0,0.22096666666666653,0.2313285714285714,0.22256499999999999,0.22314657109224886,0.22641954368541095,0.22469324040743477,44.189723320158095,0.2551005368465054,0.19002946315349456,0.0007562449672295357,-7.358586306833149e-05,0.0008298308302978672,0.013600000000000001,0.0185,5311201806.089998,-0.010600000000000026,-6.173876522469557,-60.00000000000001,39.999999999999986,33.7062566277837,4.931892907468286,0.2264,0.2366,0.2126,0.2132,46958669.0,43759.0,23873041.0,-5.8303886925795005,43.879173290938,0.255664219546948,0.18688578045305204,0.001082461888807007,-0.0002810435706427983,0.0013635054594498053,0.023999999999999994,0.019,5278278619.089998,-0.0068999999999999895,-6.73665791776028,-82.17391304347824,17.82608695652176,44.30300165490849,0.22603333333333323,0.22289314218449774,0.23187142857142856,0.22742605824721457,0.22127500000000003,0.22482937097663844,123749.0,22291597.0,342750.0,26217171.57142857
2023-07-08,0.2233,0.226,0.2148,0.2193,22486613.0,21640.0,10542554.0,0.21863333333333324,0.22885714285714287,0.22437999999999997,0.22122328554612442,0.2246396577640582,0.22417959846386956,45.70727718724448,0.2511639386277793,0.19759606137222063,0.00016497820568328603,-2.587304931800799e-05,0.00019085125500129403,0.011200000000000015,0.017914285714285716,5288715193.089998,0.005099999999999993,-4.5691906005222,-68.91304347826086,31.08695652173914,29.637681159420314,-1.791312136139724,0.2129,0.2241,0.2105,0.2234,32923187.0,30209.0,16558443.0,4.931892907468286,44.189723320158095,0.2551005368465054,0.19002946315349456,0.0007562449672295357,-7.358586306833149e-05,0.0008298308302978672,0.013600000000000001,0.0185,5311201806.089998,-0.010600000000000026,-6.173876522469557,-60.00000000000001,39.999999999999986,33.7062566277837,0.22096666666666653,0.22314657109224886,0.2313285714285714,0.22641954368541095,0.22256499999999999,0.22469324040743477,109685.0,19615826.666666668,299225.0,22927532.714285713
2023-07-09,0.2193,0.221,0.2161,0.2171,15476920.0,13666.0,7546666.0,0.2199333333333332,0.22617142857142855,0.225755,0.21916164277306222,0.22275474332304365,0.22350535099112007,45.74468085106382,0.24734003136302984,0.20416996863697018,-0.0004756436525729657,-0.00011582716996899953,-0.0003598164826039662,0.0049000000000000155,0.017214285714285717,5273238273.089998,-0.0011000000000000176,-4.571428571428582,-73.69565217391305,26.30434782608695,32.463768115942045,-1.0031919744642077,0.2233,0.226,0.2148,0.2193,22486613.0,21640.0,10542554.0,-1.791312136139724,45.70727718724448,0.2511639386277793,0.19759606137222063,0.00016497820568328603,-2.587304931800799e-05,0.00019085125500129403,0.011200000000000015,0.017914285714285716,5288715193.089998,0.005099999999999993,-4.5691906005222,-68.91304347826086,31.08695652173914,29.637681159420314,0.21863333333333324,0.22122328554612442,0.22885714285714287,0.2246396577640582,0.22437999999999997,0.22417959846386956,95608.0,16991346.0,268943.0,20027466.14285714
2023-07-10,0.2172,0.2189,0.2085,0.2152,32412689.0,26802.0,15464057.0,0.21719999999999987,0.22187142857142855,0.22653000000000004,0.2171808213865311,0.22086605749228272,0.22271436518244198,47.90059982862041,0.2450750915621427,0.20798490843785739,-0.0011237018759637785,-0.0003174021111679553,-0.0008062997647958231,0.01040000000000002,0.016678571428571435,5240825584.089998,-0.01200000000000001,-2.22626079054975,-77.8260869565217,22.173913043478287,26.52173913043481,-0.9208103130755072,0.2193,0.221,0.2161,0.2171,15476920.0,13666.0,7546666.0,-1.0031919744642077,45.74468085106382,0.24734003136302984,0.20416996863697018,-0.0004756436525729657,-0.00011582716996899953,-0.0003598164826039662,0.0049000000000000155,0.017214285714285717,5273238273.089998,-0.0011000000000000176,-4.571428571428582,-73.69565217391305,26.30434782608695,32.463768115942045,0.2199333333333332,0.21916164277306222,0.22617142857142855,0.22275474332304365,0.225755,0.22350535099112007,65515.0,11549221.0,241927.0,18410656.285714287
2023-07-11,0.2152,0.219,0.2112,0.2138,21237337.0,20861.0,10482808.0,0.21536666666666657,0.21832857142857143,0.22612000000000002,0.21549041069326555,0.21909954311921204,0.2218653780222094,40.307101727447204,0.24543343682778604,0.206806563172214,-0.0017303149925695371,-0.0005999846874482717,-0.0011303303051212654,0.007800000000000001,0.015878571428571433,5219588247.089998,-0.022800000000000015,-8.632478632478646,-80.8695652173913,19.130434782608695,22.536231884057997,-0.6505576208178496,0.2172,0.2189,0.2085,0.2152,32412689.0,26802.0,15464057.0,-0.9208103130755072,47.90059982862041,0.2450750915621427,0.20798490843785739,-0.0011237018759637785,-0.0003174021111679553,-0.0008062997647958231,0.01040000000000002,0.016678571428571435,5240825584.089998,-0.01200000000000001,-2.22626079054975,-77.8260869565217,22.173913043478287,26.52173913043481,0.21719999999999987,0.2171808213865311,0.22187142857142855,0.22086605749228272,0.22653000000000004,0.22271436518244198,62108.0,11184425.666666666,216066.0,16712358.714285715
2023-07-12,0.2139,0.2214,0.21,0.2195,47627396.0,38667.0,23862013.0,0.21616666666666653,0.21735714285714286,0.225665,0.21749520534663278,0.21919965733940905,0.2216401039248561,52.94117647058823,0.24516034627318536,0.20616965372681464,-0.0017311621352940343,-0.0008262201770174243,-0.00090494195827661,0.011400000000000021,0.014557142857142862,5267215643.089998,-0.016399999999999998,2.474323062558348,-68.62745098039215,31.37254901960784,24.22563228189829,2.6180458158017736,0.2152,0.219,0.2112,0.2138,21237337.0,20861.0,10482808.0,-0.6505576208178496,40.307101727447204,0.24543343682778604,0.206806563172214,-0.0017303149925695371,-0.0005999846874482717,-0.0011303303051212654,0.007800000000000001,0.015878571428571433,5219588247.089998,-0.022800000000000015,-8.632478632478646,-80.8695652173913,19.130434782608695,22.536231884057997,0.21536666666666657,0.21549041069326555,0.21832857142857143,0.21909954311921204,0.22612000000000002,0.2218653780222094,61329.0,11164510.333333334,192654.0,14697652.142857144
2023-07-13,0.2194,0.2373,0.2151,0.2333,87246275.0,80008.0,42237548.0,0.22219999999999987,0.22022857142857144,0.225425,0.22539760267331638,0.2227247430045568,0.22275057021772696,57.55755755755755,0.2443866649278937,0.20646333507210626,-0.0006112428068269782,-0.0007832247029793351,0.00017198189615235694,0.022199999999999998,0.015350000000000004,5354461918.089998,-0.011999999999999983,6.920256645279554,-38.562091503267965,61.43790849673204,37.313630766316216,6.335460346399269,0.2139,0.2214,0.21,0.2195,47627396.0,38667.0,23862013.0,2.6180458158017736,52.94117647058823,0.24516034627318536,0.20616965372681464,-0.0017311621352940343,-0.0008262201770174243,-0.00090494195827661,0.011400000000000021,0.014557142857142862,5267215643.089998,-0.016399999999999998,2.474323062558348,-68.62745098039215,31.37254901960784,24.22563228189829,0.21616666666666653,0.21749520534663278,0.21735714285714286,0.21919965733940905,0.225665,0.2216401039248561,86330.0,16602959.333333334,195604.0,15475654.57142857
2023-07-14,0.2334,0.2559,0.2247,0.2374,94628183.0,82853.0,47857872.0,0.23006666666666656,0.22222857142857144,0.22580499999999998,0.2313988013366582,0.2263935572534176,0.22414575400651485,55.36842105263157,0.24542888179840366,0.2061811182015963,0.0006002181235313098,-0.0005065361376772061,0.001106754261208516,0.031200000000000006,0.015692857142857147,5449090101.089998,-0.0012000000000000066,4.489436619718301,-39.02953586497892,60.97046413502108,51.260307217120335,1.7137960582690674,0.2194,0.2373,0.2151,0.2333,87246275.0,80008.0,42237548.0,6.335460346399269,57.55755755755755,0.2443866649278937,0.20646333507210626,-0.0006112428068269782,-0.0007832247029793351,0.00017198189615235694,0.022199999999999998,0.015350000000000004,5354461918.089998,-0.011999999999999983,6.920256645279554,-38.562091503267965,61.43790849673204,37.313630766316216,0.22219999999999987,0.22539760267331638,0.22022857142857144,0.2227247430045568,0.225425,0.22275057021772696,139536.0,25527456.333333332,231853.0,18099155.57142857
2023-07-15,0.2373,0.2465,0.2307,0.2414,44789484.0,38259.0,21845008.0,0.2373666666666666,0.22538571428571427,0.22649999999999998,0.2363994006683291,0.23014516794006318,0.22578901552970393,52.67857142857143,0.2473244795220443,0.20567552047795565,0.0018616166516065291,-3.2905579820459126e-05,0.0018945222314269883,0.01580000000000001,0.015450000000000005,5493879585.089998,0.015100000000000002,2.0287404902789463,-30.590717299578067,69.40928270042193,63.93921844405836,1.7277707543194236,0.2334,0.2559,0.2247,0.2374,94628183.0,82853.0,47857872.0,1.7137960582690674,55.36842105263157,0.24542888179840366,0.2061811182015963,0.0006002181235313098,-0.0005065361376772061,0.001106754261208516,0.031200000000000006,0.015692857142857147,5449090101.089998,-0.0012000000000000066,4.489436619718301,-39.02953586497892,60.97046413502108,51.260307217120335,0.23006666666666656,0.2313988013366582,0.22222857142857144,0.2263935572534176,0.22580499999999998,0.22414575400651485,201528.0,37985811.0,284497.0,22570502.57142857
2023-07-16,0.2415,0.2485,0.2341,0.2358,45567570.0,37556.0,21366322.0,0.23819999999999988,0.22805714285714287,0.22728500000000001,0.23609970033416455,0.23155887595504737,0.22674244262211307,49.94708994708995,0.2482766549834214,0.20629334501657862,0.0023819532003651056,0.00045006617621665384,0.0019318870241484517,0.014399999999999996,0.015550000000000007,5448312015.089998,0.02260000000000001,-0.04239084357777756,-42.405063291139236,57.594936708860764,62.65822784810127,-2.360248447204962,0.2373,0.2465,0.2307,0.2414,44789484.0,38259.0,21845008.0,1.7277707543194236,52.67857142857143,0.2473244795220443,0.20567552047795565,0.0018616166516065291,-3.2905579820459126e-05,0.0018945222314269883,0.01580000000000001,0.015450000000000005,5493879585.089998,0.015100000000000002,2.0287404902789463,-30.590717299578067,69.40928270042193,63.93921844405836,0.2373666666666666,0.2363994006683291,0.22538571428571427,0.23014516794006318,0.22649999999999998,0.22578901552970393,201120.0,37313476.0,301116.0,24185138.85714286
2023-07-17,0.2355,0.2463,0.2282,0.236,50378180.0,42285.0,24385017.0,0.2377333333333332,0.23102857142857142,0.227385,0.23604985016708227,0.23266915696628554,0.2276241147533404,44.54865181711605,0.2485298413516183,0.20624015864838172,0.0027784339357130594,0.000915739728115935,0.0018626942075971244,0.018100000000000005,0.01576428571428572,5498690195.089998,0.0126,-3.7912759885854075,-41.98312236286924,58.01687763713076,61.673699015471165,0.21231422505307876,0.2415,0.2485,0.2341,0.2358,45567570.0,37556.0,21366322.0,-2.360248447204962,49.94708994708995,0.2482766549834214,0.20629334501657862,0.0023819532003651056,0.00045006617621665384,0.0019318870241484517,0.014399999999999996,0.015550000000000007,5448312015.089998,0.02260000000000001,-0.04239084357777756,-42.405063291139236,57.594936708860764,62.65822784810127,0.23819999999999988,0.23609970033416455,0.22805714285714287,0.23155887595504737,0.22728500000000001,0.22674244262211307,158668.0,30356400.666666668,325006.0,26159375.42857143
2023-07-18,0.2362,0.239,0.2207,0.2254,31656003.0,26380.0,14962535.0,0.23239999999999986,0.2326857142857143,0.227945,0.23072492508354114,0.23085186772471417,0.2274122943006413,42.60089686098654,0.2481938180290749,0.20769618197092513,0.00221181988009439,0.001174955758511626,0.001036864121582764,0.018299999999999983,0.01595714285714286,5467034192.089998,0.006099999999999994,-5.5322715842414105,-64.34599156118146,35.65400843881854,50.42194092827003,-4.572396274343778,0.2355,0.2463,0.2282,0.236,50378180.0,42285.0,24385017.0,0.21231422505307876,44.54865181711605,0.2485298413516183,0.20624015864838172,0.0027784339357130594,0.000915739728115935,0.0018626942075971244,0.018100000000000005,0.01576428571428572,5498690195.089998,0.0126,-3.7912759885854075,-41.98312236286924,58.01687763713076,61.673699015471165,0.2377333333333332,0.23604985016708227,0.23102857142857142,0.23266915696628554,0.227385,0.2276241147533404,118100.0,22532115.666666668,340489.0,27433798.285714287
2023-07-19,0.2253,0.2314,0.2234,0.2248,33053725.0,27405.0,15176504.0,0.22873333333333323,0.23344285714285715,0.228275,0.22776246254177057,0.2293389007935356,0.22716350436724692,49.032258064516135,0.2480650426848789,0.20848495731512112,0.0016948223165174081,0.0012789290701127826,0.0004158932464046255,0.008000000000000007,0.015092857142857147,5433980467.089998,0.007700000000000012,-0.6628369421122438,-65.61181434599156,34.38818565400844,42.686357243319264,-0.22192632046160693,0.2362,0.239,0.2207,0.2254,31656003.0,26380.0,14962535.0,-4.572396274343778,42.60089686098654,0.2481938180290749,0.20769618197092513,0.00221181988009439,0.001174955758511626,0.001036864121582764,0.018299999999999983,0.01595714285714286,5467034192.089998,0.006099999999999994,-5.5322715842414105,-64.34599156118146,35.65400843881854,50.42194092827003,0.23239999999999986,0.23072492508354114,0.2326857142857143,0.23085186772471417,0.227945,0.2274122943006413,106221.0,20237958.0,346008.0,28073759.285714287
2023-07-20,0.2249,0.2317,0.2187,0.2228,31688144.0,26625.0,14581942.0,0.2243333333333332,0.23194285714285715,0.22805499999999998,0.22528123127088528,0.22770417559515171,0.2267479325227472,57.22891566265061,0.24799263698176627,0.2081173630182337,0.001110908871361449,0.001245325030362516,-0.00013441615900106692,0.012999999999999984,0.014307142857142862,5402292323.089998,0.007599999999999996,4.502814258911814,-69.83122362869199,30.168776371308013,33.40365682137835,-0.9337483325922592,0.2253,0.2314,0.2234,0.2248,33053725.0,27405.0,15176504.0,-0.22192632046160693,49.032258064516135,0.2480650426848789,0.20848495731512112,0.0016948223165174081,0.0012789290701127826,0.0004158932464046255,0.008000000000000007,0.015092857142857147,5433980467.089998,0.007700000000000012,-0.6628369421122438,-65.61181434599156,34.38818565400844,42.686357243319264,0.22873333333333323,0.22776246254177057,0.23344285714285715,0.2293389007935356,0.228275,0.22716350436724692,96070.0,18174685.333333332,334746.0,26832972.285714287
2023-07-21,0.2225,0.2265,0.2202,0.225,18412090.0,15327.0,8954434.0,0.22419999999999987,0.2301714285714286,0.227475,0.22514061563544263,0.2270281316963638,0.22658146275867605,51.36986301369865,0.24703735643958363,0.2079126435604164,0.0008162654727764673,0.0011595131188453062,-0.0003432476460688389,0.0063,0.01378571428571429,5420704413.089998,0.011200000000000015,0.71620411817368,-65.18987341772151,34.81012658227849,33.12236286919833,1.1235955056179785,0.2249,0.2317,0.2187,0.2228,31688144.0,26625.0,14581942.0,-0.9337483325922592,57.22891566265061,0.24799263698176627,0.2081173630182337,0.001110908871361449,0.001245325030362516,-0.00013441615900106692,0.012999999999999984,0.014307142857142862,5402292323.089998,0.007599999999999996,4.502814258911814,-69.83122362869199,30.168776371308013,33.40365682137835,0.2243333333333332,0.22528123127088528,0.23194285714285715,0.22770417559515171,0.22805499999999998,0.2267479325227472,80410.0,14906993.666666666,281363.0,22882171.42857143
2023-07-22,0.2249,0.2273,0.2173,0.2197,19746654.0,15594.0,8881159.0,0.2224999999999999,0.2270714285714286,0.22666499999999998,0.22242030781772132,0.22519609877227284,0.22592608535308784,50.33557046979867,0.24609967059273852,0.20723032940726144,0.00015332531180214937,0.0009582755574366749,-0.0008049502456345255,0.010000000000000009,0.013700000000000004,5400957759.089998,0.00020000000000000573,0.18239854081167906,-76.37130801687762,23.628691983122383,29.53586497890298,-2.3121387283236916,0.2225,0.2265,0.2202,0.225,18412090.0,15327.0,8954434.0,1.1235955056179785,51.36986301369865,0.24703735643958363,0.2079126435604164,0.0008162654727764673,0.0011595131188453062,-0.0003432476460688389,0.0063,0.01378571428571429,5420704413.089998,0.011200000000000015,0.71620411817368,-65.18987341772151,34.81012658227849,33.12236286919833,0.22419999999999987,0.22514061563544263,0.2301714285714286,0.2270281316963638,0.227475,0.22658146275867605,69357.0,12904293.333333334,213837.0,17324537.42857143
2023-07-23,0.2199,0.2257,0.2174,0.2236,18250519.0,14606.0,8520646.0,0.22276666666666656,0.22532857142857146,0.22558000000000003,0.22301015390886064,0.22479707407920463,0.2257045534146985,55.301794453507355,0.24294719230090647,0.2082128076990936,-5.670843610422471e-05,0.000755278758728495,-0.0008119871948327197,0.008300000000000002,0.013942857142857146,5419208278.089998,-0.009700000000000014,2.9940119760479167,-68.14345991561183,31.856540084388175,30.098452883263032,1.6825829922692044,0.2249,0.2273,0.2173,0.2197,19746654.0,15594.0,8881159.0,-2.3121387283236916,50.33557046979867,0.24609967059273852,0.20723032940726144,0.00015332531180214937,0.0009582755574366749,-0.0008049502456345255,0.010000000000000009,0.013700000000000004,5400957759.089998,0.00020000000000000573,0.18239854081167906,-76.37130801687762,23.628691983122383,29.53586497890298,0.2224999999999999,0.22242030781772132,0.2270714285714286,0.22519609877227284,0.22666499999999998,0.22592608535308784,57546.0,10805845.0,191172.0,15472559.0
2023-07-24,0.2235,0.2261,0.2083,0.2123,40384348.0,30151.0,17762499.0,0.21853333333333325,0.22194285714285716,0.224265,0.21765507695443032,0.22167280555940344,0.2244279292799653,47.949080622347935,0.24146319757985105,0.20706680242014894,-0.0011220430427419381,0.0003798143984344084,-0.0015018574411763464,0.017799999999999983,0.01447142857142857,5378823930.089998,-0.02510000000000001,-1.347583643122685,-91.59663865546224,8.403361344537764,21.29619780401612,-5.011185682326628,0.2199,0.2257,0.2174,0.2236,18250519.0,14606.0,8520646.0,1.6825829922692044,55.301794453507355,0.24294719230090647,0.2082128076990936,-5.670843610422471e-05,0.000755278758728495,-0.0008119871948327197,0.008300000000000002,0.013942857142857146,5419208278.089998,-0.009700000000000014,2.9940119760479167,-68.14345991561183,31.856540084388175,30.098452883263032,0.22276666666666656,0.22301015390886064,0.22532857142857146,0.22479707407920463,0.22558000000000003,0.2257045534146985,45527.0,8785413.0,168222.0,13637462.42857143
2023-07-25,0.2123,0.2136,0.2075,0.2098,17974868.0,14585.0,8313149.0,0.21523333333333325,0.21971428571428572,0.22344,0.21372753847721515,0.21870460416955256,0.22303479315806385,47.21448467966573,0.2417727604374994,0.2051072395625006,-0.0021433502924695647,-0.0001248185397463862,-0.0020185317527231786,0.006100000000000022,0.014350000000000002,5360849062.089998,-0.03160000000000002,-1.8709073900841977,-95.24793388429754,4.75206611570247,15.003989181542819,-1.1775788977861528,0.2235,0.2261,0.2083,0.2123,40384348.0,30151.0,17762499.0,-5.011185682326628,47.949080622347935,0.24146319757985105,0.20706680242014894,-0.0011220430427419381,0.0003798143984344084,-0.0015018574411763464,0.017799999999999983,0.01447142857142857,5378823930.089998,-0.02510000000000001,-1.347583643122685,-91.59663865546224,8.403361344537764,21.29619780401612,0.21853333333333325,0.21765507695443032,0.22194285714285716,0.22167280555940344,0.224265,0.2244279292799653,60351.0,11721434.666666666,156088.0,12691388.42857143
2023-07-26,0.2099,0.2149,0.2045,0.2118,22392064.0,19009.0,10668441.0,0.2112999999999999,0.2178571428571429,0.22336999999999999,0.21276376923860757,0.2169784531271644,0.22196481285729586,44.34654919236415,0.2418772503572264,0.20486274964277357,-0.002759549986216636,-0.0006517648290404362,-0.0021077851571762,0.01040000000000002,0.01427857142857143,5383241126.089998,-0.02400000000000002,-3.5079726651480736,-85.7976653696498,14.202334630350189,9.119254030196823,0.9051929490233374,0.2123,0.2136,0.2075,0.2098,17974868.0,14585.0,8313149.0,-1.1775788977861528,47.21448467966573,0.2417727604374994,0.2051072395625006,-0.0021433502924695647,-0.0001248185397463862,-0.0020185317527231786,0.006100000000000022,0.014350000000000002,5360849062.089998,-0.03160000000000002,-1.8709073900841977,-95.24793388429754,4.75206611570247,15.003989181542819,0.21523333333333325,0.21372753847721515,0.21971428571428572,0.21870460416955256,0.22344,0.22303479315806385,59342.0,11532098.0,144293.0,11741476.142857144
2023-07-27,0.2118,0.2179,0.2098,0.2147,21202762.0,15726.0,10653976.0,0.21209999999999987,0.21669999999999998,0.22293500000000002,0.21373188461930379,0.21640883984537332,0.22127292591850578,33.74125874125873,0.24184389793320094,0.2040261020667991,-0.002979540629622829,-0.0011173199891569149,-0.001862220640465914,0.008100000000000024,0.013271428571428575,5404443888.089998,-0.021299999999999986,-7.972567509644235,-80.15564202334629,19.844357976653715,12.932919574235472,1.3692162417374947,0.2099,0.2149,0.2045,0.2118,22392064.0,19009.0,10668441.0,0.9051929490233374,44.34654919236415,0.2418772503572264,0.20486274964277357,-0.002759549986216636,-0.0006517648290404362,-0.0021077851571762,0.01040000000000002,0.01427857142857143,5383241126.089998,-0.02400000000000002,-3.5079726651480736,-85.7976653696498,14.202334630350189,9.119254030196823,0.2112999999999999,0.21276376923860757,0.2178571428571429,0.2169784531271644,0.22336999999999999,0.22196481285729586,63745.0,12248029.666666666,135897.0,11097467.142857144
2023-07-28,0.2147,0.2174,0.2125,0.2159,17430371.0,12471.0,8141752.0,0.2141333333333332,0.21539999999999998,0.22276500000000002,0.2148159423096519,0.21628162988403,0.2207612186881719,30.20257826887662,0.24187160122894422,0.20365839877105582,-0.0030222165966262704,-0.0014982993106507862,-0.0015239172859754842,0.0049000000000000155,0.011392857142857147,5421874259.089998,-0.00949999999999998,-9.056444818871102,-74.09090909090905,25.90909090909095,19.98526117203163,0.5589194224499332,0.2118,0.2179,0.2098,0.2147,21202762.0,15726.0,10653976.0,1.3692162417374947,33.74125874125873,0.24184389793320094,0.2040261020667991,-0.002979540629622829,-0.0011173199891569149,-0.001862220640465914,0.008100000000000024,0.013271428571428575,5404443888.089998,-0.021299999999999986,-7.972567509644235,-80.15564202334629,19.844357976653715,12.932919574235472,0.21209999999999987,0.21373188461930379,0.21669999999999998,0.21640883984537332,0.22293500000000002,0.22127292591850578,49320.0,9878522.0,124998.0,10536329.142857144
2023-07-29,0.2159,0.2181,0.2139,0.2149,14019249.0,9695.0,6747592.0,0.2151666666666666,0.2147142857142857,0.222655,0.21485797115482597,0.2159362224130225,0.22020300738453646,24.17153996101365,0.2419235699902525,0.2033864300097475,-0.0031009830483055834,-0.0018188360581817458,-0.0012821469901238376,0.0041999999999999815,0.010564285714285717,5407855010.089998,-0.009899999999999992,-10.977630488815237,-76.36363636363632,23.636363636363676,23.12993750736946,-0.4631773969430296,0.2147,0.2174,0.2125,0.2159,17430371.0,12471.0,8141752.0,0.5589194224499332,30.20257826887662,0.24187160122894422,0.20365839877105582,-0.0030222165966262704,-0.0014982993106507862,-0.0015239172859754842,0.0049000000000000155,0.011392857142857147,5421874259.089998,-0.00949999999999998,-9.056444818871102,-74.09090909090905,25.90909090909095,19.98526117203163,0.2141333333333332,0.2148159423096519,0.21539999999999998,0.21628162988403,0.22276500000000002,0.2207612186881719,47206.0,9821389.666666666,122142.0,10420231.714285715
2023-07-30,0.2149,0.215,0.2034,0.21,19497956.0,16551.0,9341132.0,0.2135999999999999,0.21277142857142856,0.22239499999999998,0.21242898557741297,0.21445216680976686,0.219231292395533,24.505928853754924,0.2422194373384226,0.20257056266157736,-0.003518239008472507,-0.002158716648239898,-0.0013595223602326087,0.0116,0.010364285714285717,5388357054.089998,-0.012800000000000006,-10.941475826972013,-84.61538461538463,15.384615384615374,21.643356643356682,-2.2801302931596164,0.2159,0.2181,0.2139,0.2149,14019249.0,9695.0,6747592.0,-0.4631773969430296,24.17153996101365,0.2419235699902525,0.2033864300097475,-0.0031009830483055834,-0.0018188360581817458,-0.0012821469901238376,0.0041999999999999815,0.010564285714285717,5407855010.089998,-0.009899999999999992,-10.977630488815237,-76.36363636363632,23.636363636363676,23.12993750736946,0.2151666666666666,0.21485797115482597,0.2147142857142857,0.2159362224130225,0.222655,0.22020300738453646,37892.0,8514440.0,116243.0,10115436.42857143
2023-07-31,0.21,0.2123,0.2063,0.2079,20287635.0,15602.0,9779002.0,0.21093333333333322,0.21214285714285713,0.22210000000000002,0.21016449278870647,0.21281412510732514,0.21815212169119652,23.23809523809527,0.2426261322527827,0.20157386774721733,-0.003972576424461166,-0.002521488603484152,-0.001451087820977014,0.005999999999999978,0.0095,5368069419.089998,-0.017100000000000004,-11.906779661016941,-87.35955056179773,12.64044943820226,17.22047615306045,-0.9999999999999957,0.2149,0.215,0.2034,0.21,19497956.0,16551.0,9341132.0,-2.2801302931596164,24.505928853754924,0.2422194373384226,0.20257056266157736,-0.003518239008472507,-0.002158716648239898,-0.0013595223602326087,0.0116,0.010364285714285717,5388357054.089998,-0.012800000000000006,-10.941475826972013,-84.61538461538463,15.384615384615374,21.643356643356682,0.2135999999999999,0.21242898557741297,0.21277142857142856,0.21445216680976686,0.22239499999999998,0.219231292395533,38717.0,8076825.333333333,118188.0,10232648.714285715
2023-08-01,0.2078,0.2109,0.2002,0.2105,47289683.0,27656.0,24747109.0,0.20946666666666655,0.21224285714285715,0.22164999999999999,0.21033224639435322,0.21223559383049387,0.21742334819679685,33.25842696629215,0.24280123487736988,0.2004987651226301,-0.004075859853803182,-0.002832362853547958,-0.0012434970002552239,0.010700000000000015,0.00895714285714286,5415359102.089998,-0.009200000000000014,-6.6104702750665485,-67.30158730158729,32.69841269841271,20.241159173743462,1.299326275264668,0.21,0.2123,0.2063,0.2079,20287635.0,15602.0,9779002.0,-0.9999999999999957,23.23809523809527,0.2426261322527827,0.20157386774721733,-0.003972576424461166,-0.002521488603484152,-0.001451087820977014,0.005999999999999978,0.0095,5368069419.089998,-0.017100000000000004,-11.906779661016941,-87.35955056179773,12.64044943820226,17.22047615306045,0.21093333333333322,0.21016449278870647,0.21214285714285713,0.21281412510732514,0.22210000000000002,0.21815212169119652,41848.0,8622575.333333334,103639.0,9092149.142857144
2023-08-02,0.2107,0.2147,0.2032,0.2041,47917676.0,24917.0,23645690.0,0.2074999999999999,0.21114285714285713,0.22018999999999997,0.2072161231971766,0.21020169537287042,0.21615445789234,29.423459244532808,0.24197690094132532,0.19840309905867462,-0.004620872684725774,-0.0031900648197835213,-0.0014308078649422529,0.01150000000000001,0.00920714285714286,5367441426.089998,-0.01949999999999999,-9.20818505338078,-87.61904761904758,12.380952380952428,19.239938172522482,-3.132415757000472,0.2078,0.2109,0.2002,0.2105,47289683.0,27656.0,24747109.0,1.299326275264668,33.25842696629215,0.24280123487736988,0.2004987651226301,-0.004075859853803182,-0.002832362853547958,-0.0012434970002552239,0.010700000000000015,0.00895714285714286,5415359102.089998,-0.009200000000000014,-6.6104702750665485,-67.30158730158729,32.69841269841271,20.241159173743462,0.20946666666666655,0.21033224639435322,0.21224285714285715,0.21223559383049387,0.22164999999999999,0.21742334819679685,59809.0,14622414.333333334,116710.0,11439857.714285715
2023-08-03,0.204,0.2062,0.2,0.2016,25267040.0,14696.0,12400174.0,0.2053999999999999,0.20927142857142858,0.21839999999999998,0.20440806159858832,0.2080512715296528,0.21476831904545046,29.133858267716533,0.24011586856112235,0.1966841314388776,-0.0051946477210927655,-0.00359098140004537,-0.0016036663210473954,0.006199999999999983,0.008721428571428574,5342174386.089998,-0.010699999999999987,-9.51526032315978,-94.13919413919417,5.8608058608058275,16.980056980057004,-1.176470588235287,0.2107,0.2147,0.2032,0.2041,47917676.0,24917.0,23645690.0,-3.132415757000472,29.423459244532808,0.24197690094132532,0.19840309905867462,-0.004620872684725774,-0.0031900648197835213,-0.0014308078649422529,0.01150000000000001,0.00920714285714286,5367441426.089998,-0.01949999999999999,-9.20818505338078,-87.61904761904758,12.380952380952428,19.239938172522482,0.2074999999999999,0.2072161231971766,0.21114285714285713,0.21020169537287042,0.22018999999999997,0.21615445789234,68175.0,19390600.333333332,122618.0,13293750.42857143
2023-08-04,0.2016,0.2035,0.1964,0.1981,24112844.0,14806.0,11145442.0,0.20126666666666657,0.20672857142857143,0.216235,0.20125403079929416,0.2055634536472396,0.2131808600887409,24.184261036468328,0.2369045580885137,0.1955654419114863,-0.005864190581823692,-0.004045623236401034,-0.0018185673454226576,0.007099999999999995,0.00877857142857143,5318061542.089998,-0.011699999999999988,-11.955555555555563,-94.49838187702262,5.501618122977367,7.914458788245221,-1.7361111111111125,0.204,0.2062,0.2,0.2016,25267040.0,14696.0,12400174.0,-1.176470588235287,29.133858267716533,0.24011586856112235,0.1966841314388776,-0.0051946477210927655,-0.00359098140004537,-0.0016036663210473954,0.006199999999999983,0.008721428571428574,5342174386.089998,-0.010699999999999987,-9.51526032315978,-94.13919413919417,5.8608058608058275,16.980056980057004,0.2053999999999999,0.20440806159858832,0.20927142857142858,0.2080512715296528,0.21839999999999998,0.21476831904545046,67269.0,20264324.333333332,121588.0,13543207.285714285
2023-08-05,0.1981,0.1982,0.1917,0.1942,17482764.0,13290.0,8214906.0,0.19796666666666654,0.20377142857142858,0.214155,0.1977270153996471,0.2027225902354297,0.21137315912790844,24.852071005917168,0.23490701702297356,0.19340298297702646,-0.006633043927617738,-0.004563107374644375,-0.002069936552973363,0.006499999999999978,0.008528571428571429,5300578778.089998,-0.017599999999999977,-11.606736458807465,-92.73255813953487,7.267441860465125,6.2099552814161205,-1.9687026754164498,0.2016,0.2035,0.1964,0.1981,24112844.0,14806.0,11145442.0,-1.7361111111111125,24.184261036468328,0.2369045580885137,0.1955654419114863,-0.005864190581823692,-0.004045623236401034,-0.0018185673454226576,0.007099999999999995,0.00877857142857143,5318061542.089998,-0.011699999999999988,-11.955555555555563,-94.49838187702262,5.501618122977367,7.914458788245221,0.20126666666666657,0.20125403079929416,0.20672857142857143,0.2055634536472396,0.216235,0.2131808600887409,54419.0,15730435.333333334,123923.0,13972305.857142856
2023-08-06,0.1943,0.2001,0.1938,0.197,17016050.0,12482.0,7769734.0,0.19643333333333324,0.2019142857142857,0.21220500000000003,0.19736350769982355,0.2012919426765723,0.2100042868300124,23.185483870967758,0.23159902783809797,0.1928109721619021,-0.00693646983754051,-0.005037779867223602,-0.0018986899703169078,0.0063,0.008385714285714286,5317594828.089998,-0.017699999999999994,-11.896243291592123,-84.59302325581395,15.406976744186048,9.392012242542862,1.3896037056098856,0.1981,0.1982,0.1917,0.1942,17482764.0,13290.0,8214906.0,-1.9687026754164498,24.852071005917168,0.23490701702297356,0.19340298297702646,-0.006633043927617738,-0.004563107374644375,-0.002069936552973363,0.006499999999999978,0.008528571428571429,5300578778.089998,-0.017599999999999977,-11.606736458807465,-92.73255813953487,7.267441860465125,6.2099552814161205,0.19796666666666654,0.1977270153996471,0.20377142857142858,0.2027225902354297,0.214155,0.21137315912790844,42792.0,10586840.666666666,127518.0,14181922.142857144
2023-08-07,0.197,0.2002,0.1903,0.1954,23411072.0,15772.0,12003586.0,0.19553333333333323,0.20012857142857143,0.210705,0.19638175384991177,0.19981895700742924,0.20861340237001122,28.82205513784463,0.23043960492572305,0.19097039507427696,-0.00722278392836273,-0.005474780679451428,-0.0017480032489113027,0.009899999999999992,0.007821428571428573,5294183756.089998,-0.020500000000000018,-7.960433349034391,-81.65467625899282,18.345323741007178,13.6732474485528,-0.8121827411167604,0.1943,0.2001,0.1938,0.197,17016050.0,12482.0,7769734.0,1.3896037056098856,23.185483870967758,0.23159902783809797,0.1928109721619021,-0.00693646983754051,-0.005037779867223602,-0.0018986899703169078,0.0063,0.008385714285714286,5317594828.089998,-0.017699999999999994,-11.896243291592123,-84.59302325581395,15.406976744186048,9.392012242542862,0.19643333333333324,0.19736350769982355,0.2019142857142857,0.2012919426765723,0.21220500000000003,0.2100042868300124,40578.0,9043360.666666666,123449.0,13957436.714285715
2023-08-08,0.1955,0.202,0.193,0.2003,30583050.0,17160.0,15165016.0,0.19756666666666656,0.19867142857142855,0.20948000000000003,0.1983408769249559,0.19993921775557194,0.20782164976334347,38.770685579196254,0.2285614983411361,0.19039850165886396,-0.0069739099661480786,-0.005774606536790758,-0.0011993034293573202,0.009000000000000008,0.008028571428571428,5324766806.089998,-0.014600000000000002,-4.528122020972347,-64.02877697841723,35.97122302158277,23.241174502258684,2.4552429667519173,0.197,0.2002,0.1903,0.1954,23411072.0,15772.0,12003586.0,-0.8121827411167604,28.82205513784463,0.23043960492572305,0.19097039507427696,-0.00722278392836273,-0.005474780679451428,-0.0017480032489113027,0.009899999999999992,0.007821428571428573,5294183756.089998,-0.020500000000000018,-7.960433349034391,-81.65467625899282,18.345323741007178,13.6732474485528,0.19553333333333323,0.19638175384991177,0.20012857142857143,0.19981895700742924,0.210705,0.20861340237001122,41544.0,9329408.666666666,123619.0,14275234.42857143
2023-08-09,0.2004,0.2035,0.1956,0.1988,20452169.0,14411.0,9839020.0,0.19816666666666657,0.1979142857142857,0.20827999999999997,0.19857043846247796,0.19965441331667896,0.20696244502397743,34.449760765550266,0.22684613782345708,0.18971386217654285,-0.006819106605824382,-0.005983506550597483,-0.0008356000552268992,0.00789999999999999,0.007849999999999998,5304314637.089998,-0.011199999999999988,-6.1378659112370055,-69.42446043165464,30.575539568345363,28.29736211031179,-0.7984031936127697,0.1955,0.202,0.193,0.2003,30583050.0,17160.0,15165016.0,2.4552429667519173,38.770685579196254,0.2285614983411361,0.19039850165886396,-0.0069739099661480786,-0.005774606536790758,-0.0011993034293573202,0.009000000000000008,0.008028571428571428,5324766806.089998,-0.014600000000000002,-4.528122020972347,-64.02877697841723,35.97122302158277,23.241174502258684,0.19756666666666656,0.1983408769249559,0.19867142857142855,0.19993921775557194,0.20948000000000003,0.20782164976334347,45414.0,11646112.0,113123.0,12906364.0
2023-08-10,0.1989,0.204,0.1961,0.2009,16385709.0,12427.0,7896244.0,0.19999999999999987,0.19781428571428572,0.20707499999999998,0.199735219231239,0.1999658099875092,0.20638506930740816,33.17073170731706,0.22413956778472838,0.19001043221527159,-0.006452589937698122,-0.006077323228017611,-0.0003752667096805114,0.00789999999999999,0.007835714285714281,5320700346.089998,-0.007000000000000006,-6.4275733581741985,-61.870503597122294,38.129496402877706,34.89208633093529,1.005530417295124,0.2004,0.2035,0.1956,0.1988,20452169.0,14411.0,9839020.0,-0.7984031936127697,34.449760765550266,0.22684613782345708,0.18971386217654285,-0.006819106605824382,-0.005983506550597483,-0.0008356000552268992,0.00789999999999999,0.007849999999999998,5304314637.089998,-0.011199999999999988,-6.1378659112370055,-69.42446043165464,30.575539568345363,28.29736211031179,0.19816666666666657,0.19857043846247796,0.1979142857142857,0.19965441331667896,0.20827999999999997,0.20696244502397743,47343.0,12335874.0,102617.0,10933982.57142857
2023-08-11,0.201,0.2037,0.1997,0.2024,9657480.0,8593.0,4685956.0,0.20069999999999988,0.19842857142857143,0.20621,0.20106760961561948,0.2005743574906319,0.20600553889717882,33.65617433414042,0.22230640692157236,0.19011359307842765,-0.00597224109585906,-0.006056306801585901,8.406570572684104e-05,0.0040000000000000036,0.007771428571428566,5330357826.089998,-0.008099999999999996,-6.252894858730896,-56.474820143884884,43.52517985611512,37.41007194244608,0.6965174129353157,0.1989,0.204,0.1961,0.2009,16385709.0,12427.0,7896244.0,1.005530417295124,33.17073170731706,0.22413956778472838,0.19001043221527159,-0.006452589937698122,-0.006077323228017611,-0.0003752667096805114,0.00789999999999999,0.007835714285714281,5320700346.089998,-0.007000000000000006,-6.4275733581741985,-61.870503597122294,38.129496402877706,34.89208633093529,0.19999999999999987,0.199735219231239,0.19781428571428572,0.1999658099875092,0.20707499999999998,0.20638506930740816,43998.0,10966760.0,100348.0,10290564.0
2023-08-12,0.2024,0.2034,0.1995,0.2005,10336334.0,7324.0,4737300.0,0.20126666666666657,0.19932857142857144,0.205055,0.20078380480780975,0.20055576811797393,0.20548120185935226,32.93838862559241,0.21907911081694237,0.1910308891830576,-0.005679406634636286,-0.005980926768195978,0.0003015201335596924,0.003899999999999987,0.007749999999999995,5320021492.089998,-0.003599999999999992,-6.700791065611911,-58.70445344129549,41.295546558704515,40.98340760589913,-0.9387351778656053,0.201,0.2037,0.1997,0.2024,9657480.0,8593.0,4685956.0,0.6965174129353157,33.65617433414042,0.22230640692157236,0.19011359307842765,-0.00597224109585906,-0.006056306801585901,8.406570572684104e-05,0.0040000000000000036,0.007771428571428566,5330357826.089998,-0.008099999999999996,-6.252894858730896,-56.474820143884884,43.52517985611512,37.41007194244608,0.20069999999999988,0.20106760961561948,0.19842857142857143,0.2005743574906319,0.20621,0.20600553889717882,35431.0,7473740.0,94135.0,9367780.285714285
2023-08-13,0.2004,0.2224,0.1995,0.2189,62356908.0,44627.0,34792652.0,0.20726666666666657,0.20245714285714286,0.205385,0.20984190240390488,0.20514182608848044,0.20675918263465207,57.98922800718135,0.22040236188183848,0.19036763811816154,-0.003917449075163948,-0.005568231229589573,0.001650782154425625,0.022899999999999976,0.00855714285714285,5382378400.089998,0.01730000000000001,4.238095238095241,-10.903426791277186,89.09657320872282,57.9724332078475,9.231536926147713,0.2024,0.2034,0.1995,0.2005,10336334.0,7324.0,4737300.0,-0.9387351778656053,32.93838862559241,0.21907911081694237,0.1910308891830576,-0.005679406634636286,-0.005980926768195978,0.0003015201335596924,0.003899999999999987,0.007749999999999995,5320021492.089998,-0.003599999999999992,-6.700791065611911,-58.70445344129549,41.295546558704515,40.98340760589913,0.20126666666666657,0.20078380480780975,0.19932857142857144,0.20055576811797393,0.205055,0.20548120185935226,28344.0,5773166.666666667,88169.0,8870979.42857143
2023-08-14,0.2189,0.2347,0.2121,0.22,143236265.0,95655.0,69631549.0,0.2131333333333332,0.20597142857142856,0.205895,0.21492095120195243,0.20885636956636033,0.20802021285992328,61.06032906764169,0.22218273836504002,0.18960726163495997,-0.0024046054137521478,-0.0049355060664220875,0.00253090065266994,0.02259999999999998,0.009742857142857136,5525614665.089998,0.021900000000000003,5.820105820105814,-33.10810810810809,66.8918918918919,65.7613372197731,0.5025125628140656,0.2004,0.2224,0.1995,0.2189,62356908.0,44627.0,34792652.0,9.231536926147713,57.98922800718135,0.22040236188183848,0.19036763811816154,-0.003917449075163948,-0.005568231229589573,0.001650782154425625,0.022899999999999976,0.00855714285714285,5382378400.089998,0.01730000000000001,4.238095238095241,-10.903426791277186,89.09657320872282,57.9724332078475,0.20726666666666657,0.20984190240390488,0.20245714285714286,0.20514182608848044,0.205385,0.20675918263465207,60544.0,14738636.0,120314.0,12731396.285714285
2023-08-15,0.22,0.222,0.1902,0.203,63242882.0,47365.0,29233548.0,0.21396666666666656,0.20635714285714285,0.20545500000000003,0.20896047560097622,0.20739227717477027,0.20754209734945442,44.57308248914618,0.221545333809484,0.18936466619051606,-0.0025480514862784576,-0.004458015150393361,0.0019099636641149035,0.031799999999999995,0.011249999999999993,5462371783.089998,0.008800000000000002,-3.562945368171011,-71.23595505617976,28.76404494382025,61.58417001481167,-7.727272727272721,0.2189,0.2347,0.2121,0.22,143236265.0,95655.0,69631549.0,0.5025125628140656,61.06032906764169,0.22218273836504002,0.18960726163495997,-0.0024046054137521478,-0.0049355060664220875,0.00253090065266994,0.02259999999999998,0.009742857142857136,5525614665.089998,0.021900000000000003,5.820105820105814,-33.10810810810809,66.8918918918919,65.7613372197731,0.2131333333333332,0.21492095120195243,0.20597142857142856,0.20885636956636033,0.205895,0.20802021285992328,147606.0,36387167.0,200197.0,20963962.42857143
2023-08-16,0.2029,0.2056,0.1917,0.1962,48681304.0,39187.0,22322281.0,0.20639999999999992,0.20598571428571427,0.20453000000000002,0.20258023780048812,0.2045942078810777,0.20646189760188732,44.31654676258994,0.22050921017729241,0.18855078982270762,-0.003173850529012423,-0.004201182226117173,0.00102733169710475,0.013899999999999996,0.011421428571428563,5413690479.089998,-0.0007999999999999952,-3.870651641352274,-86.51685393258425,13.483146067415747,36.379694301042655,-3.3021192705766302,0.22,0.222,0.1902,0.203,63242882.0,47365.0,29233548.0,-7.727272727272721,44.57308248914618,0.221545333809484,0.18936466619051606,-0.0025480514862784576,-0.004458015150393361,0.0019099636641149035,0.031799999999999995,0.011249999999999993,5462371783.089998,0.008800000000000002,-3.562945368171011,-71.23595505617976,28.76404494382025,61.58417001481167,0.21396666666666656,0.20896047560097622,0.20635714285714285,0.20739227717477027,0.20545500000000003,0.20754209734945442,187647.0,44552583.0,230402.0,22973752.714285713
2023-08-17,0.1962,0.2013,0.1608,0.1881,86080760.0,78903.0,41642599.0,0.19576666666666656,0.20415714285714287,0.20314000000000002,0.19534011890024405,0.20047065591080826,0.20471314544932662,41.01198402130492,0.21977773770032466,0.18650226229967537,-0.004274133533672786,-0.004215772487628296,-5.83610460444901e-05,0.04050000000000001,0.013871428571428564,5327609719.089998,-0.007300000000000001,-6.696428571428581,-63.05818673883628,36.94181326116372,26.396334757466594,-4.128440366972489,0.2029,0.2056,0.1917,0.1962,48681304.0,39187.0,22322281.0,-3.3021192705766302,44.31654676258994,0.22050921017729241,0.18855078982270762,-0.003173850529012423,-0.004201182226117173,0.00102733169710475,0.013899999999999996,0.011421428571428563,5413690479.089998,-0.0007999999999999952,-3.870651641352274,-86.51685393258425,13.483146067415747,36.379694301042655,0.20639999999999992,0.20258023780048812,0.20598571428571427,0.2045942078810777,0.20453000000000002,0.20646189760188732,182207.0,40395792.666666664,255178.0,24757075.714285713
2023-08-18,0.1881,0.2054,0.1826,0.1996,86159417.0,77088.0,42575111.0,0.1946333333333332,0.2037571428571429,0.20237500000000003,0.19747005945012203,0.2002529919331062,0.20422617921605743,50.90252707581228,0.21811898799193072,0.18663101200806934,-0.00417009163095744,-0.004206636316294124,3.654468533668444e-05,0.022799999999999987,0.014992857142857136,5413769136.089998,-0.0007000000000000062,0.7571933366986361,-47.496617050067655,52.503382949932345,34.30944742617063,6.113769271664014,0.1962,0.2013,0.1608,0.1881,86080760.0,78903.0,41642599.0,-4.128440366972489,41.01198402130492,0.21977773770032466,0.18650226229967537,-0.004274133533672786,-0.004215772487628296,-5.83610460444901e-05,0.04050000000000001,0.013871428571428564,5327609719.089998,-0.007300000000000001,-6.696428571428581,-63.05818673883628,36.94181326116372,26.396334757466594,0.19576666666666656,0.19534011890024405,0.20415714285714287,0.20047065591080826,0.20314000000000002,0.20471314544932662,165455.0,31066142.666666668,321654.0,29577983.57142857
2023-08-19,0.1996,0.22,0.1992,0.2098,68469712.0,53895.0,32135924.0,0.19916666666666658,0.2050857142857143,0.202365,0.203635029725061,0.20263974394982964,0.20475701929071863,58.72483221476509,0.2180888370834507,0.18664116291654928,-0.003227379694289184,-0.004010784991893137,0.0007834052976039528,0.020800000000000013,0.01601428571428571,5482238848.089998,0.010999999999999982,8.032955715756929,-33.694181326116386,66.30581867388362,51.917004961659906,5.110220440881757,0.1881,0.2054,0.1826,0.1996,86159417.0,77088.0,42575111.0,6.113769271664014,50.90252707581228,0.21811898799193072,0.18663101200806934,-0.00417009163095744,-0.004206636316294124,3.654468533668444e-05,0.022799999999999987,0.014992857142857136,5413769136.089998,-0.0007000000000000062,0.7571933366986361,-47.496617050067655,52.503382949932345,34.30944742617063,0.1946333333333332,0.19747005945012203,0.2037571428571429,0.2002529919331062,0.20237500000000003,0.20422617921605743,195178.0,35513330.333333336,390149.0,34990720.0
2023-08-20,0.2096,0.2128,0.203,0.2048,25637629.0,21412.0,12900073.0,0.2047333333333332,0.20307142857142857,0.20221,0.2042175148625305,0.20317980796237223,0.20476111269160258,54.25764192139738,0.21776430554695228,0.18665569445304772,-0.002850868864201078,-0.0037788017663547254,0.0009279329021536472,0.009799999999999975,0.016264285714285707,5456601219.089998,0.0039000000000000146,3.9593908629441676,-40.460081190798356,59.539918809201644,59.44970681100588,-2.290076335877862,0.1996,0.22,0.1992,0.2098,68469712.0,53895.0,32135924.0,5.110220440881757,58.72483221476509,0.2180888370834507,0.18664116291654928,-0.003227379694289184,-0.004010784991893137,0.0007834052976039528,0.020800000000000013,0.01601428571428571,5482238848.089998,0.010999999999999982,8.032955715756929,-33.694181326116386,66.30581867388362,51.917004961659906,0.19916666666666658,0.203635029725061,0.2050857142857143,0.20263974394982964,0.202365,0.20475701929071863,209886.0,38784544.666666664,436720.0,38904809.14285714
2023-08-21,0.2049,0.2088,0.196,0.2015,40839602.0,32267.0,18420194.0,0.20536666666666656,0.20042857142857143,0.20176,0.20285875743126525,0.20275985597177917,0.20445053053049758,53.26902465166132,0.21681728010650791,0.18670271989349208,-0.0027866410757936,-0.0035803696282425005,0.0007937285524489005,0.012800000000000006,0.016471428571428564,5415761617.089998,-0.0008999999999999841,3.121801432958038,-44.92557510148848,55.07442489851152,60.306720793865615,-1.659346022449969,0.2096,0.2128,0.203,0.2048,25637629.0,21412.0,12900073.0,-2.290076335877862,54.25764192139738,0.21776430554695228,0.18665569445304772,-0.002850868864201078,-0.0037788017663547254,0.0009279329021536472,0.009799999999999975,0.016264285714285707,5456601219.089998,0.0039000000000000146,3.9593908629441676,-40.460081190798356,59.539918809201644,59.44970681100588,0.2047333333333332,0.2042175148625305,0.20307142857142857,0.20317980796237223,0.20221,0.20476111269160258,152395.0,29203702.666666668,413505.0,35777297.85714286
2023-08-22,0.2015,0.2044,0.1855,0.1962,45740751.0,35862.0,21349765.0,0.20083333333333322,0.19945714285714286,0.20136500000000002,0.19952937871563264,0.2011198919788344,0.20366476571806924,47.81216648879403,0.21657749832402512,0.1861525016759749,-0.0031273555882858073,-0.003489766820251162,0.0003624112319653549,0.0189,0.01717857142857142,5370020866.089998,-0.004299999999999998,-2.0469296055916075,-52.097428958051395,47.902571041948605,54.17230491655394,-2.6302729528535975,0.2049,0.2088,0.196,0.2015,40839602.0,32267.0,18420194.0,-1.659346022449969,53.26902465166132,0.21681728010650791,0.18670271989349208,-0.0027866410757936,-0.0035803696282425005,0.0007937285524489005,0.012800000000000006,0.016471428571428564,5415761617.089998,-0.0008999999999999841,3.121801432958038,-44.92557510148848,55.07442489851152,60.306720793865615,0.20536666666666656,0.20285875743126525,0.20042857142857143,0.20275985597177917,0.20176,0.20445053053049758,107574.0,21152063.666666668,350117.0,28461390.0
2023-08-23,0.1963,0.21,0.1954,0.2085,37716666.0,34642.0,19175863.0,0.2020666666666666,0.20121428571428573,0.20171,0.2040146893578163,0.2029649189841258,0.20412526422111027,54.64114832535884,0.21725428647769257,0.18616571352230743,-0.0023774611967821435,-0.003267305695557359,0.0008898444987752155,0.014600000000000002,0.01765714285714285,5407737532.089998,-0.01040000000000002,4.879275653923543,-35.4533152909337,64.5466847090663,55.84122688317549,6.214977075904223,0.2015,0.2044,0.1855,0.1962,45740751.0,35862.0,21349765.0,-2.6302729528535975,47.81216648879403,0.21657749832402512,0.1861525016759749,-0.0031273555882858073,-0.003489766820251162,0.0003624112319653549,0.0189,0.01717857142857142,5370020866.089998,-0.004299999999999998,-2.0469296055916075,-52.097428958051395,47.902571041948605,54.17230491655394,0.20083333333333322,0.19952937871563264,0.19945714285714286,0.2011198919788344,0.20136500000000002,0.20366476571806924,89541.0,17556677.333333332,338614.0,27335135.285714287
2023-08-24,0.2085,0.217,0.204,0.2091,50181132.0,42384.0,23501855.0,0.2045999999999999,0.2042142857142857,0.20225999999999997,0.20655734467890816,0.20449868923809433,0.20459904858100453,53.98058252427185,0.21804305553752446,0.18647694446247548,-0.0017149802781193657,-0.0029568406120697604,0.0012418603339503947,0.013000000000000012,0.01802142857142857,5457918664.089998,-0.010899999999999993,4.081632653061229,-34.64140730717183,65.35859269282817,59.26928281461437,0.28776978417267013,0.1963,0.21,0.1954,0.2085,37716666.0,34642.0,19175863.0,6.214977075904223,54.64114832535884,0.21725428647769257,0.18616571352230743,-0.0023774611967821435,-0.003267305695557359,0.0008898444987752155,0.014600000000000002,0.01765714285714285,5407737532.089998,-0.01040000000000002,4.879275653923543,-35.4533152909337,64.5466847090663,55.84122688317549,0.2020666666666666,0.2040146893578163,0.20121428571428573,0.2029649189841258,0.20171,0.20412526422111027,102771.0,19648607.333333332,334069.0,26885647.0
2023-08-25,0.2091,0.218,0.2001,0.2171,72340330.0,58379.0,37017002.0,0.21156666666666654,0.2067142857142857,0.203405,0.21182867233945407,0.20764901692857074,0.2057896153828136,56.71232876712329,0.22002641611534782,0.1867835838846522,-0.000538221948362283,-0.002473116879328265,0.0019348949309659822,0.0179,0.01901428571428571,5530258994.089998,0.014099999999999974,7.2628458498023685,-23.81596752368066,76.18403247631935,68.69643662607128,3.8259206121472875,0.2085,0.217,0.204,0.2091,50181132.0,42384.0,23501855.0,0.28776978417267013,53.98058252427185,0.21804305553752446,0.18647694446247548,-0.0017149802781193657,-0.0029568406120697604,0.0012418603339503947,0.013000000000000012,0.01802142857142857,5457918664.089998,-0.010899999999999993,4.081632653061229,-34.64140730717183,65.35859269282817,59.26928281461437,0.2045999999999999,0.20655734467890816,0.2042142857142857,0.20449868923809433,0.20225999999999997,0.20459904858100453,112888.0,21342494.333333332,297550.0,24294112.14285714
2023-08-26,0.2171,0.2177,0.2058,0.2076,25082161.0,18750.0,11084475.0,0.21126666666666657,0.20639999999999997,0.20393499999999998,0.20971433616972704,0.20763676269642806,0.20596203296540277,53.03159692570452,0.22037145178752884,0.1874985482124711,-0.00036796146837181354,-0.002052085797136975,0.0016841243287651613,0.011899999999999994,0.019585714285714286,5505176833.089998,0.011399999999999993,3.5411471321695753,-36.671177266576436,63.328822733423564,68.29048263419037,-4.3758636573007745,0.2091,0.218,0.2001,0.2171,72340330.0,58379.0,37017002.0,3.8259206121472875,56.71232876712329,0.22002641611534782,0.1867835838846522,-0.000538221948362283,-0.002473116879328265,0.0019348949309659822,0.0179,0.01901428571428571,5530258994.089998,0.014099999999999974,7.2628458498023685,-23.81596752368066,76.18403247631935,68.69643662607128,0.21156666666666654,0.21182867233945407,0.2067142857142857,0.20764901692857074,0.203405,0.2057896153828136,135405.0,26564906.666666668,278841.0,23500096.57142857
2023-08-27,0.2076,0.2145,0.2064,0.2102,28015123.0,20464.0,13464407.0,0.21163333333333323,0.2071714285714286,0.204675,0.20995716808486353,0.20827757202232106,0.20636564887345965,45.705824284304036,0.2208236352689006,0.1885263647310994,-2.2965804922059352e-05,-0.0016462617986939918,0.0016232959937719324,0.008099999999999996,0.018528571428571426,5533191956.089998,0.02210000000000001,-3.9744175422567474,-33.15290933694181,66.8470906630582,68.78664862426704,1.2524084778419997,0.2171,0.2177,0.2058,0.2076,25082161.0,18750.0,11084475.0,-4.3758636573007745,53.03159692570452,0.22037145178752884,0.1874985482124711,-0.00036796146837181354,-0.002052085797136975,0.0016841243287651613,0.011899999999999994,0.019585714285714286,5505176833.089998,0.011399999999999993,3.5411471321695753,-36.671177266576436,63.328822733423564,68.29048263419037,0.21126666666666657,0.20971433616972704,0.20639999999999997,0.20763676269642806,0.20393499999999998,0.20596203296540277,119513.0,23867777.333333332,243696.0,20492746.714285713
2023-08-28,0.2102,0.2123,0.2027,0.2069,29718570.0,23375.0,13723557.0,0.20823333333333324,0.20794285714285715,0.20500500000000002,0.20842858404243175,0.20793317901674077,0.20641653945693966,43.67149758454106,0.22104658739997832,0.18896341260002172,-1.565620187829464e-05,-0.0013201406793308525,0.0013044844774525578,0.009599999999999997,0.017599999999999998,5503473386.089998,0.007300000000000001,-5.954545454545457,-24.673202614379086,75.32679738562092,68.50090359403424,-1.5699333967649844,0.2076,0.2145,0.2064,0.2102,28015123.0,20464.0,13464407.0,1.2524084778419997,45.705824284304036,0.2208236352689006,0.1885263647310994,-2.2965804922059352e-05,-0.0016462617986939918,0.0016232959937719324,0.008099999999999996,0.018528571428571426,5533191956.089998,0.02210000000000001,-3.9744175422567474,-33.15290933694181,66.8470906630582,68.78664862426704,0.21163333333333323,0.20995716808486353,0.2071714285714286,0.20827757202232106,0.204675,0.20636564887345965,97593.0,20521961.333333332,242748.0,20573365.85714286
2023-08-29,0.2069,0.2177,0.2021,0.216,46330445.0,45256.0,21978409.0,0.2110333333333332,0.21077142857142858,0.20586500000000002,0.2122142920212159,0.20994988426255556,0.20732924998485017,56.79916317991631,0.22234417665277179,0.18938582334722825,0.0007161750392742638,-0.0009128775356098293,0.0016290525748840932,0.015600000000000003,0.01644285714285714,5549803831.089998,0.006200000000000011,6.4039408866994885,-6.756756756756762,93.24324324324323,78.47237709730746,4.398260028999515,0.2102,0.2123,0.2027,0.2069,29718570.0,23375.0,13723557.0,-1.5699333967649844,43.67149758454106,0.22104658739997832,0.18896341260002172,-1.565620187829464e-05,-0.0013201406793308525,0.0013044844774525578,0.009599999999999997,0.017599999999999998,5503473386.089998,0.007300000000000001,-5.954545454545457,-24.673202614379086,75.32679738562092,68.50090359403424,0.20823333333333324,0.20842858404243175,0.20794285714285715,0.20793317901674077,0.20500500000000002,0.20641653945693966,62589.0,12757479.666666666,233856.0,19902417.714285713
2023-08-30,0.216,0.2353,0.2129,0.2338,90061369.0,74555.0,47066437.0,0.21889999999999987,0.21438571428571432,0.20751,0.22300714601060795,0.21591241319691667,0.2098502737958168,67.6360225140713,0.22798600906826827,0.18703399093173173,0.0027013285753422767,-0.00019003631341940814,0.002891364888761685,0.022400000000000003,0.01705,5639865200.089998,0.028999999999999998,19.164118246687046,-2.013422818791948,97.98657718120806,88.85220593669074,8.240740740740746,0.2069,0.2177,0.2021,0.216,46330445.0,45256.0,21978409.0,4.398260028999515,56.79916317991631,0.22234417665277179,0.18938582334722825,0.0007161750392742638,-0.0009128775356098293,0.0016290525748840932,0.015600000000000003,0.01644285714285714,5549803831.089998,0.006200000000000011,6.4039408866994885,-6.756756756756762,93.24324324324323,78.47237709730746,0.2110333333333332,0.2122142920212159,0.21077142857142858,0.20994988426255556,0.20586500000000002,0.20732924998485017,89095.0,16388791.0,243250.0,19992224.0
2023-08-31,0.2337,0.257,0.2239,0.2294,201710525.0,181179.0,100375828.0,0.2263999999999999,0.21728571428571428,0.20886,0.22620357300530397,0.2192843098976875,0.21171215248192948,70.06802721088437,0.2313760901531521,0.18634390984684787,0.0038748667751067334,0.0006229443042858202,0.003251922470820913,0.03310000000000002,0.016521428571428572,5438154675.089998,0.02789999999999998,21.956406166932485,-37.09677419354841,62.90322580645159,84.71101541030096,-1.839965768078733,0.216,0.2353,0.2129,0.2338,90061369.0,74555.0,47066437.0,8.240740740740746,67.6360225140713,0.22798600906826827,0.18703399093173173,0.0027013285753422767,-0.00019003631341940814,0.002891364888761685,0.022400000000000003,0.01705,5639865200.089998,0.028999999999999998,19.164118246687046,-2.013422818791948,97.98657718120806,88.85220593669074,0.21889999999999987,0.22300714601060795,0.21438571428571432,0.21591241319691667,0.20751,0.2098502737958168,143186.0,27589467.666666668,283163.0,23976591.714285713
2023-09-01,0.2292,0.2394,0.2218,0.2301,79913696.0,68454.0,37480812.0,0.2310999999999999,0.21914285714285714,0.21034000000000003,0.228151786502652,0.2219882324232656,0.21346337605507906,66.55808903365909,0.23438192828757487,0.18629807171242518,0.004805987965519287,0.0014595530365325137,0.0033464349289867735,0.017600000000000005,0.01615,5518068371.089998,0.033899999999999986,15.280561122244496,-37.62237762237763,62.37762237762238,74.42247512176068,0.392670157068068,0.2337,0.257,0.2239,0.2294,201710525.0,181179.0,100375828.0,-1.839965768078733,70.06802721088437,0.2313760901531521,0.18634390984684787,0.0038748667751067334,0.0006229443042858202,0.003251922470820913,0.03310000000000002,0.016521428571428572,5438154675.089998,0.02789999999999998,21.956406166932485,-37.09677419354841,62.90322580645159,84.71101541030096,0.2263999999999999,0.22620357300530397,0.21728571428571428,0.2192843098976875,0.20886,0.21171215248192948,300990.0,56473558.0,421958.0,34958587.85714286
2023-09-02,0.2301,0.2538,0.2247,0.2516,93260430.0,87410.0,47671743.0,0.2370333333333332,0.22542857142857145,0.21197499999999997,0.239875893251326,0.2293911743174492,0.21709543547840487,70.21276595744682,0.2421367307194968,0.18181326928050315,0.007195829491164207,0.0026068083274588525,0.004589021163705355,0.029100000000000015,0.016742857142857146,5611328801.089998,0.0431,19.923736892278356,-7.552447552447574,92.44755244755243,72.57613354387547,9.343763581051713,0.2292,0.2394,0.2218,0.2301,79913696.0,68454.0,37480812.0,0.392670157068068,66.55808903365909,0.23438192828757487,0.18629807171242518,0.004805987965519287,0.0014595530365325137,0.0033464349289867735,0.017600000000000005,0.01615,5518068371.089998,0.033899999999999986,15.280561122244496,-37.62237762237763,62.37762237762238,74.42247512176068,0.2310999999999999,0.228151786502652,0.21914285714285714,0.2219882324232656,0.21034000000000003,0.21346337605507906,324188.0,61641025.666666664,432033.0,35024846.428571425
2023-09-03,0.2516,0.2736,0.2474,0.2591,150749382.0,158757.0,73664134.0,0.24693333333333323,0.2324142857142857,0.21393,0.24948794662566298,0.2368183807380869,0.22109587019474725,75.63739376770539,0.25063979218275045,0.17722020781724956,0.009584499296257376,0.004002346521218557,0.005582152775038819,0.0262,0.017914285714285716,5762078183.089998,0.04999999999999999,26.513671875,-16.45856980703747,83.54143019296252,79.45553500604579,2.98092209856916,0.2301,0.2538,0.2247,0.2516,93260430.0,87410.0,47671743.0,9.343763581051713,70.21276595744682,0.2421367307194968,0.18181326928050315,0.007195829491164207,0.0026068083274588525,0.004589021163705355,0.029100000000000015,0.016742857142857146,5611328801.089998,0.0431,19.923736892278356,-7.552447552447574,92.44755244755243,72.57613354387547,0.2370333333333332,0.239875893251326,0.22542857142857145,0.2293911743174492,0.21197499999999997,0.21709543547840487,337043.0,61842794.333333336,500693.0,40251599.0
2023-09-04,0.2591,0.2699,0.252,0.2674,94657751.0,94195.0,46811671.0,0.2593666666666666,0.24105714285714286,0.21715,0.25844397331283153,0.24446378555356518,0.22550578731905704,79.71145175834086,0.26051709885562324,0.17378290114437678,0.012008847442170734,0.005603646705408994,0.00640520073676174,0.01789999999999997,0.01827857142857143,5856735934.089998,0.05030000000000004,32.7047146401985,-7.037457434733238,92.96254256526676,89.65050840192725,3.2033963720571323,0.2516,0.2736,0.2474,0.2591,150749382.0,158757.0,73664134.0,2.98092209856916,75.63739376770539,0.25063979218275045,0.17722020781724956,0.009584499296257376,0.004002346521218557,0.005582152775038819,0.0262,0.017914285714285716,5762078183.089998,0.04999999999999999,26.513671875,-16.45856980703747,83.54143019296252,79.45553500604579,0.24693333333333323,0.24948794662566298,0.2324142857142857,0.2368183807380869,0.21393,0.22109587019474725,314621.0,52938896.333333336,638986.0,48851560.0
2023-09-05,0.2675,0.2718,0.2489,0.2501,66283787.0,70491.0,30846437.0,0.2588666666666665,0.24592857142857144,0.21984499999999998,0.25427198665641576,0.24587283916517388,0.22784809328867067,71.92839707078925,0.26441284184040464,0.17527715815959533,0.012391355562847345,0.006961188476896665,0.00543016708595068,0.022899999999999976,0.018564285714285717,5790452147.089998,0.04249999999999998,27.47196738022424,-30.051150895140683,69.9488491048593,82.15094062102953,-6.504672897196271,0.2591,0.2699,0.252,0.2674,94657751.0,94195.0,46811671.0,3.2033963720571323,79.71145175834086,0.26051709885562324,0.17378290114437678,0.012008847442170734,0.005603646705408994,0.00640520073676174,0.01789999999999997,0.01827857142857143,5856735934.089998,0.05030000000000004,32.7047146401985,-7.037457434733238,92.96254256526676,89.65050840192725,0.2593666666666666,0.25844397331283153,0.24105714285714286,0.24446378555356518,0.21715,0.22550578731905704,340362.0,56049182.666666664,709806.0,53578433.428571425
2023-09-06,0.2501,0.2617,0.243,0.2567,78407548.0,72580.0,38961510.0,0.2580666666666665,0.24919999999999995,0.22327500000000003,0.25548599332820787,0.2485796293738804,0.2305958939278449,70.56313993174061,0.2681142156839688,0.17843578431603124,0.013076325109669773,0.008184215803451286,0.004892109306218487,0.018699999999999994,0.018857142857142857,5868859695.089998,0.046499999999999986,23.117505995203835,-22.993197278911598,77.0068027210884,79.97273146373817,2.6389444222311056,0.2675,0.2718,0.2489,0.2501,66283787.0,70491.0,30846437.0,-6.504672897196271,71.92839707078925,0.26441284184040464,0.17527715815959533,0.012391355562847345,0.006961188476896665,0.00543016708595068,0.022899999999999976,0.018564285714285717,5790452147.089998,0.04249999999999998,27.47196738022424,-30.051150895140683,69.9488491048593,82.15094062102953,0.2588666666666665,0.25427198665641576,0.24592857142857144,0.24587283916517388,0.21984499999999998,0.22784809328867067,323443.0,50440747.333333336,735041.0,54845294.571428575
2023-09-07,0.2565,0.2577,0.2408,0.2491,39494223.0,41862.0,18457682.0,0.2519666666666665,0.2520142857142857,0.22575000000000003,0.25229299666410393,0.24870972203041028,0.2323581897442406,66.10305958132045,0.27055143324770137,0.1809485667522987,0.012857696405787988,0.009118911923918628,0.0037387844818693606,0.0169,0.019135714285714284,5829365472.089998,0.04219999999999999,19.12960306073648,-33.33333333333336,66.66666666666664,71.20743949753813,-2.884990253411313,0.2501,0.2617,0.243,0.2567,78407548.0,72580.0,38961510.0,2.6389444222311056,70.56313993174061,0.2681142156839688,0.17843578431603124,0.013076325109669773,0.008184215803451286,0.004892109306218487,0.018699999999999994,0.018857142857142857,5868859695.089998,0.046499999999999986,23.117505995203835,-22.993197278911598,77.0068027210884,79.97273146373817,0.2580666666666665,0.25548599332820787,0.24919999999999995,0.2485796293738804,0.22327500000000003,0.2305958939278449,237266.0,38873206.0,733066.0,53687447.85714286
2023-09-08,0.2491,0.2555,0.2355,0.2386,53580374.0,59048.0,24531818.0,0.24813333333333318,0.2532285714285714,0.22719,0.24544649833205195,0.2461822915228077,0.23295264786383676,58.484609313338595,0.2716831644660857,0.1826968355339143,0.011702272818350262,0.009635584102804955,0.0020666887155453076,0.020000000000000018,0.019285714285714288,5775785098.089998,0.02260000000000001,9.903270382312312,-48.951048951048946,51.048951048951054,64.90747347890205,-4.21517462866318,0.2565,0.2577,0.2408,0.2491,39494223.0,41862.0,18457682.0,-2.884990253411313,66.10305958132045,0.27055143324770137,0.1809485667522987,0.012857696405787988,0.009118911923918628,0.0037387844818693606,0.0169,0.019135714285714284,5829365472.089998,0.04219999999999999,19.12960306073648,-33.33333333333336,66.66666666666664,71.20743949753813,0.2519666666666665,0.25229299666410393,0.2520142857142857,0.24870972203041028,0.22575000000000003,0.2323581897442406,184933.0,29421876.333333332,593749.0,41984855.571428575
2023-09-09,0.2386,0.2407,0.2335,0.2351,23427417.0,26840.0,11372419.0,0.24093333333333322,0.2508714285714286,0.228705,0.240273249166026,0.24341171864210578,0.2331571575910904,61.39188069594034,0.2720364022511189,0.18537359774888104,0.010384464904336699,0.009785360263111303,0.0005991046412253953,0.007199999999999984,0.018949999999999998,5752357681.089998,0.0012999999999999956,13.246628131021199,-53.84615384615385,46.15384615384615,54.623154623154626,-1.4668901927912836,0.2491,0.2555,0.2355,0.2386,53580374.0,59048.0,24531818.0,-4.21517462866318,58.484609313338595,0.2716831644660857,0.1826968355339143,0.011702272818350262,0.009635584102804955,0.0020666887155453076,0.020000000000000018,0.019285714285714288,5775785098.089998,0.02260000000000001,9.903270382312312,-48.951048951048946,51.048951048951054,64.90747347890205,0.24813333333333318,0.24544649833205195,0.2532285714285714,0.2461822915228077,0.22719,0.23295264786383676,173490.0,27317003.333333332,584343.0,40134999.28571428
2023-09-10,0.235,0.2352,0.215,0.231,45432921.0,50116.0,22343149.0,0.2348999999999999,0.24685714285714286,0.23018,0.235636624583013,0.24030878898157934,0.23295171401098655,58.51063829787235,0.2715774115640844,0.18878258843591558,0.008906587308977476,0.009609605672284539,-0.000703018363307063,0.020199999999999996,0.01981428571428571,5706924760.089998,0.001600000000000018,9.895337773549006,-59.58041958041957,40.41958041958043,45.874125874125895,-1.702127659574458,0.2386,0.2407,0.2335,0.2351,23427417.0,26840.0,11372419.0,-1.4668901927912836,61.39188069594034,0.2720364022511189,0.18537359774888104,0.010384464904336699,0.009785360263111303,0.0005991046412253953,0.007199999999999984,0.018949999999999998,5752357681.089998,0.0012999999999999956,13.246628131021199,-53.84615384615385,46.15384615384615,54.623154623154626,0.24093333333333322,0.240273249166026,0.2508714285714286,0.24341171864210578,0.228705,0.2331571575910904,127750.0,18120639.666666668,523773.0,34949381.571428575
2023-09-11,0.231,0.2364,0.2176,0.223,53035213.0,67923.0,26263476.0,0.22969999999999988,0.2405142857142857,0.23152,0.2293183122915065,0.2359815917361845,0.2320039317242259,56.343577620173356,0.26991213735287467,0.1931278626471253,0.0070090297934228,0.009089490496512191,-0.0020804607030893915,0.01880000000000001,0.020471428571428574,5653889547.089998,-0.007099999999999995,7.7815369743837515,-70.76923076923077,29.230769230769234,38.60139860139862,-3.463203463203466,0.235,0.2352,0.215,0.231,45432921.0,50116.0,22343149.0,-1.702127659574458,58.51063829787235,0.2715774115640844,0.18878258843591558,0.008906587308977476,0.009609605672284539,-0.000703018363307063,0.020199999999999996,0.01981428571428571,5706924760.089998,0.001600000000000018,9.895337773549006,-59.58041958041957,40.41958041958043,45.874125874125895,0.2348999999999999,0.235636624583013,0.24685714285714286,0.24030878898157934,0.23018,0.23295171401098655,136004.0,19415795.333333332,415132.0,27617812.285714287
2023-09-12,0.223,0.2378,0.2213,0.2252,45085077.0,48889.0,22526916.0,0.22639999999999985,0.23695714285714287,0.232355,0.22725915614575326,0.2332861938021384,0.23135593822668057,53.833333333333336,0.2693396895776291,0.1953703104223709,0.0056179630243309575,0.008395185002075945,-0.0027772219777449873,0.016500000000000015,0.02053571428571429,5698974624.089998,-0.02639999999999998,4.259259259259274,-79.73640856672158,20.263591433278428,29.971313694542715,0.9865470852017971,0.231,0.2364,0.2176,0.223,53035213.0,67923.0,26263476.0,-3.463203463203466,56.343577620173356,0.26991213735287467,0.1931278626471253,0.0070090297934228,0.009089490496512191,-0.0020804607030893915,0.01880000000000001,0.020471428571428574,5653889547.089998,-0.007099999999999995,7.7815369743837515,-70.76923076923077,29.230769230769234,38.60139860139862,0.22969999999999988,0.2293183122915065,0.2405142857142857,0.2359815917361845,0.23152,0.2320039317242259,144879.0,19993014.666666668,388860.0,24682355.85714286
2023-09-13,0.2252,0.2302,0.2214,0.2236,42582654.0,45370.0,21390934.0,0.2239333333333332,0.23222857142857145,0.23308,0.2254295780728766,0.23086464535160378,0.2306172774431872,45.08670520231214,0.26868813626710547,0.19747186373289455,0.004336438199266657,0.007583435641514088,-0.003246997442247431,0.008799999999999975,0.01956428571428571,5656391970.089998,-0.035500000000000004,-4.362703165098381,-85.32423208191126,14.675767918088727,21.390042860712143,-0.7104795737122638,0.223,0.2378,0.2213,0.2252,45085077.0,48889.0,22526916.0,0.9865470852017971,53.833333333333336,0.2693396895776291,0.1953703104223709,0.0056179630243309575,0.008395185002075945,-0.0027772219777449873,0.016500000000000015,0.02053571428571429,5698974624.089998,-0.02639999999999998,4.259259259259274,-79.73640856672158,20.263591433278428,29.971313694542715,0.22639999999999985,0.22725915614575326,0.23695714285714287,0.2332861938021384,0.232355,0.23135593822668057,166928.0,23711180.333333332,367258.0,23493852.85714286
2023-09-14,0.2236,0.2312,0.2232,0.2296,33758729.0,34562.0,15943402.0,0.22613333333333321,0.22944285714285714,0.233705,0.2275147890364383,0.23054848401370284,0.23052039387716938,50.09487666034156,0.26856305653301493,0.19884694346698506,0.0037616089124012375,0.006819070295691518,-0.0030574613832902806,0.00799999999999998,0.017771428571428566,5690150699.089998,-0.03780000000000003,0.08718395815170421,-75.08532423208192,24.914675767918087,19.95134503976176,2.68336314847943,0.2252,0.2302,0.2214,0.2236,42582654.0,45370.0,21390934.0,-0.7104795737122638,45.08670520231214,0.26868813626710547,0.19747186373289455,0.004336438199266657,0.007583435641514088,-0.003246997442247431,0.008799999999999975,0.01956428571428571,5656391970.089998,-0.035500000000000004,-4.362703165098381,-85.32423208191126,14.675767918088727,21.390042860712143,0.2239333333333332,0.2254295780728766,0.23222857142857145,0.23086464535160378,0.23308,0.2306172774431872,162182.0,23393775.333333332,340048.0,20983770.57142857
2023-09-15,0.2296,0.2379,0.2272,0.2372,33266602.0,34567.0,15166505.0,0.2301333333333332,0.22924285714285714,0.23518499999999998,0.23235739451821913,0.23221136301027712,0.23115654684124848,53.16117542297417,0.26781880713948003,0.20255119286051992,0.0038746445547442887,0.006230185147502072,-0.0023555405927577835,0.010699999999999987,0.017278571428571424,5723417301.089998,-0.012899999999999995,3.085614950021731,-62.11604095563141,37.88395904436859,25.82480091012515,3.3101045296167224,0.2236,0.2312,0.2232,0.2296,33758729.0,34562.0,15943402.0,2.68336314847943,50.09487666034156,0.26856305653301493,0.19884694346698506,0.0037616089124012375,0.006819070295691518,-0.0030574613832902806,0.00799999999999998,0.017771428571428566,5690150699.089998,-0.03780000000000003,0.08718395815170421,-75.08532423208192,24.914675767918087,19.95134503976176,0.22613333333333321,0.2275147890364383,0.22944285714285714,0.23054848401370284,0.233705,0.23052039387716938,128821.0,19953750.666666668,332748.0,20624587.714285713
2023-09-16,0.2371,0.2413,0.234,0.2362,29812974.0,29400.0,14864094.0,0.2343333333333332,0.2294,0.236485,0.23427869725910955,0.23320852225770783,0.23163687571351052,41.612200435729854,0.26692585032348465,0.20604414967651535,0.0038392776699162634,0.005752003651984911,-0.0019127259820686474,0.007299999999999973,0.015721428571428563,5693604327.089998,-0.02049999999999999,-6.120826709061999,-63.82252559726964,36.17747440273036,32.9920364050057,-0.37958667229017795,0.2296,0.2379,0.2272,0.2372,33266602.0,34567.0,15166505.0,3.3101045296167224,53.16117542297417,0.26781880713948003,0.20255119286051992,0.0038746445547442887,0.006230185147502072,-0.0023555405927577835,0.010699999999999987,0.017278571428571424,5723417301.089998,-0.012899999999999995,3.085614950021731,-62.11604095563141,37.88395904436859,25.82480091012515,0.2301333333333332,0.23235739451821913,0.22924285714285714,0.23221136301027712,0.23518499999999998,0.23115654684124848,114499.0,17500280.333333332,308267.0,19286685.85714286
2023-09-17,0.2361,0.2363,0.2233,0.2256,26526890.0,25547.0,10811269.0,0.23299999999999987,0.2286285714285714,0.23742000000000002,0.22993934862955479,0.23130639169328088,0.23106193516936666,32.349841938883046,0.2650540446016935,0.20978595539830652,0.0029222320744536345,0.005186049336478656,-0.002263817262025021,0.013000000000000012,0.01477857142857142,5667077437.089998,-0.023499999999999993,-12.92937089926669,-81.33802816901408,18.661971830985916,30.907801759361636,-4.447268106734438,0.2371,0.2413,0.234,0.2362,29812974.0,29400.0,14864094.0,-0.37958667229017795,41.612200435729854,0.26692585032348465,0.20604414967651535,0.0038392776699162634,0.005752003651984911,-0.0019127259820686474,0.007299999999999973,0.015721428571428563,5693604327.089998,-0.02049999999999999,-6.120826709061999,-63.82252559726964,36.17747440273036,32.9920364050057,0.2343333333333332,0.23427869725910955,0.2294,0.23320852225770783,0.236485,0.23163687571351052,98529.0,15324667.0,310827.0,19785496.57142857
2023-09-18,0.2255,0.2345,0.2233,0.227,33164918.0,33249.0,16857991.0,0.2295999999999999,0.22920000000000001,0.23797000000000001,0.22846967431477738,0.23022979376996064,0.23067508420085556,27.045454545454547,0.2642117987187571,0.21172820128124295,0.002282128179724202,0.004605265105127765,-0.0023231369254035628,0.011199999999999988,0.014299999999999993,5700242355.089998,-0.0116,-15.108451757666419,-78.87323943661968,21.126760563380305,25.32206893236554,0.6651884700665195,0.2361,0.2363,0.2233,0.2256,26526890.0,25547.0,10811269.0,-4.447268106734438,32.349841938883046,0.2650540446016935,0.20978595539830652,0.0029222320744536345,0.005186049336478656,-0.002263817262025021,0.013000000000000012,0.01477857142857142,5667077437.089998,-0.023499999999999993,-12.92937089926669,-81.33802816901408,18.661971830985916,30.907801759361636,0.23299999999999987,0.22993934862955479,0.2286285714285714,0.23130639169328088,0.23742000000000002,0.23106193516936666,89514.0,13613956.0,286258.0,18138085.14285714
2023-09-19,0.2269,0.2359,0.2253,0.2337,29434719.0,29724.0,14513413.0,0.22876666666666653,0.2304142857142857,0.23796499999999998,0.2310848371573887,0.23109734532747048,0.2309631714198217,39.405684754521964,0.2642101820139074,0.21171981798609257,0.002289088055024785,0.004142029695107169,-0.001852941640082384,0.010599999999999998,0.013421428571428567,5729677074.089998,-0.0014000000000000123,-6.5573770491803245,-59.957173447537485,40.04282655246252,26.610519648942926,2.9969149405024242,0.2255,0.2345,0.2233,0.227,33164918.0,33249.0,16857991.0,0.6651884700665195,27.045454545454547,0.2642117987187571,0.21172820128124295,0.002282128179724202,0.004605265105127765,-0.0023231369254035628,0.011199999999999988,0.014299999999999993,5700242355.089998,-0.0116,-15.108451757666419,-78.87323943661968,21.126760563380305,25.32206893236554,0.2295999999999999,0.22846967431477738,0.22920000000000001,0.23022979376996064,0.23797000000000001,0.23067508420085556,88196.0,14177784.666666666,251584.0,16794444.42857143
2023-09-20,0.2337,0.2365,0.2248,0.2276,29238464.0,29446.0,13724475.0,0.22943333333333318,0.2309857142857143,0.23787499999999998,0.22934241857869436,0.23022300899560286,0.2306428693798387,31.079323797139153,0.26425584432621857,0.21149415567378138,0.0017818447886076005,0.003669992713807256,-0.0018881479251996553,0.011699999999999988,0.012921428571428566,5700438610.089998,-0.003400000000000014,-11.336190105181142,-70.49180327868851,29.508196721311485,30.225927945718116,-2.610183996576805,0.2269,0.2359,0.2253,0.2337,29434719.0,29724.0,14513413.0,2.9969149405024242,39.405684754521964,0.2642101820139074,0.21171981798609257,0.002289088055024785,0.004142029695107169,-0.001852941640082384,0.010599999999999998,0.013421428571428567,5729677074.089998,-0.0014000000000000123,-6.5573770491803245,-59.957173447537485,40.04282655246252,26.610519648942926,0.22876666666666653,0.2310848371573887,0.2304142857142857,0.23109734532747048,0.23796499999999998,0.2309631714198217,88520.0,14060891.0,232419.0,15649658.285714285
2023-09-21,0.2276,0.2375,0.2229,0.2234,49486168.0,51697.0,24289003.0,0.2282333333333332,0.2301,0.23754,0.22637120928934718,0.22851725674670215,0.22995307229604453,32.5170068027211,0.26450035295716107,0.21057964704283896,0.001029083314478929,0.003141810833941591,-0.0021127275194626617,0.014600000000000002,0.012757142857142852,5650952442.089998,0.0003999999999999837,-10.317141710156562,-79.25925925925928,20.740740740740716,30.097254671504924,-1.8453427065026402,0.2337,0.2365,0.2248,0.2276,29238464.0,29446.0,13724475.0,-2.610183996576805,31.079323797139153,0.26425584432621857,0.21149415567378138,0.0017818447886076005,0.003669992713807256,-0.0018881479251996553,0.011699999999999988,0.012921428571428566,5700438610.089998,-0.003400000000000014,-11.336190105181142,-70.49180327868851,29.508196721311485,30.225927945718116,0.22943333333333318,0.22934241857869436,0.2309857142857143,0.23022300899560286,0.23787499999999998,0.2306428693798387,92419.0,15031959.666666666,216495.0,14554449.857142856
2023-09-22,0.2233,0.2238,0.2184,0.2234,22559181.0,22212.0,10696813.0,0.22479999999999986,0.22812857142857143,0.23613000000000003,0.22488560464467358,0.2272379425600266,0.22932897017261172,37.936507936507915,0.26294351583762726,0.20931648416237283,0.00042758548358634574,0.002598965763870542,-0.002171380280284196,0.005399999999999988,0.011714285714285707,5628393261.089998,-0.0018000000000000238,-6.3704945515507205,-68.06083650190116,31.93916349809884,27.396033653383693,0.04478280340348813,0.2276,0.2375,0.2229,0.2234,49486168.0,51697.0,24289003.0,-1.8453427065026402,32.5170068027211,0.26450035295716107,0.21057964704283896,0.001029083314478929,0.003141810833941591,-0.0021127275194626617,0.014600000000000002,0.012757142857142852,5650952442.089998,0.0003999999999999837,-10.317141710156562,-79.25925925925928,20.740740740740716,30.097254671504924,0.2282333333333332,0.22637120928934718,0.2301,0.22851725674670215,0.23754,0.22995307229604453,110867.0,17508963.666666668,233630.0,15746678.57142857
2023-09-23,0.2234,0.2249,0.2154,0.2212,16308660.0,16486.0,7403590.0,0.22266666666666654,0.2259857142857143,0.23423500000000003,0.2230428023223368,0.22572845692001997,0.2285547825371249,38.73581847649919,0.2595271685402695,0.20894283145973053,-0.00022404484527352442,0.0020343636420417288,-0.002258408487315253,0.00949999999999998,0.01187857142857142,5612084601.089998,-0.0023999999999999855,-5.912377711612082,-76.42585551330794,23.574144486692067,25.418016241843887,-0.9847806624888003,0.2233,0.2238,0.2184,0.2234,22559181.0,22212.0,10696813.0,0.04478280340348813,37.936507936507915,0.26294351583762726,0.20931648416237283,0.00042758548358634574,0.002598965763870542,-0.002171380280284196,0.005399999999999988,0.011714285714285707,5628393261.089998,-0.0018000000000000238,-6.3704945515507205,-68.06083650190116,31.93916349809884,27.396033653383693,0.22479999999999986,0.22488560464467358,0.22812857142857143,0.2272379425600266,0.23613000000000003,0.22932897017261172,103355.0,16236763.666666666,221275.0,15108151.142857144
2023-09-24,0.2214,0.2217,0.2125,0.2154,15922115.0,17750.0,7067802.0,0.21999999999999986,0.22452857142857144,0.23163499999999998,0.2192214011611684,0.223146342690015,0.22730194610501778,37.69716088328076,0.2529506009087462,0.21031939909125374,-0.001194706272781676,0.001388549659077048,-0.002583255931858724,0.009200000000000014,0.011092857142857137,5596162486.089998,-0.01419999999999999,-6.7532467532467555,-89.9305555555555,10.069444444444494,21.860917476411814,-2.710027100271005,0.2234,0.2249,0.2154,0.2212,16308660.0,16486.0,7403590.0,-0.9847806624888003,38.73581847649919,0.2595271685402695,0.20894283145973053,-0.00022404484527352442,0.0020343636420417288,-0.002258408487315253,0.00949999999999998,0.01187857142857142,5612084601.089998,-0.0023999999999999855,-5.912377711612082,-76.42585551330794,23.574144486692067,25.418016241843887,0.22266666666666654,0.2230428023223368,0.2259857142857143,0.22572845692001997,0.23423500000000003,0.2285547825371249,90395.0,14129802.0,208361.0,14042364.857142856
2023-09-25,0.2153,0.219,0.2126,0.2162,15505771.0,17919.0,7282976.0,0.21759999999999988,0.2229857142857143,0.22994000000000003,0.2177107005805842,0.22140975701751126,0.2262446179045399,43.95017793594307,0.2504493457514752,0.20943065424852486,-0.0018777634450711789,0.0007352870382474027,-0.0026130504833185818,0.006399999999999989,0.010207142857142849,5611668257.089998,-0.02099999999999999,-3.0493273542600896,-87.15277777777774,12.847222222222257,15.496937051119621,0.4180213655364663,0.2214,0.2217,0.2125,0.2154,15922115.0,17750.0,7067802.0,-2.710027100271005,37.69716088328076,0.2529506009087462,0.21031939909125374,-0.001194706272781676,0.001388549659077048,-0.002583255931858724,0.009200000000000014,0.011092857142857137,5596162486.089998,-0.01419999999999999,-6.7532467532467555,-89.9305555555555,10.069444444444494,21.860917476411814,0.21999999999999986,0.2192214011611684,0.22452857142857144,0.223146342690015,0.23163499999999998,0.22730194610501778,56448.0,8389401.666666666,200564.0,13507583.857142856
2023-09-26,0.2162,0.2177,0.2103,0.2139,13149518.0,13508.0,5813135.0,0.21516666666666653,0.22015714285714286,0.2278,0.2158053502902921,0.21953231776313342,0.22506894000886943,39.96447602131438,0.24525731636685527,0.21034268363314473,-0.002574998968146197,7.32298369686828e-05,-0.00264822880511488,0.007400000000000018,0.009557142857142849,5598518739.089998,-0.022299999999999986,-5.017761989342806,-88.38709677419348,11.612903225806516,11.509856630824437,-1.063829787234041,0.2153,0.219,0.2126,0.2162,15505771.0,17919.0,7282976.0,0.4180213655364663,43.95017793594307,0.2504493457514752,0.20943065424852486,-0.0018777634450711789,0.0007352870382474027,-0.0026130504833185818,0.006399999999999989,0.010207142857142849,5611668257.089998,-0.02099999999999999,-3.0493273542600896,-87.15277777777774,12.847222222222257,15.496937051119621,0.21759999999999988,0.2177107005805842,0.2229857142857143,0.22140975701751126,0.22994000000000003,0.2262446179045399,52155.0,7251456.0,185234.0,12139724.57142857
2023-09-27,0.2139,0.2161,0.2093,0.2113,19368569.0,19140.0,9477403.0,0.21379999999999985,0.21782857142857143,0.22591,0.21355267514514603,0.21747423832235008,0.2237576123889771,39.26701570680628,0.24176936880657535,0.21005063119342465,-0.003299328805676238,-0.0006012818915603014,-0.0026980469141159365,0.006799999999999973,0.009414285714285707,5579150170.089998,-0.014300000000000007,-5.500894454382832,-93.75000000000007,6.2499999999999245,10.236708482676248,-1.215521271622262,0.2162,0.2177,0.2103,0.2139,13149518.0,13508.0,5813135.0,-1.063829787234041,39.96447602131438,0.24525731636685527,0.21034268363314473,-0.002574998968146197,7.32298369686828e-05,-0.00264822880511488,0.007400000000000018,0.009557142857142849,5598518739.089998,-0.022299999999999986,-5.017761989342806,-88.38709677419348,11.612903225806516,11.509856630824437,0.21516666666666653,0.2158053502902921,0.22015714285714286,0.21953231776313342,0.2278,0.22506894000886943,49177.0,6721304.333333333,169018.0,10896827.714285715
2023-09-28,0.2112,0.2196,0.2097,0.2183,22688427.0,24109.0,11641224.0,0.21449999999999989,0.21710000000000002,0.22489499999999998,0.215926337572573,0.21768067874176256,0.2232378397805031,40.308747855917666,0.23991070756507346,0.2098792924349265,-0.0032708199455567244,-0.0011351895023595862,-0.002135630443197138,0.009899999999999992,0.009549999999999993,5601838597.089998,-0.008700000000000013,-4.921602787456447,-71.87500000000003,28.12499999999996,15.329301075268816,3.361742424242422,0.2139,0.2161,0.2093,0.2113,19368569.0,19140.0,9477403.0,-1.215521271622262,39.26701570680628,0.24176936880657535,0.21005063119342465,-0.003299328805676238,-0.0006012818915603014,-0.0026980469141159365,0.006799999999999973,0.009414285714285707,5579150170.089998,-0.014300000000000007,-5.500894454382832,-93.75000000000007,6.2499999999999245,10.236708482676248,0.21379999999999985,0.21355267514514603,0.21782857142857143,0.21747423832235008,0.22591,0.2237576123889771,50567.0,7524504.666666667,158712.0,10290103.142857144
2023-09-29,0.2183,0.2216,0.215,0.2192,20215714.0,22495.0,9988428.0,0.21626666666666652,0.2165,0.22410000000000002,0.2175631687862865,0.2180605090563219,0.22285328361093137,32.558139534883736,0.2385122754694084,0.20968772453059165,-0.0031394147708698195,-0.0015360345560616329,-0.0016033802148081866,0.006599999999999995,0.009257142857142851,5622054311.089998,-0.014499999999999985,-7.588532883642496,-69.0625,30.9375,21.77083333333331,0.4122766834631296,0.2112,0.2196,0.2097,0.2183,22688427.0,24109.0,11641224.0,3.361742424242422,40.308747855917666,0.23991070756507346,0.2098792924349265,-0.0032708199455567244,-0.0011351895023595862,-0.002135630443197138,0.009899999999999992,0.009549999999999993,5601838597.089998,-0.008700000000000013,-4.921602787456447,-71.87500000000003,28.12499999999996,15.329301075268816,0.21449999999999989,0.215926337572573,0.21710000000000002,0.21768067874176256,0.22489499999999998,0.2232378397805031,56757.0,8977254.0,131124.0,8483277.57142857
2023-09-30,0.2191,0.2238,0.2183,0.2228,15716484.0,16151.0,7184489.0,0.22009999999999988,0.21672857142857144,0.22369,0.22018158439314325,0.21924538179224143,0.22284820898131885,37.638376383763834,0.23773772317179437,0.20964227682820563,-0.0027135057049941236,-0.001771528785848131,-0.0009419769191459926,0.005500000000000005,0.009128571428571425,5637770795.089998,-0.004799999999999999,-5.673158340389495,-52.1276595744681,47.8723404255319,35.64494680851064,1.6887266088544084,0.2183,0.2216,0.215,0.2192,20215714.0,22495.0,9988428.0,0.4122766834631296,32.558139534883736,0.2385122754694084,0.20968772453059165,-0.0031394147708698195,-0.0015360345560616329,-0.0016033802148081866,0.006599999999999995,0.009257142857142851,5622054311.089998,-0.014499999999999985,-7.588532883642496,-69.0625,30.9375,21.77083333333331,0.21626666666666652,0.2175631687862865,0.2165,0.2180605090563219,0.22410000000000002,0.22285328361093137,65744.0,10369018.333333334,131407.0,8382079.714285715
2023-10-01,0.2228,0.237,0.2225,0.2349,34732284.0,38731.0,18112230.0,0.2256333333333332,0.21951428571428572,0.22428499999999998,0.22754079219657164,0.22315903634418108,0.22399599860214564,58.348294434470375,0.23919148392993733,0.20937851607006264,-0.001383650958738325,-0.00169395322042617,0.00031030226168784493,0.014499999999999985,0.00923571428571428,5672503079.089998,0.01150000000000001,4.122340425531923,-9.219858156028346,90.78014184397165,56.52999408983453,5.430879712746858,0.2191,0.2238,0.2183,0.2228,15716484.0,16151.0,7184489.0,1.6887266088544084,37.638376383763834,0.23773772317179437,0.20964227682820563,-0.0027135057049941236,-0.001771528785848131,-0.0009419769191459926,0.005500000000000005,0.009128571428571425,5637770795.089998,-0.004799999999999999,-5.673158340389495,-52.1276595744681,47.8723404255319,35.64494680851064,0.22009999999999988,0.22018158439314325,0.21672857142857144,0.21924538179224143,0.22369,0.22284820898131885,62755.0,9604713.666666666,131072.0,8350779.571428572
2023-10-02,0.2349,0.2389,0.2201,0.2218,36443568.0,42362.0,16520834.0,0.22649999999999984,0.2203142857142857,0.22411499999999998,0.22467039609828582,0.2228192772581358,0.22378685587813177,46.14243323442136,0.2390550591838398,0.20917494081616017,-0.0013709881124269185,-0.0016293601988263196,0.0002583720863994011,0.01880000000000001,0.009778571428571425,5636059511.089998,-0.0015999999999999903,-2.2907488986784186,-57.77027027027031,42.22972972972969,60.2940706664111,-5.576841209025117,0.2228,0.237,0.2225,0.2349,34732284.0,38731.0,18112230.0,5.430879712746858,58.348294434470375,0.23919148392993733,0.20937851607006264,-0.001383650958738325,-0.00169395322042617,0.00031030226168784493,0.014499999999999985,0.00923571428571428,5672503079.089998,0.01150000000000001,4.122340425531923,-9.219858156028346,90.78014184397165,56.52999408983453,0.2256333333333332,0.22754079219657164,0.21951428571428572,0.22315903634418108,0.22428499999999998,0.22399599860214564,77377.0,11761715.666666666,152053.0,9928555.0
2023-10-03,0.222,0.2285,0.2152,0.2182,28561407.0,32606.0,13135173.0,0.22496666666666654,0.22092857142857142,0.22384500000000002,0.2214351980491429,0.22166445794360184,0.22325477436592875,37.94712286158632,0.23901761730173982,0.20867238269826022,-0.0016326227700185214,-0.0016300127130647601,-2.610056953761264e-06,0.013300000000000006,0.009971428571428567,5607498104.089998,-0.0030000000000000027,-6.632434745400085,-69.93243243243245,30.06756756756755,54.35914638042298,-1.7117117117117109,0.2349,0.2389,0.2201,0.2218,36443568.0,42362.0,16520834.0,-5.576841209025117,46.14243323442136,0.2390550591838398,0.20917494081616017,-0.0013709881124269185,-0.0016293601988263196,0.0002583720863994011,0.01880000000000001,0.009778571428571425,5636059511.089998,-0.0015999999999999903,-2.2907488986784186,-57.77027027027031,42.22972972972969,60.2940706664111,0.22649999999999984,0.22467039609828582,0.2203142857142857,0.2228192772581358,0.22411499999999998,0.22378685587813177,97244.0,13939184.333333334,176496.0,11248249.0
2023-10-04,0.2182,0.223,0.2098,0.2194,23043366.0,25385.0,10861436.0,0.21979999999999988,0.22208571428571428,0.223335,0.22041759902457148,0.2210983434577014,0.22288765299774507,43.09764309764311,0.23837827441944512,0.2082917255805549,-0.0017232753049405136,-0.001648665231439911,-7.461007350060265e-05,0.013200000000000017,0.010078571428571426,5630541470.089998,0.0040000000000000036,-3.602811950790852,-65.87837837837837,34.12162162162163,35.472972972972975,0.5499541704857959,0.222,0.2285,0.2152,0.2182,28561407.0,32606.0,13135173.0,-1.7117117117117109,37.94712286158632,0.23901761730173982,0.20867238269826022,-0.0016326227700185214,-0.0016300127130647601,-2.610056953761264e-06,0.013300000000000006,0.009971428571428567,5607498104.089998,-0.0030000000000000027,-6.632434745400085,-69.93243243243245,30.06756756756755,54.35914638042298,0.22496666666666654,0.2214351980491429,0.22092857142857142,0.22166445794360184,0.22384500000000002,0.22325477436592875,113699.0,15922745.666666666,195594.0,12294254.42857143
2023-10-05,0.2194,0.2212,0.2131,0.2158,11938419.0,14213.0,5572979.0,0.21779999999999988,0.22172857142857144,0.22226500000000002,0.21810879951228573,0.21977375759327605,0.22221263842653127,43.5374149659864,0.2361560459609886,0.20837395403901143,-0.0020618403929285045,-0.0017313002637376297,-0.00033054012919087484,0.008099999999999996,0.009614285714285712,5618603051.089998,-0.00040000000000001146,-3.40196956132498,-78.0405405405406,21.959459459459392,28.71621621621621,-1.6408386508660073,0.2182,0.223,0.2098,0.2194,23043366.0,25385.0,10861436.0,0.5499541704857959,43.09764309764311,0.23837827441944512,0.2082917255805549,-0.0017232753049405136,-0.001648665231439911,-7.461007350060265e-05,0.013200000000000017,0.010078571428571426,5630541470.089998,0.0040000000000000036,-3.602811950790852,-65.87837837837837,34.12162162162163,35.472972972972975,0.21979999999999988,0.22041759902457148,0.22208571428571428,0.2210983434577014,0.223335,0.22288765299774507,100353.0,13505814.333333334,201839.0,12491973.42857143
2023-10-06,0.2159,0.2277,0.2156,0.2251,21310198.0,19578.0,10825104.0,0.22009999999999988,0.2225714285714286,0.22171,0.22160439975614288,0.22110531819495702,0.2224876252430521,51.248164464023496,0.2340580916912941,0.20936190830870588,-0.0015617208420025397,-0.0016973843793906117,0.00013566353738807204,0.0121,0.010092857142857141,5639913249.089998,0.011199999999999988,0.7609668755595322,-46.621621621621664,53.37837837837833,36.48648648648646,4.2612320518758615,0.2194,0.2212,0.2131,0.2158,11938419.0,14213.0,5572979.0,-1.6408386508660073,43.5374149659864,0.2361560459609886,0.20837395403901143,-0.0020618403929285045,-0.0017313002637376297,-0.00033054012919087484,0.008099999999999996,0.009614285714285712,5618603051.089998,-0.00040000000000001146,-3.40196956132498,-78.0405405405406,21.959459459459392,28.71621621621621,0.21779999999999988,0.21810879951228573,0.22172857142857144,0.21977375759327605,0.22226500000000002,0.22221263842653127,72204.0,9856529.333333334,191943.0,11625081.285714285
2023-10-07,0.2252,0.2267,0.2198,0.2207,10912853.0,11934.0,4971027.0,0.22053333333333316,0.22227142857142854,0.22146500000000002,0.22115219987807144,0.22100398864621776,0.2223173752199043,49.644381223328594,0.2336818606526422,0.20924813934735784,-0.0015030890474935776,-0.0016585253130112052,0.00015543626551762753,0.006900000000000017,0.00990714285714286,5629000396.089998,0.00940000000000002,-0.22603978300180794,-61.48648648648649,38.51351351351351,37.950450450450425,-1.9982238010657212,0.2159,0.2277,0.2156,0.2251,21310198.0,19578.0,10825104.0,4.2612320518758615,51.248164464023496,0.2340580916912941,0.20936190830870588,-0.0015617208420025397,-0.0016973843793906117,0.00013566353738807204,0.0121,0.010092857142857141,5639913249.089998,0.011199999999999988,0.7609668755595322,-46.621621621621664,53.37837837837833,36.48648648648646,0.22009999999999988,0.22160439975614288,0.2225714285714286,0.22110531819495702,0.22171,0.2224876252430521,59176.0,9086506.333333334,189026.0,11744606.42857143
2023-10-08,0.2207,0.2222,0.2168,0.2186,11307355.0,11786.0,5114900.0,0.2214666666666665,0.21994285714285716,0.221045,0.21987609993903573,0.22040299148466333,0.22196333948467534,52.40240240240239,0.23303613268850945,0.20905386731149053,-0.0016075446039609809,-0.0016483291712011605,4.078456724017961e-05,0.005400000000000016,0.009635714285714287,5617693041.089998,0.0002999999999999947,1.485608170844932,-68.58108108108115,31.41891891891885,41.10360360360358,-0.9515178975985585,0.2252,0.2267,0.2198,0.2207,10912853.0,11934.0,4971027.0,-1.9982238010657212,49.644381223328594,0.2336818606526422,0.20924813934735784,-0.0015030890474935776,-0.0016585253130112052,0.00015543626551762753,0.006900000000000017,0.00990714285714286,5629000396.089998,0.00940000000000002,-0.22603978300180794,-61.48648648648649,38.51351351351351,37.950450450450425,0.22053333333333316,0.22115219987807144,0.22227142857142854,0.22100398864621776,0.22146500000000002,0.2223173752199043,45725.0,7123036.666666667,184809.0,11428397.57142857
2023-10-09,0.2186,0.2215,0.2023,0.2075,31427587.0,33375.0,15001646.0,0.21559999999999988,0.2179,0.219735,0.21368804996951785,0.2171772436134975,0.22058587858137294,44.343302990897264,0.23162914274231133,0.2078408572576887,-0.002556533491746449,-0.001829970035310218,-0.0007265634564362308,0.019199999999999995,0.010550000000000002,5586265454.089998,-0.011700000000000016,-4.024051803885298,-85.79234972677601,14.207650273223999,28.046694235218805,-5.077767612076852,0.2207,0.2222,0.2168,0.2186,11307355.0,11786.0,5114900.0,-0.9515178975985585,52.40240240240239,0.23303613268850945,0.20905386731149053,-0.0016075446039609809,-0.0016483291712011605,4.078456724017961e-05,0.005400000000000016,0.009635714285714287,5617693041.089998,0.0002999999999999947,1.485608170844932,-68.58108108108115,31.41891891891885,41.10360360360358,0.2214666666666665,0.21987609993903573,0.21994285714285716,0.22040299148466333,0.221045,0.22196333948467534,43298.0,6970343.666666667,157864.0,9571636.142857144
2023-10-10,0.2075,0.2128,0.2011,0.2043,20566208.0,20768.0,9400432.0,0.2101333333333332,0.21591428571428573,0.21857000000000001,0.20899402498475894,0.21395793271012312,0.2190348425260041,43.83033419023137,0.23171872016968872,0.2054212798303113,-0.0035261796745783835,-0.0021692119631638515,-0.001356967711414532,0.011699999999999988,0.010857142857142857,5565699246.089998,-0.01849999999999999,-4.488078541374474,-91.53439153439152,8.465608465608486,18.03072588591713,-1.542168674698786,0.2186,0.2215,0.2023,0.2075,31427587.0,33375.0,15001646.0,-5.077767612076852,44.343302990897264,0.23162914274231133,0.2078408572576887,-0.002556533491746449,-0.001829970035310218,-0.0007265634564362308,0.019199999999999995,0.010550000000000002,5586265454.089998,-0.011700000000000016,-4.024051803885298,-85.79234972677601,14.207650273223999,28.046694235218805,0.21559999999999988,0.21368804996951785,0.2179,0.2171772436134975,0.219735,0.22058587858137294,57095.0,8362524.333333333,148877.0,9354609.285714285
2023-10-11,0.2043,0.2067,0.199,0.2059,22408428.0,25049.0,11307339.0,0.20589999999999986,0.21398571428571428,0.21769500000000003,0.20744701249237946,0.21194344953259234,0.21778390514257515,46.484375000000014,0.23178575471422871,0.20360424528577134,-0.004118054265975751,-0.0025589804237262314,-0.00155907384224952,0.007699999999999985,0.010921428571428572,5588107674.089998,-0.028999999999999998,-2.555608140085186,-82.70676691729325,17.293233082706745,13.322163940513093,0.7831620166421881,0.2075,0.2128,0.2011,0.2043,20566208.0,20768.0,9400432.0,-1.542168674698786,43.83033419023137,0.23171872016968872,0.2054212798303113,-0.0035261796745783835,-0.0021692119631638515,-0.001356967711414532,0.011699999999999988,0.010857142857142857,5565699246.089998,-0.01849999999999999,-4.488078541374474,-91.53439153439152,8.465608465608486,18.03072588591713,0.2101333333333332,0.20899402498475894,0.21591428571428573,0.21395793271012312,0.21857000000000001,0.2190348425260041,65929.0,9838992.666666666,137039.0,8821074.857142856
2023-10-12,0.2058,0.2065,0.1993,0.2026,14093150.0,17205.0,6598337.0,0.2042666666666665,0.2121,0.216655,0.20502350624618973,0.20960758714944425,0.21633781893852036,39.26128590971272,0.23198841380589663,0.20132158619410334,-0.00479809214509358,-0.0030068027679997014,-0.0017912893770938784,0.007199999999999984,0.01072857142857143,5574014524.089998,-0.019199999999999995,-7.191937700412277,-90.97744360902257,9.022556390977426,11.59379931309757,-1.554907677356661,0.2043,0.2067,0.199,0.2059,22408428.0,25049.0,11307339.0,0.7831620166421881,46.484375000000014,0.23178575471422871,0.20360424528577134,-0.004118054265975751,-0.0025589804237262314,-0.00155907384224952,0.007699999999999985,0.010921428571428572,5588107674.089998,-0.028999999999999998,-2.555608140085186,-82.70676691729325,17.293233082706745,13.322163940513093,0.20589999999999986,0.20744701249237946,0.21398571428571428,0.21194344953259234,0.21769500000000003,0.21778390514257515,79192.0,11903139.0,136703.0,8884775.285714285
2023-10-13,0.2027,0.2109,0.202,0.2091,17224122.0,16515.0,9042068.0,0.20586666666666653,0.2098142857142857,0.21605,0.20706175312309488,0.20948069036208317,0.21564850284913747,43.58322744599746,0.23158190265213782,0.20051809734786216,-0.004757687723945525,-0.0033569797591888662,-0.0014007079647566588,0.008899999999999991,0.010892857142857143,5591238646.089998,-0.009099999999999997,-4.607664233576636,-74.68671679197995,25.31328320802005,17.20969089390142,3.1573754316724307,0.2058,0.2065,0.1993,0.2026,14093150.0,17205.0,6598337.0,-1.554907677356661,39.26128590971272,0.23198841380589663,0.20132158619410334,-0.00479809214509358,-0.0030068027679997014,-0.0017912893770938784,0.007199999999999984,0.01072857142857143,5574014524.089998,-0.019199999999999995,-7.191937700412277,-90.97744360902257,9.022556390977426,11.59379931309757,0.2042666666666665,0.20502350624618973,0.2121,0.20960758714944425,0.216655,0.21633781893852036,63022.0,9102036.0,139695.0,9031255.0
2023-10-14,0.2091,0.217,0.2085,0.2128,23164890.0,24881.0,10704138.0,0.20816666666666653,0.2086857142857143,0.21592000000000003,0.20993087656154744,0.21031051777156237,0.21537721686350533,43.65482233502537,0.23151819152795777,0.20032180847204228,-0.004376656479753216,-0.0035609151033017365,-0.0008157413764514794,0.008500000000000008,0.011107142857142857,5614403536.089998,-0.0066000000000000225,-4.4883303411131115,-65.41353383458652,34.58646616541349,22.97410192147034,1.769488283118116,0.2027,0.2109,0.202,0.2091,17224122.0,16515.0,9042068.0,3.1573754316724307,43.58322744599746,0.23158190265213782,0.20051809734786216,-0.004757687723945525,-0.0033569797591888662,-0.0014007079647566588,0.008899999999999991,0.010892857142857143,5591238646.089998,-0.009099999999999997,-4.607664233576636,-74.68671679197995,25.31328320802005,17.20969089390142,0.20586666666666653,0.20706175312309488,0.2098142857142857,0.20948069036208317,0.21605,0.21564850284913747,58769.0,8982581.333333334,136632.0,8776535.57142857
2023-10-15,0.2129,0.2152,0.2108,0.2119,10780935.0,13185.0,4944973.0,0.21126666666666652,0.20772857142857143,0.21570499999999998,0.21091543828077372,0.21070788832867177,0.2150460533526953,32.98816568047337,0.23140514750167746,0.2000048524983225,-0.004100046171856081,-0.003668741317012606,-0.00043130485484347506,0.004400000000000015,0.010385714285714288,5603622601.089998,-0.003899999999999987,-9.79140059599829,-67.66917293233084,32.33082706766916,30.743525480367584,-0.46970408642555234,0.2091,0.217,0.2085,0.2128,23164890.0,24881.0,10704138.0,1.769488283118116,43.65482233502537,0.23151819152795777,0.20032180847204228,-0.004376656479753216,-0.0035609151033017365,-0.0008157413764514794,0.008500000000000008,0.011107142857142857,5614403536.089998,-0.0066000000000000225,-4.4883303411131115,-65.41353383458652,34.58646616541349,22.97410192147034,0.20816666666666653,0.20993087656154744,0.2086857142857143,0.21031051777156237,0.21592000000000003,0.21537721686350533,58601.0,8781514.333333334,149579.0,9595551.42857143
2023-10-16,0.212,0.2232,0.2101,0.2139,33924580.0,35920.0,18023686.0,0.21286666666666654,0.20864285714285713,0.21570499999999998,0.21240771914038686,0.21150591624650383,0.21493690541434338,43.00884955752212,0.23140514750167746,0.2000048524983225,-0.0036770603617161113,-0.0036704051259533075,-6.655235762803753e-06,0.0131,0.00997857142857143,5637547181.089998,-0.011199999999999988,-3.561767357980161,-49.491525423728824,50.508474576271176,39.14192260311796,0.8962264150943456,0.2129,0.2152,0.2108,0.2119,10780935.0,13185.0,4944973.0,-0.46970408642555234,32.98816568047337,0.23140514750167746,0.2000048524983225,-0.004100046171856081,-0.003668741317012606,-0.00043130485484347506,0.004400000000000015,0.010385714285714288,5603622601.089998,-0.003899999999999987,-9.79140059599829,-67.66917293233084,32.33082706766916,30.743525480367584,0.21126666666666652,0.21091543828077372,0.20772857142857143,0.21070788832867177,0.21570499999999998,0.2150460533526953,54581.0,8230393.0,150978.0,9571276.142857144
2023-10-17,0.2138,0.216,0.2025,0.206,26650190.0,24348.0,13233591.0,0.21059999999999987,0.20888571428571429,0.21544000000000002,0.20920385957019344,0.21012943718487787,0.2140857715653583,39.96710526315788,0.23162464509458222,0.19925535490541782,-0.003933956831131014,-0.003723115466988849,-0.00021084136414216458,0.013499999999999984,0.009992857142857142,5610896991.089998,-0.014700000000000019,-5.591200733272239,-75.60975609756106,24.390243902438947,35.743181848793114,-3.6482694106641724,0.212,0.2232,0.2101,0.2139,33924580.0,35920.0,18023686.0,0.8962264150943456,43.00884955752212,0.23140514750167746,0.2000048524983225,-0.0036770603617161113,-0.0036704051259533075,-6.655235762803753e-06,0.0131,0.00997857142857143,5637547181.089998,-0.011199999999999988,-3.561767357980161,-49.491525423728824,50.508474576271176,39.14192260311796,0.21286666666666654,0.21240771914038686,0.20864285714285713,0.21150591624650383,0.21570499999999998,0.21493690541434338,73986.0,11224265.666666666,153523.0,10002996.142857144
2023-10-18,0.2059,0.2103,0.2019,0.2031,20303074.0,18253.0,10322252.0,0.20766666666666656,0.2084857142857143,0.21467999999999998,0.20615192978509672,0.2083720778886584,0.21303950760675275,36.95999999999999,0.23170488580982482,0.19765511419017515,-0.0043217366082380915,-0.0038428396952386976,-0.0004788969129993939,0.00839999999999999,0.009649999999999997,5590593917.089998,-0.015499999999999986,-7.429352780309939,-85.71428571428574,14.285714285714256,29.728144254808143,-1.3598834385624075,0.2138,0.216,0.2025,0.206,26650190.0,24348.0,13233591.0,-3.6482694106641724,39.96710526315788,0.23162464509458222,0.19925535490541782,-0.003933956831131014,-0.003723115466988849,-0.00021084136414216458,0.013499999999999984,0.009992857142857142,5610896991.089998,-0.014700000000000019,-5.591200733272239,-75.60975609756106,24.390243902438947,35.743181848793114,0.21059999999999987,0.20920385957019344,0.20888571428571429,0.21012943718487787,0.21544000000000002,0.2140857715653583,73453.0,12067416.666666666,157103.0,10550590.285714285
2023-10-19,0.2031,0.209,0.1991,0.2038,37505539.0,28762.0,18398519.0,0.20429999999999984,0.20865714285714287,0.21391,0.20497596489254838,0.2072290584164938,0.21215955450134774,39.932885906040276,0.23145907704862617,0.1963609229513738,-0.00452046165744463,-0.003978364087679884,-0.0005420975697647459,0.009899999999999992,0.009778571428571426,5628099456.089998,-0.003699999999999981,-5.560704355885071,-83.27526132404182,16.724738675958182,18.46689895470381,0.344657804037423,0.2059,0.2103,0.2019,0.2031,20303074.0,18253.0,10322252.0,-1.3598834385624075,36.95999999999999,0.23170488580982482,0.19765511419017515,-0.0043217366082380915,-0.0038428396952386976,-0.0004788969129993939,0.00839999999999999,0.009649999999999997,5590593917.089998,-0.015499999999999986,-7.429352780309939,-85.71428571428574,14.285714285714256,29.728144254808143,0.20766666666666656,0.20615192978509672,0.2084857142857143,0.2083720778886584,0.21467999999999998,0.21303950760675275,78521.0,13859843.0,150307.0,10409863.57142857
2023-10-20,0.2039,0.2233,0.2034,0.2185,68882597.0,64167.0,35393591.0,0.20846666666666655,0.21,0.21369500000000002,0.21173798244627418,0.21004679381237037,0.21276340645360034,44.92307692307693,0.23088722284381075,0.1965027771561893,-0.0034519931158549233,-0.0038730898933148922,0.00042109677745996894,0.0199,0.010335714285714283,5696982053.089998,0.01419999999999999,-2.932030208796088,-29.602888086642643,70.39711191335736,33.80252162500995,7.160372731731242,0.2031,0.209,0.1991,0.2038,37505539.0,28762.0,18398519.0,0.344657804037423,39.932885906040276,0.23145907704862617,0.1963609229513738,-0.00452046165744463,-0.003978364087679884,-0.0005420975697647459,0.009899999999999992,0.009778571428571426,5628099456.089998,-0.003699999999999981,-5.560704355885071,-83.27526132404182,16.724738675958182,18.46689895470381,0.20429999999999984,0.20497596489254838,0.20865714285714287,0.2072290584164938,0.21391,0.21215955450134774,71363.0,13984787.333333334,161864.0,12095603.857142856
2023-10-21,0.2185,0.2333,0.2166,0.2271,58311932.0,57445.0,29470630.0,0.2164666666666665,0.21204285714285714,0.213305,0.21941899122313707,0.21431009535927778,0.21412879631516224,54.6242774566474,0.22873545177889218,0.1978745482211078,-0.0018894950491865625,-0.0034763709244892264,0.0015868758753026639,0.01670000000000002,0.011035714285714284,5755293985.089998,0.021199999999999997,2.8998640688717714,-18.07580174927117,81.92419825072884,56.34868294668147,3.935926773455376,0.2039,0.2233,0.2034,0.2185,68882597.0,64167.0,35393591.0,7.160372731731242,44.92307692307693,0.23088722284381075,0.1965027771561893,-0.0034519931158549233,-0.0038730898933148922,0.00042109677745996894,0.0199,0.010335714285714283,5696982053.089998,0.01419999999999999,-2.932030208796088,-29.602888086642643,70.39711191335736,33.80252162500995,0.20846666666666655,0.21173798244627418,0.21,0.21004679381237037,0.21369500000000002,0.21276340645360034,111182.0,21371454.0,209516.0,15860107.142857144
2023-10-22,0.2272,0.2345,0.2186,0.2323,44981362.0,49785.0,21930131.0,0.22596666666666654,0.21495714285714285,0.21383000000000002,0.22585949561156854,0.21880757151945834,0.21585938714228964,59.47441217150762,0.23108414976769318,0.19657585023230686,-0.0002289681302961588,-0.0028268903656506134,0.0025979222353544546,0.015899999999999997,0.011785714285714283,5800275347.089998,0.029700000000000004,6.267154620311088,-6.197183098591497,93.8028169014085,82.04137568849825,2.244718309859152,0.2185,0.2333,0.2166,0.2271,58311932.0,57445.0,29470630.0,3.935926773455376,54.6242774566474,0.22873545177889218,0.1978745482211078,-0.0018894950491865625,-0.0034763709244892264,0.0015868758753026639,0.01670000000000002,0.011035714285714284,5755293985.089998,0.021199999999999997,2.8998640688717714,-18.07580174927117,81.92419825072884,56.34868294668147,0.2164666666666665,0.21941899122313707,0.21204285714285714,0.21431009535927778,0.213305,0.21412879631516224,150374.0,27754246.666666668,242080.0,18541034.57142857
2023-10-23,0.2324,0.2518,0.2258,0.2515,79091222.0,93399.0,40024327.0,0.23696666666666655,0.22032857142857143,0.215495,0.23867974780578427,0.22698067863959376,0.21925373122397634,77.36318407960202,0.23959387308996014,0.19139612691003985,0.00260624775351026,-0.0017402627418184385,0.004346510495328699,0.026000000000000023,0.01227142857142857,5879366569.089998,0.04239999999999999,21.204819277108445,-0.5681818181818606,99.43181818181814,91.7196111113185,8.21858864027539,0.2272,0.2345,0.2186,0.2323,44981362.0,49785.0,21930131.0,2.244718309859152,59.47441217150762,0.23108414976769318,0.19657585023230686,-0.0002289681302961588,-0.0028268903656506134,0.0025979222353544546,0.015899999999999997,0.011785714285714283,5800275347.089998,0.029700000000000004,6.267154620311088,-6.197183098591497,93.8028169014085,82.04137568849825,0.22596666666666654,0.22585949561156854,0.21495714285714285,0.21880757151945834,0.21383000000000002,0.21585938714228964,171397.0,28931450.666666668,278680.0,20967485.714285713
2023-10-24,0.2515,0.2878,0.2457,0.2747,167773262.0,231222.0,83194673.0,0.2528333333333332,0.23014285714285715,0.21825999999999998,0.2566898739028921,0.2389105089796953,0.22453432825026431,85.05976095617531,0.2540831562862808,0.18243684371371915,0.006648582161010885,-6.249376125257384e-05,0.006711075922263459,0.0421,0.014442857142857143,6047139831.089998,0.06190000000000001,34.459128732256474,-14.752252252252255,85.24774774774775,92.82746094365814,9.224652087475148,0.2324,0.2518,0.2258,0.2515,79091222.0,93399.0,40024327.0,8.21858864027539,77.36318407960202,0.23959387308996014,0.19139612691003985,0.00260624775351026,-0.0017402627418184385,0.004346510495328699,0.026000000000000023,0.01227142857142857,5879366569.089998,0.04239999999999999,21.204819277108445,-0.5681818181818606,99.43181818181814,91.7196111113185,0.23696666666666655,0.23867974780578427,0.22032857142857143,0.22698067863959376,0.215495,0.21925373122397634,200629.0,30475029.333333332,336159.0,24110434.42857143
2023-10-25,0.2747,0.3199,0.2695,0.3027,153600156.0,239142.0,77169473.0,0.2762999999999998,0.24437142857142855,0.222605,0.2796949369514461,0.2548578817347715,0.23197867794071533,88.17034700315459,0.27460125391360607,0.17060874608639393,0.011973504193542595,0.0023447058297064597,0.009628798363836136,0.0504,0.017492857142857143,6200739987.089998,0.09080000000000002,47.013113161729,-14.238410596026482,85.76158940397352,90.14705177784647,10.192937750273035,0.2515,0.2878,0.2457,0.2747,167773262.0,231222.0,83194673.0,9.224652087475148,85.05976095617531,0.2540831562862808,0.18243684371371915,0.006648582161010885,-6.249376125257384e-05,0.006711075922263459,0.0421,0.014442857142857143,6047139831.089998,0.06190000000000001,34.459128732256474,-14.752252252252255,85.24774774774775,92.82746094365814,0.2528333333333332,0.2566898739028921,0.23014285714285715,0.2389105089796953,0.21825999999999998,0.22453432825026431,374406.0,48383043.666666664,543033.0,34104874.71428572
2023-10-26,0.3025,0.3112,0.2767,0.2961,90047112.0,147099.0,42186681.0,0.2911666666666665,0.2575571428571429,0.22615500000000002,0.28789746847572306,0.2651684113010786,0.23808547051779005,85.9338970023059,0.28768871262543233,0.16462128737456772,0.015482505738192293,0.004972265811403627,0.010510239926788666,0.034499999999999975,0.019442857142857144,6110692875.089998,0.08219999999999997,46.15004935834155,-19.70198675496692,80.29801324503309,83.76911679891815,-2.115702479338849,0.2747,0.3199,0.2695,0.3027,153600156.0,239142.0,77169473.0,10.192937750273035,88.17034700315459,0.27460125391360607,0.17060874608639393,0.011973504193542595,0.0023447058297064597,0.009628798363836136,0.0504,0.017492857142857143,6200739987.089998,0.09080000000000002,47.013113161729,-14.238410596026482,85.76158940397352,90.14705177784647,0.2762999999999998,0.2796949369514461,0.24437142857142855,0.2548578817347715,0.222605,0.23197867794071533,563763.0,66796157.666666664,763922.0,43654477.71428572
2023-10-27,0.2961,0.3243,0.2857,0.318,116909636.0,188550.0,58808461.0,0.30559999999999987,0.2717714285714286,0.23102,0.3029487342378615,0.27837630847580896,0.24569637808752431,87.42268041237111,0.30488726644886244,0.15715273355113754,0.019802293207781763,0.007938271290679253,0.01186402191710251,0.03859999999999997,0.02156428571428571,6227602511.089998,0.11200000000000002,52.08034433285509,-5.031948881789116,94.96805111821088,87.00921792240585,7.396149949341449,0.3025,0.3112,0.2767,0.2961,90047112.0,147099.0,42186681.0,-2.115702479338849,85.9338970023059,0.28768871262543233,0.16462128737456772,0.015482505738192293,0.004972265811403627,0.010510239926788666,0.034499999999999975,0.019442857142857144,6110692875.089998,0.08219999999999997,46.15004935834155,-19.70198675496692,80.29801324503309,83.76911679891815,0.2911666666666665,0.28789746847572306,0.2575571428571429,0.2651684113010786,0.22615500000000002,0.23808547051779005,617463.0,67516942.33333333,882259.0,47052786.571428575
2023-10-28,0.318,0.3644,0.3131,0.3517,122384216.0,220906.0,62678075.0,0.3219333333333332,0.2895714285714286,0.237675,0.32732436711893076,0.2967072313568567,0.2557919611268077,89.57264957264955,0.32879827971083403,0.14655172028916597,0.02564939400922331,0.011480495834388066,0.014168898174835243,0.05130000000000001,0.024621428571428572,6349986727.089998,0.1486,65.27255639097747,-7.683000604960672,92.31699939503933,89.19435458609445,10.597484276729562,0.2961,0.3243,0.2857,0.318,116909636.0,188550.0,58808461.0,7.396149949341449,87.42268041237111,0.30488726644886244,0.15715273355113754,0.019802293207781763,0.007938271290679253,0.01186402191710251,0.03859999999999997,0.02156428571428571,6227602511.089998,0.11200000000000002,52.08034433285509,-5.031948881789116,94.96805111821088,87.00921792240585,0.30559999999999987,0.3029487342378615,0.2717714285714286,0.27837630847580896,0.23102,0.24569637808752431,574791.0,59388205.0,1006642.0,50397768.0
2023-10-29,0.3518,0.3904,0.3466,0.3658,115293078.0,226591.0,56772834.0,0.34516666666666657,0.3086428571428571,0.24558999999999997,0.3465621835594654,0.31398042351764255,0.26626891720996887,90.77901430842606,0.3519102094964276,0.13926979050357235,0.031062941429050972,0.015396984953320647,0.015665956475730325,0.043800000000000006,0.027435714285714282,6465279805.089998,0.162,72.62859839546955,-12.85938316779927,87.14061683220072,91.47522244848365,3.979533826037525,0.318,0.3644,0.3131,0.3517,122384216.0,220906.0,62678075.0,10.597484276729562,89.57264957264955,0.32879827971083403,0.14655172028916597,0.02564939400922331,0.011480495834388066,0.014168898174835243,0.05130000000000001,0.024621428571428572,6349986727.089998,0.1486,65.27255639097747,-7.683000604960672,92.31699939503933,89.19435458609445,0.3219333333333332,0.32732436711893076,0.2895714285714286,0.2967072313568567,0.237675,0.2557919611268077,556555.0,54557739.0,1170103.0,55141688.71428572
2023-10-30,0.3659,0.3791,0.356,0.3585,74141628.0,161310.0,36237402.0,0.3586666666666665,0.32392857142857145,0.25329999999999997,0.3525310917797327,0.3251103176382319,0.2750528298566385,87.26804123711337,0.36896636230303503,0.13763363769696488,0.03436799491832848,0.019191186946322214,0.015176807972006268,0.02310000000000001,0.02815,6391138177.089998,0.13999999999999999,67.601683029453,-16.67537898588606,83.32462101411394,87.59407908045135,-2.02241049467068,0.3518,0.3904,0.3466,0.3658,115293078.0,226591.0,56772834.0,3.979533826037525,90.77901430842606,0.3519102094964276,0.13926979050357235,0.031062941429050972,0.015396984953320647,0.015665956475730325,0.043800000000000006,0.027435714285714282,6465279805.089998,0.162,72.62859839546955,-12.85938316779927,87.14061683220072,91.47522244848365,0.34516666666666657,0.3465621835594654,0.3086428571428571,0.31398042351764255,0.24558999999999997,0.26626891720996887,636047.0,59419790.0,1346909.0,60119217.71428572
2023-10-31,0.3585,0.3787,0.3369,0.3632,91789736.0,179613.0,46635834.0,0.3624999999999999,0.3365714285714286,0.261165,0.35786554588986635,0.3346327382286739,0.2834477984417205,91.19496855345909,0.3844045574736935,0.13792544252630648,0.03694069500345104,0.02274108855774798,0.014199606445703061,0.041800000000000004,0.03017142857142857,6482927913.089998,0.13610000000000003,76.3106796116505,-14.218504966021955,85.78149503397805,85.41557762676426,1.3110181311018236,0.3659,0.3791,0.356,0.3585,74141628.0,161310.0,36237402.0,-2.02241049467068,87.26804123711337,0.36896636230303503,0.13763363769696488,0.03436799491832848,0.019191186946322214,0.015176807972006268,0.02310000000000001,0.02815,6391138177.089998,0.13999999999999999,67.601683029453,-16.67537898588606,83.32462101411394,87.59407908045135,0.3586666666666665,0.3525310917797327,0.32392857142857145,0.3251103176382319,0.25329999999999997,0.2750528298566385,608807.0,51896103.666666664,1414820.0,59578228.428571425
2023-11-01,0.3633,0.3867,0.339,0.3856,90808473.0,169177.0,45233777.0,0.3690999999999998,0.3484142857142857,0.27031499999999997,0.3717327729449332,0.34737455367150544,0.2931765795425091,93.39039467427482,0.40212243969097816,0.13850756030902178,0.04032226122394933,0.02625732309098825,0.014064938132961079,0.047699999999999965,0.03297857142857143,6573736386.089998,0.1533,89.8572131954702,-2.5091479351803585,97.49085206481965,88.86565603763722,6.1381778144783885,0.3585,0.3787,0.3369,0.3632,91789736.0,179613.0,46635834.0,1.3110181311018236,91.19496855345909,0.3844045574736935,0.13792544252630648,0.03694069500345104,0.02274108855774798,0.014199606445703061,0.041800000000000004,0.03017142857142857,6482927913.089998,0.13610000000000003,76.3106796116505,-14.218504966021955,85.78149503397805,85.41557762676426,0.3624999999999999,0.35786554588986635,0.3365714285714286,0.3346327382286739,0.261165,0.2834477984417205,567514.0,46548690.0,1363211.0,54355537.14285714
2023-11-02,0.3853,0.3892,0.3402,0.3482,69590399.0,123176.0,32470324.0,0.36566666666666653,0.3558571428571428,0.27727,0.3599663864724666,0.3475809152536291,0.2984169053003654,79.23076923076921,0.4101522684301938,0.1443877315698062,0.039528647736032596,0.02891158801999712,0.010617059716035476,0.04899999999999999,0.035771428571428565,6504145987.089998,0.09670000000000001,70.85377821393524,-22.5668449197861,77.4331550802139,86.90183405967055,-9.628860628082005,0.3633,0.3867,0.339,0.3856,90808473.0,169177.0,45233777.0,6.1381778144783885,93.39039467427482,0.40212243969097816,0.13850756030902178,0.04032226122394933,0.02625732309098825,0.014064938132961079,0.047699999999999965,0.03297857142857143,6573736386.089998,0.1533,89.8572131954702,-2.5091479351803585,97.49085206481965,88.86565603763722,0.3690999999999998,0.3717327729449332,0.3484142857142857,0.34737455367150544,0.27031499999999997,0.2931765795425091,510100.0,42702337.666666664,1293246.0,49793294.85714286
2023-11-03,0.348,0.3687,0.3298,0.3565,68458734.0,116274.0,33685928.0,0.3634333333333332,0.3613571428571429,0.284455,0.35823319323623326,0.34981068644022184,0.30394862860509253,78.67830423940148,0.4181967696434614,0.1507132303565386,0.03911851012884959,0.030952972441767618,0.008165537687081975,0.038900000000000046,0.037128571428571434,6572604721.089998,0.08179999999999998,63.1578947368421,-19.505178365937876,80.49482163406212,85.13960959303189,2.442528735632186,0.3853,0.3892,0.3402,0.3482,69590399.0,123176.0,32470324.0,-9.628860628082005,79.23076923076921,0.4101522684301938,0.1443877315698062,0.039528647736032596,0.02891158801999712,0.010617059716035476,0.04899999999999999,0.035771428571428565,6504145987.089998,0.09670000000000001,70.85377821393524,-22.5668449197861,77.4331550802139,86.90183405967055,0.36566666666666653,0.3599663864724666,0.3558571428571428,0.3475809152536291,0.27727,0.2984169053003654,471966.0,41446645.0,1269323.0,48405243.85714286
2023-11-04,0.3565,0.366,0.3505,0.3609,40295306.0,62434.0,19412138.0,0.3551999999999999,0.3626714285714286,0.29190499999999997,0.35956659661811663,0.3525830148301664,0.30937256873794083,78.29949238578678,0.4252286264448931,0.15858137355510685,0.038702379409502885,0.03250285383531468,0.006199525574188208,0.015500000000000014,0.03704285714285715,6612900027.089998,0.058199999999999974,58.91677675033024,-17.171129220023296,82.82887077997671,80.25228249808426,1.2342215988779845,0.348,0.3687,0.3298,0.3565,68458734.0,116274.0,33685928.0,2.442528735632186,78.67830423940148,0.4181967696434614,0.1507132303565386,0.03911851012884959,0.030952972441767618,0.008165537687081975,0.038900000000000046,0.037128571428571434,6572604721.089998,0.08179999999999998,63.1578947368421,-19.505178365937876,80.49482163406212,85.13960959303189,0.3634333333333332,0.35823319323623326,0.3613571428571429,0.34981068644022184,0.284455,0.30394862860509253,408627.0,37130009.666666664,1197047.0,44816310.571428575
2023-11-05,0.3609,0.3748,0.3455,0.3653,54492320.0,77091.0,25764648.0,0.36089999999999983,0.3626,0.299475,0.36243329830905835,0.35576226112262477,0.31469899076289887,78.2258064516129,0.4313346522622947,0.16761534773770526,0.03828629546232798,0.033659542160717336,0.0046267533016106435,0.029300000000000048,0.038,6667392347.089998,0.06920000000000004,57.253551442100736,-15.249088699878499,84.7509113001215,82.69153457138678,1.2191742865059614,0.3565,0.366,0.3505,0.3609,40295306.0,62434.0,19412138.0,1.2342215988779845,78.29949238578678,0.4252286264448931,0.15858137355510685,0.038702379409502885,0.03250285383531468,0.006199525574188208,0.015500000000000014,0.03704285714285715,6612900027.089998,0.058199999999999974,58.91677675033024,-17.171129220023296,82.82887077997671,80.25228249808426,0.3551999999999999,0.35956659661811663,0.3626714285714286,0.3525830148301664,0.29190499999999997,0.30937256873794083,301884.0,28522796.666666668,1038575.0,38635462.428571425
2023-11-06,0.3655,0.4065,0.355,0.3904,92418060.0,123628.0,45745449.0,0.37219999999999986,0.36715714285714285,0.308695,0.3764166491545292,0.3644216958419686,0.32190861069024185,78.75776397515527,0.4388105029397331,0.17857949706026685,0.03952627190870289,0.03483288811031445,0.004693383798388441,0.05149999999999999,0.03982142857142858,6759810407.089998,0.07240000000000002,55.228628230616316,-10.012437810945244,89.98756218905476,85.855781423051,6.812585499316015,0.3609,0.3748,0.3455,0.3653,54492320.0,77091.0,25764648.0,1.2191742865059614,78.2258064516129,0.4313346522622947,0.16761534773770526,0.03828629546232798,0.033659542160717336,0.0046267533016106435,0.029300000000000048,0.038,6667392347.089998,0.06920000000000004,57.253551442100736,-15.249088699878499,84.7509113001215,82.69153457138678,0.36089999999999983,0.36243329830905835,0.3626,0.35576226112262477,0.299475,0.31469899076289887,255799.0,26287571.333333332,889075.0,34205721.571428575
2023-11-07,0.3906,0.3944,0.3478,0.3635,90097672.0,129808.0,43547571.0,0.3730666666666665,0.3672,0.316715,0.36995832457726463,0.36419127188147643,0.32586969538640925,68.10766721044044,0.4389611584801524,0.19446884151984764,0.037901452635535626,0.03544660101535869,0.0024548516201769385,0.046599999999999975,0.04014285714285715,6669712735.089998,0.011799999999999977,32.32617400800872,-31.386861313868607,68.61313868613139,81.1172040584359,-6.9380440348182315,0.3655,0.4065,0.355,0.3904,92418060.0,123628.0,45745449.0,6.812585499316015,78.75776397515527,0.4388105029397331,0.17857949706026685,0.03952627190870289,0.03483288811031445,0.004693383798388441,0.05149999999999999,0.03982142857142858,6759810407.089998,0.07240000000000002,55.228628230616316,-10.012437810945244,89.98756218905476,85.855781423051,0.37219999999999986,0.3764166491545292,0.36715714285714285,0.3644216958419686,0.308695,0.32190861069024185,263153.0,30307411.666666668,851393.0,35564014.0
2023-11-08,0.3636,0.3809,0.3581,0.3713,49687606.0,79838.0,25607611.0,0.3750666666666665,0.3651571428571429,0.32509,0.3706291622886323,0.3659684539111073,0.3301963910638941,65.24444444444444,0.4373036102074352,0.2128763897925648,0.03681874291854664,0.03572102939599628,0.0010977135225503643,0.022800000000000042,0.03817142857142857,6719400341.089998,0.005500000000000005,22.662702345556653,-27.11864406779658,72.88135593220342,77.1606856024632,2.117711771177129,0.3906,0.3944,0.3478,0.3635,90097672.0,129808.0,43547571.0,-6.9380440348182315,68.10766721044044,0.4389611584801524,0.19446884151984764,0.037901452635535626,0.03544660101535869,0.0024548516201769385,0.046599999999999975,0.04014285714285715,6669712735.089998,0.011799999999999977,32.32617400800872,-31.386861313868607,68.61313868613139,81.1172040584359,0.3730666666666665,0.36995832457726463,0.3672,0.36419127188147643,0.316715,0.32586969538640925,330527.0,38352556.0,801588.0,35122833.571428575
2023-11-09,0.3713,0.4115,0.338,0.3909,122721878.0,202795.0,61456768.0,0.37523333333333325,0.3712571428571429,0.33371,0.38076458114431616,0.3722013404333305,0.33597768715304704,69.91596638655462,0.4376279210520799,0.22979207894792011,0.037114412024398025,0.03599970592167663,0.001114706102721394,0.07349999999999995,0.04095714285714286,6842122219.089998,0.03240000000000004,32.016210739615026,-16.37519872813987,83.62480127186012,75.03976529673166,5.278750336654997,0.3636,0.3809,0.3581,0.3713,49687606.0,79838.0,25607611.0,2.117711771177129,65.24444444444444,0.4373036102074352,0.2128763897925648,0.03681874291854664,0.03572102939599628,0.0010977135225503643,0.022800000000000042,0.03817142857142857,6719400341.089998,0.005500000000000005,22.662702345556653,-27.11864406779658,72.88135593220342,77.1606856024632,0.3750666666666665,0.3706291622886323,0.3651571428571429,0.3659684539111073,0.32509,0.3301963910638941,333274.0,38300210.333333336,712249.0,32319095.57142857
2023-11-10,0.3907,0.4435,0.3721,0.4434,116718685.0,198035.0,59711719.0,0.40186666666666654,0.3836714285714286,0.344525,0.41208229057215806,0.3900010053249979,0.3462083836146616,73.34326135517497,0.4467341328703176,0.24231586712968248,0.04111113953440243,0.03702199264422179,0.004089146890180639,0.07140000000000002,0.043300000000000005,6958840904.089998,0.0802,39.43396226415095,-0.07668711656440873,99.92331288343559,85.47649002916638,13.488610186844133,0.3713,0.4115,0.338,0.3909,122721878.0,202795.0,61456768.0,5.278750336654997,69.91596638655462,0.4376279210520799,0.22979207894792011,0.037114412024398025,0.03599970592167663,0.001114706102721394,0.07349999999999995,0.04095714285714286,6842122219.089998,0.03240000000000004,32.016210739615026,-16.37519872813987,83.62480127186012,75.03976529673166,0.37523333333333325,0.38076458114431616,0.3712571428571429,0.3722013404333305,0.33371,0.33597768715304704,412441.0,43537316.666666664,791868.0,36460016.14285714
2023-11-11,0.4433,0.4537,0.4182,0.4267,104598445.0,186628.0,51950640.0,0.4203333333333332,0.39307142857142857,0.35424500000000003,0.419391145286079,0.39917575399374844,0.3538742518418367,64.90461049284579,0.44815488905943285,0.2603351109405672,0.042441782004811524,0.03810595051633974,0.004335831488471782,0.035499999999999976,0.042171428571428575,6854242459.089998,0.041100000000000025,21.324992891669048,-21.791767554479392,78.20823244552061,87.25211553360545,-3.744642454319874,0.3907,0.4435,0.3721,0.4434,116718685.0,198035.0,59711719.0,13.488610186844133,73.34326135517497,0.4467341328703176,0.24231586712968248,0.04111113953440243,0.03702199264422179,0.004089146890180639,0.07140000000000002,0.043300000000000005,6958840904.089998,0.0802,39.43396226415095,-0.07668711656440873,99.92331288343559,85.47649002916638,0.40186666666666654,0.41208229057215806,0.3836714285714286,0.3900010053249979,0.344525,0.3462083836146616,480668.0,48925366.0,873629.0,40177986.28571428
2023-11-12,0.4264,0.4345,0.3898,0.4296,76737486.0,145447.0,37221148.0,0.4332333333333332,0.4022571428571428,0.36315,0.4244955726430395,0.40678181549531134,0.3610862278568998,63.269550748752074,0.44951084639158456,0.2767891536084154,0.04323198015678664,0.039131156444429126,0.004100823712357517,0.04470000000000002,0.04223571428571428,6930979945.089998,0.08139999999999997,17.441224712957883,-19.451170298627932,80.54882970137207,86.2267916767761,0.7504690431519655,0.4433,0.4537,0.4182,0.4267,104598445.0,186628.0,51950640.0,-3.744642454319874,64.90461049284579,0.44815488905943285,0.2603351109405672,0.042441782004811524,0.03810595051633974,0.004335831488471782,0.035499999999999976,0.042171428571428575,6854242459.089998,0.041100000000000025,21.324992891669048,-21.791767554479392,78.20823244552061,87.25211553360545,0.4203333333333332,0.419391145286079,0.39307142857142857,0.39917575399374844,0.35424500000000003,0.3538742518418367,587458.0,57706375.666666664,997823.0,44826343.71428572
2023-11-13,0.4297,0.439,0.3718,0.3738,74824525.0,136124.0,37133715.0,0.41003333333333325,0.39988571428571434,0.368105,0.39914778632151976,0.39853636162148354,0.36229706329909983,52.64797507788163,0.4438127615432657,0.2923972384567343,0.0389071270831855,0.039086350572180406,-0.00017922348899490625,0.06719999999999998,0.04538571428571429,6856155420.089998,0.017300000000000038,4.267782426778255,-64.4874899112187,35.512510088781305,64.75652407855802,-13.009076099604375,0.4264,0.4345,0.3898,0.4296,76737486.0,145447.0,37221148.0,0.7504690431519655,63.269550748752074,0.44951084639158456,0.2767891536084154,0.04323198015678664,0.039131156444429126,0.004100823712357517,0.04470000000000002,0.04223571428571428,6930979945.089998,0.08139999999999997,17.441224712957883,-19.451170298627932,80.54882970137207,86.2267916767761,0.4332333333333332,0.4244955726430395,0.4022571428571428,0.40678181549531134,0.36315,0.3610862278568998,530110.0,49627835.666666664,1066179.0,46462986.571428575
2023-11-14,0.3737,0.3971,0.36,0.3841,81774065.0,145225.0,40721527.0,0.3958333333333332,0.4028285714285714,0.37217500000000003,0.39162389316075985,0.3949272712161127,0.3643735334610903,53.54838709677419,0.44156654733901357,0.3027834526609865,0.03589697579095458,0.03844847561593524,-0.002551499824980666,0.03710000000000002,0.04505,6937929485.089998,0.0232,5.754405286343611,-56.174334140435825,43.825665859564175,53.29566854990586,2.782981000802789,0.4297,0.439,0.3718,0.3738,74824525.0,136124.0,37133715.0,-13.009076099604375,52.64797507788163,0.4438127615432657,0.2923972384567343,0.0389071270831855,0.039086350572180406,-0.00017922348899490625,0.06719999999999998,0.04538571428571429,6856155420.089998,0.017300000000000038,4.267782426778255,-64.4874899112187,35.512510088781305,64.75652407855802,0.41003333333333325,0.39914778632151976,0.39988571428571434,0.39853636162148354,0.368105,0.36229706329909983,468199.0,42101834.333333336,1078675.0,45232738.85714286
2023-11-15,0.384,0.4499,0.3787,0.4458,89415274.0,151650.0,46881484.0,0.40123333333333316,0.41347142857142855,0.37966,0.4187119465803799,0.4076454534120845,0.37212843503622456,59.017375674056325,0.44675752211282915,0.31256247788717084,0.03805145012563449,0.038369070517875095,-0.0003176203922406057,0.07120000000000004,0.04672857142857144,7027344759.089998,0.08049999999999996,15.612033195020736,-6.3761097659402886,93.62389023405971,57.65402206080174,16.09374999999999,0.3737,0.3971,0.36,0.3841,81774065.0,145225.0,40721527.0,2.782981000802789,53.54838709677419,0.44156654733901357,0.3027834526609865,0.03589697579095458,0.03844847561593524,-0.002551499824980666,0.03710000000000002,0.04505,6937929485.089998,0.0232,5.754405286343611,-56.174334140435825,43.825665859564175,53.29566854990586,0.3958333333333332,0.39162389316075985,0.4028285714285714,0.3949272712161127,0.37217500000000003,0.3643735334610903,426796.0,38358796.666666664,1094092.0,44829018.28571428
2023-11-16,0.4458,0.4541,0.4124,0.4328,123306534.0,215309.0,60105819.0,0.4208999999999999,0.41945714285714286,0.38539999999999996,0.42575597329019,0.4139340900590634,0.37790667931848887,63.671622495151915,0.449878180723956,0.3209218192760439,0.03826875679667291,0.03834900777363466,-8.025097696175154e-05,0.041700000000000015,0.04620714285714288,6904038225.089998,0.04239999999999999,24.296381390005738,-17.13596138374898,82.86403861625102,73.43786490329165,-2.9161058770749118,0.384,0.4499,0.3787,0.4458,89415274.0,151650.0,46881484.0,16.09374999999999,59.017375674056325,0.44675752211282915,0.31256247788717084,0.03805145012563449,0.038369070517875095,-0.0003176203922406057,0.07120000000000004,0.04672857142857144,7027344759.089998,0.08049999999999996,15.612033195020736,-6.3761097659402886,93.62389023405971,57.65402206080174,0.40123333333333316,0.4187119465803799,0.41347142857142855,0.4076454534120845,0.37966,0.37212843503622456,432999.0,41578908.666666664,1165904.0,47868143.0
2023-11-17,0.4331,0.4824,0.413,0.4415,147866507.0,250892.0,71770998.0,0.4400333333333332,0.4191857142857143,0.38989,0.433627986645095,0.42082556754429756,0.38396318605006136,63.718528082633966,0.45694243509842947,0.32283756490157056,0.03869691721647023,0.038418589662201776,0.0002783275542684524,0.06940000000000002,0.04838571428571429,7051904732.089998,0.07800000000000001,23.842917251051897,-28.32409972299169,71.67590027700831,82.72127637577303,1.9395058877857352,0.4458,0.4541,0.4124,0.4328,123306534.0,215309.0,60105819.0,-2.9161058770749118,63.671622495151915,0.449878180723956,0.3209218192760439,0.03826875679667291,0.03834900777363466,-8.025097696175154e-05,0.041700000000000015,0.04620714285714288,6904038225.089998,0.04239999999999999,24.296381390005738,-17.13596138374898,82.86403861625102,73.43786490329165,0.4208999999999999,0.42575597329019,0.41945714285714286,0.4139340900590634,0.38539999999999996,0.37790667931848887,512184.0,49236276.666666664,1178418.0,47675150.28571428
2023-11-18,0.4412,0.4669,0.3952,0.4624,103864494.0,158532.0,49877540.0,0.4455666666666665,0.4242857142857143,0.39472,0.4480139933225475,0.43121917565822315,0.3914333588071983,65.55317192767393,0.4680856050203198,0.3213543949796802,0.04025861649447132,0.03878659502865569,0.001472021465815633,0.07169999999999999,0.0524,7155769226.089998,0.09109999999999996,28.124134109171518,-13.85041551246539,86.14958448753461,80.22984112693132,4.805077062556664,0.4331,0.4824,0.413,0.4415,147866507.0,250892.0,71770998.0,1.9395058877857352,63.718528082633966,0.45694243509842947,0.32283756490157056,0.03869691721647023,0.038418589662201776,0.0002783275542684524,0.06940000000000002,0.04838571428571429,7051904732.089998,0.07800000000000001,23.842917251051897,-28.32409972299169,71.67590027700831,82.72127637577303,0.4400333333333332,0.433627986645095,0.4191857142857143,0.42082556754429756,0.38989,0.38396318605006136,617851.0,59586100.333333336,1231275.0,49397904.428571425
2023-11-19,0.4624,0.5173,0.4478,0.4995,139722504.0,228989.0,70785684.0,0.4677999999999998,0.43427142857142853,0.40176999999999996,0.47375699666127374,0.4482893817436674,0.40172541987317945,68.69080779944291,0.4866722248793949,0.31686777512060504,0.04398292656704228,0.03982586133633301,0.004157065230709273,0.0695,0.055271428571428576,7295491730.089998,0.10859999999999997,36.73692855187516,-9.927495817066362,90.07250418293364,82.6326629824922,8.023356401384088,0.4412,0.4669,0.3952,0.4624,103864494.0,158532.0,49877540.0,4.805077062556664,65.55317192767393,0.4680856050203198,0.3213543949796802,0.04025861649447132,0.03878659502865569,0.001472021465815633,0.07169999999999999,0.0524,7155769226.089998,0.09109999999999996,28.124134109171518,-13.85041551246539,86.14958448753461,80.22984112693132,0.4455666666666665,0.4480139933225475,0.4242857142857143,0.43121917565822315,0.39472,0.3914333588071983,624733.0,60584785.666666664,1203179.0,49101747.28571428
2023-11-20,0.4996,0.5794,0.497,0.5195,182489800.0,343119.0,92444120.0,0.4937999999999998,0.45508571428571426,0.40958500000000003,0.4966284983306368,0.46609203630775053,0.41294204655192424,68.23961571065273,0.5073398658096948,0.31183013419030525,0.04799504498211021,0.04145969806548845,0.006535346916621762,0.08240000000000003,0.05747857142857144,7477981530.089998,0.07609999999999995,33.0686475409836,-24.81358740679373,75.18641259320627,83.8028337545582,3.9831865492393863,0.4624,0.5173,0.4478,0.4995,139722504.0,228989.0,70785684.0,8.023356401384088,68.69080779944291,0.4866722248793949,0.31686777512060504,0.04398292656704228,0.03982586133633301,0.004157065230709273,0.0695,0.055271428571428576,7295491730.089998,0.10859999999999997,36.73692855187516,-9.927495817066362,90.07250418293364,82.6326629824922,0.4677999999999998,0.47375699666127374,0.43427142857142853,0.4482893817436674,0.40176999999999996,0.40172541987317945,638413.0,64144740.666666664,1286721.0,53896681.0
2023-11-21,0.5195,0.5422,0.4597,0.4604,159898381.0,330033.0,78718630.0,0.4931333333333332,0.4659857142857143,0.41332500000000005,0.4785142491653184,0.4646690272308129,0.41746185164221716,62.54856254856255,0.512922291761943,0.31372770823805707,0.04587696060665514,0.04234315057372179,0.003533810032933349,0.08250000000000002,0.06004285714285716,7318083149.089998,0.03369999999999995,26.657496561210458,-49.29577464788734,50.70422535211265,71.98771404275087,-11.376323387872953,0.4996,0.5794,0.497,0.5195,182489800.0,343119.0,92444120.0,3.9831865492393863,68.23961571065273,0.5073398658096948,0.31183013419030525,0.04799504498211021,0.04145969806548845,0.006535346916621762,0.08240000000000003,0.05747857142857144,7477981530.089998,0.07609999999999995,33.0686475409836,-24.81358740679373,75.18641259320627,83.8028337545582,0.4937999999999998,0.4966284983306368,0.45508571428571426,0.46609203630775053,0.40958500000000003,0.41294204655192424,730640.0,71035781.33333333,1493716.0,61798167.428571425
2023-11-22,0.4603,0.5488,0.4603,0.5162,113493156.0,219422.0,57584108.0,0.49869999999999987,0.47604285714285716,0.421725,0.4973571245826592,0.47755177042310964,0.4268654848191488,66.68970283344852,0.526403955307208,0.3170460446927921,0.048145960476521865,0.0435037125542818,0.004642247922240064,0.08849999999999997,0.06473571428571429,7431576305.089998,0.08660000000000001,39.02504713169943,-26.180613090306558,73.81938690969343,66.57000828500414,12.144253747555943,0.5195,0.5422,0.4597,0.4604,159898381.0,330033.0,78718630.0,-11.376323387872953,62.54856254856255,0.512922291761943,0.31372770823805707,0.04587696060665514,0.04234315057372179,0.003533810032933349,0.08250000000000002,0.06004285714285716,7318083149.089998,0.03369999999999995,26.657496561210458,-49.29577464788734,50.70422535211265,71.98771404275087,0.4931333333333332,0.4785142491653184,0.4659857142857143,0.4646690272308129,0.41332500000000005,0.41746185164221716,902141.0,80649478.0,1678524.0,67226325.0
2023-11-23,0.5161,0.5223,0.4819,0.4963,63112860.0,128667.0,28085712.0,0.49096666666666655,0.4851142857142857,0.42871500000000007,0.4968285622913296,0.48223882781733224,0.4334782957887537,62.131675874769805,0.533725200507019,0.32370479949298114,0.04778753062554536,0.044360476168534516,0.0034270544570108447,0.04039999999999999,0.06237142857142858,7368463445.089998,0.1225,26.963417753901254,-37.87602552415679,62.12397447584321,62.21586224588311,-3.836465801201314,0.4603,0.5488,0.4603,0.5162,113493156.0,219422.0,57584108.0,12.144253747555943,66.68970283344852,0.526403955307208,0.3170460446927921,0.048145960476521865,0.0435037125542818,0.004642247922240064,0.08849999999999997,0.06473571428571429,7431576305.089998,0.08660000000000001,39.02504713169943,-26.180613090306558,73.81938690969343,66.57000828500414,0.49869999999999987,0.4973571245826592,0.47604285714285716,0.47755177042310964,0.421725,0.4268654848191488,892574.0,76248952.66666667,1746296.0,68755271.28571428
2023-11-24,0.4963,0.5678,0.4936,0.5318,99550199.0,217060.0,49910677.0,0.5147666666666666,0.4980142857142857,0.43726000000000004,0.5143142811456648,0.4946291208629992,0.4428422676183962,60.58936272160997,0.5467528288927886,0.32776717110721143,0.04979403110554331,0.04544718715593628,0.004346843949607035,0.07419999999999999,0.06257142857142858,7468013644.089998,0.14770000000000005,19.936851601262973,-21.695533272561516,78.30446672743848,71.41594270432506,7.1529316945396,0.5161,0.5223,0.4819,0.4963,63112860.0,128667.0,28085712.0,-3.836465801201314,62.131675874769805,0.533725200507019,0.32370479949298114,0.04778753062554536,0.044360476168534516,0.0034270544570108447,0.04039999999999999,0.06237142857142858,7368463445.089998,0.1225,26.963417753901254,-37.87602552415679,62.12397447584321,62.21586224588311,0.49096666666666655,0.4968285622913296,0.4851142857142857,0.48223882781733224,0.42871500000000007,0.4334782957887537,678122.0,54796150.0,1659654.0,64180970.28571428
2023-11-25,0.5318,0.5413,0.5172,0.5325,47959549.0,101881.0,22996011.0,0.5201999999999999,0.5080285714285714,0.44562,0.5234071405728324,0.5040968406472495,0.451381099273787,63.17887394120579,0.5574853815035983,0.33375461849640176,0.05085446275106259,0.04652864227496155,0.004325820476101042,0.02410000000000001,0.06175714285714286,7515973193.089998,0.0867,24.79493789547691,-21.376481312670943,78.62351868732907,73.01731996353693,0.1316284317412416,0.4963,0.5678,0.4936,0.5318,99550199.0,217060.0,49910677.0,7.1529316945396,60.58936272160997,0.5467528288927886,0.32776717110721143,0.04979403110554331,0.04544718715593628,0.004346843949607035,0.07419999999999999,0.06257142857142858,7468013644.089998,0.14770000000000005,19.936851601262973,-21.695533272561516,78.30446672743848,71.41594270432506,0.5147666666666666,0.5143142811456648,0.4980142857142857,0.4946291208629992,0.43726000000000004,0.4428422676183962,565149.0,45193499.0,1625822.0,61058067.28571428
2023-11-26,0.5325,0.5439,0.505,0.5345,43537332.0,95394.0,20306385.0,0.5329333333333333,0.5130285714285714,0.452825,0.5289535702864162,0.511697630485437,0.4592971850572359,63.096129837702875,0.5682218142404305,0.3374281857595695,0.05126529138785335,0.04747597209753991,0.0037893192903134393,0.038900000000000046,0.06134285714285716,7559510525.089998,0.10169999999999996,24.418063314711368,-20.464904284412054,79.53509571558794,78.82102704345185,0.3755868544600942,0.5318,0.5413,0.5172,0.5325,47959549.0,101881.0,22996011.0,0.1316284317412416,63.17887394120579,0.5574853815035983,0.33375461849640176,0.05085446275106259,0.04652864227496155,0.004325820476101042,0.02410000000000001,0.06175714285714286,7515973193.089998,0.0867,24.79493789547691,-21.376481312670943,78.62351868732907,73.01731996353693,0.5201999999999999,0.5234071405728324,0.5080285714285714,0.5040968406472495,0.44562,0.451381099273787,447608.0,33664133.333333336,1569171.0,57217848.85714286
2023-11-27,0.5341,0.5534,0.4975,0.5138,77760099.0,170883.0,38583629.0,0.5269333333333333,0.5122142857142857,0.4603400000000001,0.5213767851432081,0.5122232228640777,0.4644879293374991,69.15708812260537,0.5707101981133376,0.3499698018866626,0.0493516637797794,0.047851110433987806,0.0015005533457915915,0.055900000000000005,0.0605357142857143,7481750426.089998,0.07230000000000003,37.453183520599254,-29.899726526891513,70.10027347310849,76.08629595867518,-3.8007863695937063,0.5325,0.5439,0.505,0.5345,43537332.0,95394.0,20306385.0,0.3755868544600942,63.096129837702875,0.5682218142404305,0.3374281857595695,0.05126529138785335,0.04747597209753991,0.0037893192903134393,0.038900000000000046,0.06134285714285716,7559510525.089998,0.10169999999999996,24.418063314711368,-20.464904284412054,79.53509571558794,78.82102704345185,0.5329333333333333,0.5289535702864162,0.5130285714285714,0.511697630485437,0.452825,0.4592971850572359,414335.0,31071024.333333332,1435576.0,50006520.428571425
2023-11-28,0.5139,0.5463,0.4888,0.54,69952853.0,147617.0,33896344.0,0.5294333333333333,0.5235857142857142,0.46877499999999994,0.530688392571604,0.5191674171480583,0.47167955511488013,70.4432205612379,0.5762406542440597,0.3613093457559402,0.049379999257444795,0.04815688819867921,0.0012231110587655886,0.057499999999999996,0.06199285714285715,7551703279.089998,0.07760000000000006,40.58838844051029,-19.631290483308412,80.36870951669158,76.66802623512935,5.078809106830125,0.5341,0.5534,0.4975,0.5138,77760099.0,170883.0,38583629.0,-3.8007863695937063,69.15708812260537,0.5707101981133376,0.3499698018866626,0.0493516637797794,0.047851110433987806,0.0015005533457915915,0.055900000000000005,0.0605357142857143,7481750426.089998,0.07230000000000003,37.453183520599254,-29.899726526891513,70.10027347310849,76.08629595867518,0.5269333333333333,0.5213767851432081,0.5122142857142857,0.5122232228640777,0.4603400000000001,0.4644879293374991,368158.0,27295341.666666668,1263340.0,42312164.571428575
2023-11-29,0.5404,0.56,0.5205,0.5225,46643681.0,105402.0,23062960.0,0.5254333333333333,0.5244857142857143,0.4753550000000001,0.5265941962858021,0.5200005628610437,0.4765195974848916,61.376446158409976,0.5787836425767147,0.3719263574232855,0.04744345298772462,0.048014201156488294,-0.0005707481687636726,0.03950000000000009,0.05972857142857144,7505059598.089998,0.022999999999999965,17.20502467474203,-30.890336590662354,69.10966340933766,73.19288213304593,-3.312361213915623,0.5139,0.5463,0.4888,0.54,69952853.0,147617.0,33896344.0,5.078809106830125,70.4432205612379,0.5762406542440597,0.3613093457559402,0.049379999257444795,0.04815688819867921,0.0012231110587655886,0.057499999999999996,0.06199285714285715,7551703279.089998,0.07760000000000006,40.58838844051029,-19.631290483308412,80.36870951669158,76.66802623512935,0.5294333333333333,0.530688392571604,0.5235857142857142,0.5191674171480583,0.46877499999999994,0.47167955511488013,413894.0,30928786.0,1080924.0,35908980.85714286
2023-11-30,0.5226,0.5376,0.5148,0.5282,33757413.0,76676.0,15228140.0,0.5302333333333332,0.5290428571428571,0.47959500000000005,0.527397098142901,0.5220504221457828,0.48144154058156857,64.46331109763494,0.5844507600756931,0.374739239924307,0.04584025060560504,0.047579411046311644,-0.0017391604407066066,0.02279999999999993,0.05837857142857144,7538817011.089998,0.008700000000000041,22.04251386321625,-27.795874049945716,72.20412595005428,73.89416629202786,1.0715652506697377,0.5404,0.56,0.5205,0.5225,46643681.0,105402.0,23062960.0,-3.312361213915623,61.376446158409976,0.5787836425767147,0.3719263574232855,0.04744345298772462,0.048014201156488294,-0.0005707481687636726,0.03950000000000009,0.05972857142857144,7505059598.089998,0.022999999999999965,17.20502467474203,-30.890336590662354,69.10966340933766,73.19288213304593,0.5254333333333333,0.5265941962858021,0.5244857142857143,0.5200005628610437,0.4753550000000001,0.4765195974848916,423902.0,31847644.333333332,966904.0,30977388.285714287
2023-12-01,0.5284,0.5644,0.522,0.5544,58948424.0,116995.0,30607872.0,0.5350333333333332,0.5322714285714286,0.48597999999999997,0.5408985490714505,0.5301378166093371,0.48838996528808587,66.25395911315866,0.5928074673923913,0.37915253260760856,0.04615181283493475,0.04729389140403627,-0.0011420785691015206,0.04239999999999999,0.05645,7597765435.089998,0.09400000000000003,25.571913929784817,-13.572204125950064,86.42779587404993,75.91386174448064,4.920514761544289,0.5226,0.5376,0.5148,0.5282,33757413.0,76676.0,15228140.0,1.0715652506697377,64.46331109763494,0.5844507600756931,0.374739239924307,0.04584025060560504,0.047579411046311644,-0.0017391604407066066,0.02279999999999993,0.05837857142857144,7538817011.089998,0.008700000000000041,22.04251386321625,-27.795874049945716,72.20412595005428,73.89416629202786,0.5302333333333332,0.527397098142901,0.5290428571428571,0.5220504221457828,0.47959500000000005,0.48144154058156857,329695.0,24062481.333333332,914913.0,29140592.285714287
2023-12-02,0.5543,0.5791,0.5405,0.5583,57346041.0,125306.0,28128369.0,0.5469666666666666,0.5359571428571429,0.49241499999999994,0.5495992745357252,0.5371783624570028,0.4950480638320777,64.51710566151984,0.6004411230589932,0.3843888769410067,0.046181078822757904,0.047071328887780595,-0.0008902500650226908,0.03859999999999997,0.05408571428571429,7655111476.089998,0.042100000000000026,20.739619377162644,-16.033434650455927,83.96656534954407,80.86616239121611,0.7216308858019129,0.5284,0.5644,0.522,0.5544,58948424.0,116995.0,30607872.0,4.920514761544289,66.25395911315866,0.5928074673923913,0.37915253260760856,0.04615181283493475,0.04729389140403627,-0.0011420785691015206,0.04239999999999999,0.05645,7597765435.089998,0.09400000000000003,25.571913929784817,-13.572204125950064,86.42779587404993,75.91386174448064,0.5350333333333332,0.5408985490714505,0.5322714285714286,0.5301378166093371,0.48597999999999997,0.48838996528808587,299073.0,22966324.0,814848.0,26383048.714285713
2023-12-03,0.5584,0.5844,0.55,0.5578,60121539.0,145656.0,29302686.0,0.5568333333333332,0.5392857142857143,0.5016149999999999,0.5536996372678626,0.5423337718427521,0.5010244387052132,59.92509363295879,0.5977986899402663,0.40543131005973354,0.04563784187506642,0.04678463148523777,-0.0011467896101713462,0.034399999999999986,0.051578571428571425,7594989937.089998,0.061499999999999944,11.671671671671668,-21.331194867682488,78.66880513231752,83.02105545197053,-0.1074498567335324,0.5543,0.5791,0.5405,0.5583,57346041.0,125306.0,28128369.0,0.7216308858019129,64.51710566151984,0.6004411230589932,0.3843888769410067,0.046181078822757904,0.047071328887780595,-0.0008902500650226908,0.03859999999999997,0.05408571428571429,7655111476.089998,0.042100000000000026,20.739619377162644,-16.033434650455927,83.96656534954407,80.86616239121611,0.5469666666666666,0.5495992745357252,0.5359571428571429,0.5371783624570028,0.49241499999999994,0.4950480638320777,318977.0,24654793.666666668,838273.0,27116242.714285713
2023-12-04,0.5577,0.5683,0.5011,0.5426,113928893.0,234043.0,52388055.0,0.5528999999999998,0.5434,0.50954,0.5481498186339313,0.542400328882064,0.5049840159713833,53.99792315680167,0.5897470583585098,0.42933294164149016,0.04347960390322769,0.04612362596883575,-0.0026440220656080565,0.06720000000000004,0.05049285714285714,7481061044.089998,0.01079999999999992,4.446583253128011,-33.52044907778673,66.47955092221326,76.37164046802496,-2.707548861395016,0.5584,0.5844,0.55,0.5578,60121539.0,145656.0,29302686.0,-0.1074498567335324,59.92509363295879,0.5977986899402663,0.40543131005973354,0.04563784187506642,0.04678463148523777,-0.0011467896101713462,0.034399999999999986,0.051578571428571425,7594989937.089998,0.061499999999999944,11.671671671671668,-21.331194867682488,78.66880513231752,83.02105545197053,0.5568333333333332,0.5536996372678626,0.5392857142857143,0.5423337718427521,0.5016149999999999,0.5010244387052132,387957.0,29346309.0,888535.0,28401428.57142857
2023-12-05,0.5427,0.5476,0.5139,0.5326,65340975.0,127056.0,31419861.0,0.5443333333333332,0.5423428571428571,0.51388,0.5403749093169656,0.539950246661548,0.5076141096883945,65.05421184320267,0.5887832105277709,0.4389767894722291,0.040495461858018056,0.04499799314667221,-0.004502531288654153,0.03369999999999995,0.04700714285714286,7415720069.089998,9.999999999998899e-05,15.682015638575141,-41.74053182917007,58.25946817082993,67.80260807512025,-1.861065045144647,0.5577,0.5683,0.5011,0.5426,113928893.0,234043.0,52388055.0,-2.707548861395016,53.99792315680167,0.5897470583585098,0.42933294164149016,0.04347960390322769,0.04612362596883575,-0.0026440220656080565,0.06720000000000004,0.05049285714285714,7481061044.089998,0.01079999999999992,4.446583253128011,-33.52044907778673,66.47955092221326,76.37164046802496,0.5528999999999998,0.5481498186339313,0.5434,0.542400328882064,0.50954,0.5049840159713833,505005.0,36606370.0,951695.0,30373489.42857143
2023-12-06,0.5327,0.5433,0.5016,0.5045,52069998.0,115061.0,25223206.0,0.5265666666666666,0.5397714285714286,0.517465,0.5224374546584828,0.531087684996161,0.5073175278133093,47.241867043847236,0.5822022104824716,0.45272778951752835,0.03545437664472828,0.043089269846283425,-0.007634893201555144,0.04169999999999996,0.04366428571428571,7363650071.089998,-0.030000000000000027,-2.2665633475397184,-77.95121951219518,22.048780487804827,48.929266526949355,-5.293786371315939,0.5427,0.5476,0.5139,0.5326,65340975.0,127056.0,31419861.0,-1.861065045144647,65.05421184320267,0.5887832105277709,0.4389767894722291,0.040495461858018056,0.04499799314667221,-0.004502531288654153,0.03369999999999995,0.04700714285714286,7415720069.089998,9.999999999998899e-05,15.682015638575141,-41.74053182917007,58.25946817082993,67.80260807512025,0.5443333333333332,0.5403749093169656,0.5423428571428571,0.539950246661548,0.51388,0.5076141096883945,506755.0,37703534.0,931134.0,30019706.14285714
2023-12-07,0.5044,0.5371,0.4856,0.5267,54730761.0,111783.0,26492364.0,0.5212666666666665,0.5395571428571428,0.521725,0.5245687273292414,0.5299907637471207,0.509163477545375,57.08955223880595,0.5757395350808396,0.46771046491916035,0.03287171014833623,0.041045757906693986,-0.008174047758357755,0.051500000000000046,0.04445714285714286,7418380832.089998,0.012899999999999912,6.125327422929661,-58.40080971659924,41.59919028340076,40.635812980678516,4.421094369547975,0.5327,0.5433,0.5016,0.5045,52069998.0,115061.0,25223206.0,-5.293786371315939,47.241867043847236,0.5822022104824716,0.45272778951752835,0.03545437664472828,0.043089269846283425,-0.007634893201555144,0.04169999999999996,0.04366428571428571,7363650071.089998,-0.030000000000000027,-2.2665633475397184,-77.95121951219518,22.048780487804827,48.929266526949355,0.5265666666666666,0.5224374546584828,0.5397714285714286,0.531087684996161,0.517465,0.5073175278133093,476160.0,36343707.333333336,940793.0,30328312.714285713
2023-12-08,0.5267,0.5452,0.5194,0.5378,46217436.0,93794.0,22879375.0,0.5229999999999998,0.5371857142857143,0.5254949999999999,0.5311843636646207,0.5319430728103405,0.5118907653981964,51.57894736842103,0.5720910230966157,0.4788989769033841,0.03135911719363205,0.039108429764081604,-0.007749312570449557,0.025800000000000045,0.041,7464598268.089998,-0.0022000000000000908,1.1282437006393087,-47.16599190283407,52.83400809716593,38.82732628945718,2.1074615530662615,0.5044,0.5371,0.4856,0.5267,54730761.0,111783.0,26492364.0,4.421094369547975,57.08955223880595,0.5757395350808396,0.46771046491916035,0.03287171014833623,0.041045757906693986,-0.008174047758357755,0.051500000000000046,0.04445714285714286,7418380832.089998,0.012899999999999912,6.125327422929661,-58.40080971659924,41.59919028340076,40.635812980678516,0.5212666666666665,0.5245687273292414,0.5395571428571428,0.5299907637471207,0.521725,0.509163477545375,353900.0,27711810.333333332,975900.0,31937487.57142857
2023-12-09,0.5378,0.5554,0.5013,0.5132,57684504.0,122511.0,27667749.0,0.5258999999999999,0.5307428571428571,0.52618,0.5221921818323103,0.5272573046077553,0.5120154544078921,45.48854604955587,0.5715537508164931,0.4808062491835069,0.02785427522406453,0.036857598856078186,-0.009003323632013657,0.05410000000000004,0.04314285714285715,7406913764.089998,-0.009299999999999975,-3.6244131455399065,-72.06477732793523,27.935222672064775,40.7894736842105,-4.574191149126062,0.5267,0.5452,0.5194,0.5378,46217436.0,93794.0,22879375.0,2.1074615530662615,51.57894736842103,0.5720910230966157,0.4788989769033841,0.03135911719363205,0.039108429764081604,-0.007749312570449557,0.025800000000000045,0.041,7464598268.089998,-0.0022000000000000908,1.1282437006393087,-47.16599190283407,52.83400809716593,38.82732628945718,0.5229999999999998,0.5311843636646207,0.5371857142857143,0.5319430728103405,0.5254949999999999,0.5118907653981964,320638.0,24864981.666666668,952699.0,30833416.57142857
2023-12-10,0.5133,0.5303,0.501,0.5284,36929457.0,78862.0,17730801.0,0.5264666666666665,0.5265428571428571,0.526625,0.5252960909161551,0.5275429784558165,0.5135758873214262,48.656979304271246,0.5718973628950885,0.48135263710491155,0.026003424390653396,0.03468676396299323,-0.008683339572339834,0.029299999999999993,0.04245714285714286,7443843221.089998,0.00019999999999997797,-1.1412535079513564,-56.68016194331986,43.31983805668014,41.36302294197029,2.941749464250926,0.5378,0.5554,0.5013,0.5132,57684504.0,122511.0,27667749.0,-4.574191149126062,45.48854604955587,0.5715537508164931,0.4808062491835069,0.02785427522406453,0.036857598856078186,-0.009003323632013657,0.05410000000000004,0.04314285714285715,7406913764.089998,-0.009299999999999975,-3.6244131455399065,-72.06477732793523,27.935222672064775,40.7894736842105,0.5258999999999999,0.5221921818323103,0.5307428571428571,0.5272573046077553,0.52618,0.5120154544078921,328088.0,25679829.333333332,949904.0,30767613.714285713
2023-12-11,0.5282,0.535,0.4659,0.4917,91985124.0,193557.0,44953131.0,0.5110999999999999,0.5192714285714286,0.5281899999999999,0.5084980454580776,0.5185822338418624,0.5114924694812903,45.45454545454546,0.5652406282353069,0.4911393717646931,0.02132935693552329,0.03201528255749925,-0.010685925621975956,0.06910000000000005,0.04340000000000001,7351858097.089998,-0.06269999999999998,-4.301284546516159,-78.22784810126579,21.772151898734208,31.009070875826392,-6.910261264672468,0.5133,0.5303,0.501,0.5284,36929457.0,78862.0,17730801.0,2.941749464250926,48.656979304271246,0.5718973628950885,0.48135263710491155,0.026003424390653396,0.03468676396299323,-0.008683339572339834,0.029299999999999993,0.04245714285714286,7443843221.089998,0.00019999999999997797,-1.1412535079513564,-56.68016194331986,43.31983805668014,41.36302294197029,0.5264666666666665,0.5252960909161551,0.5265428571428571,0.5275429784558165,0.526625,0.5135758873214262,295167.0,22759308.333333332,883110.0,29114487.285714287
2023-12-12,0.4917,0.6055,0.4907,0.6031,151733658.0,319810.0,79220629.0,0.5410666666666666,0.5293428571428571,0.532535,0.5557990227290388,0.5397116753813969,0.520216996197358,59.61011270179712,0.5819755022542985,0.4830944977457015,0.026310878365999435,0.030874401719199286,-0.004563523353199851,0.11480000000000001,0.04749285714285715,7503591755.089998,0.04479999999999995,11.685185185185176,-1.7191977077364382,98.28080229226356,54.45759741589265,22.65609111246694,0.5282,0.535,0.4659,0.4917,91985124.0,193557.0,44953131.0,-6.910261264672468,45.45454545454546,0.5652406282353069,0.4911393717646931,0.02132935693552329,0.03201528255749925,-0.010685925621975956,0.06910000000000005,0.04340000000000001,7351858097.089998,-0.06269999999999998,-4.301284546516159,-78.22784810126579,21.772151898734208,31.009070875826392,0.5110999999999999,0.5084980454580776,0.5192714285714286,0.5185822338418624,0.5281899999999999,0.5114924694812903,394930.0,30117227.0,842624.0,28052355.285714287
2023-12-13,0.6031,0.6578,0.5658,0.6288,208816315.0,554765.0,105733274.0,0.5745333333333332,0.5471,0.53916,0.5922995113645194,0.5619837565360477,0.5305582346547525,65.79494799405647,0.6018822582837227,0.4764377417162773,0.03196408315208754,0.03109233800577694,0.0008717451463106027,0.09200000000000008,0.051242857142857146,7712408070.089998,0.07100000000000006,20.34449760765551,-15.112037519541435,84.88796248045857,68.31363889048545,4.261316531255191,0.4917,0.6055,0.4907,0.6031,151733658.0,319810.0,79220629.0,22.65609111246694,59.61011270179712,0.5819755022542985,0.4830944977457015,0.026310878365999435,0.030874401719199286,-0.004563523353199851,0.11480000000000001,0.04749285714285715,7503591755.089998,0.04479999999999995,11.685185185185176,-1.7191977077364382,98.28080229226356,54.45759741589265,0.5410666666666666,0.5557990227290388,0.5293428571428571,0.5397116753813969,0.532535,0.520216996197358,592229.0,47301520.333333336,1035378.0,34881036.428571425
2023-12-14,0.6289,0.716,0.6224,0.7053,120724095.0,317874.0,62135941.0,0.6457333333333333,0.5726142857142857,0.547835,0.6487997556822598,0.5978128174020358,0.5472003075447761,71.74073164743433,0.644875529243142,0.45079447075685797,0.0421315332477169,0.03330017705416493,0.008831356193551972,0.09360000000000002,0.05630000000000002,7833132165.089998,0.16270000000000007,33.5289663006437,-4.278288684526163,95.72171131547384,92.96349202939867,12.148195261567821,0.6031,0.6578,0.5658,0.6288,208816315.0,554765.0,105733274.0,4.261316531255191,65.79494799405647,0.6018822582837227,0.4764377417162773,0.03196408315208754,0.03109233800577694,0.0008717451463106027,0.09200000000000008,0.051242857142857146,7712408070.089998,0.07100000000000006,20.34449760765551,-15.112037519541435,84.88796248045857,68.31363889048545,0.5745333333333332,0.5922995113645194,0.5471,0.5619837565360477,0.53916,0.5305582346547525,1068132.0,76635678.0,1475082.0,46382474.71428572
2023-12-15,0.7054,0.7508,0.6665,0.6694,111073497.0,329479.0,55421885.0,0.6678333333333333,0.5914142857142857,0.5546800000000001,0.6590998778411299,0.6157096130515269,0.5588383734928927,63.78896882494004,0.6655007770753241,0.44385922292467606,0.04675353508050084,0.03599084865943211,0.010762686421068729,0.08430000000000004,0.05929285714285716,7722058668.089998,0.13680000000000003,20.743145743145753,-28.571428571428577,71.42857142857142,84.01274840816797,-5.103487383045085,0.6289,0.716,0.6224,0.7053,120724095.0,317874.0,62135941.0,12.148195261567821,71.74073164743433,0.644875529243142,0.45079447075685797,0.0421315332477169,0.03330017705416493,0.008831356193551972,0.09360000000000002,0.05630000000000002,7833132165.089998,0.16270000000000007,33.5289663006437,-4.278288684526163,95.72171131547384,92.96349202939867,0.6457333333333333,0.6487997556822598,0.5726142857142857,0.5978128174020358,0.547835,0.5472003075447761,1192449.0,82363281.33333333,1681173.0,51474414.28571428
2023-12-16,0.6692,0.6969,0.6367,0.6467,74515562.0,226161.0,36285487.0,0.6738,0.6104857142857144,0.56029,0.652899938920565,0.6234572097886453,0.5672061474459505,60.14226709499771,0.6779576121427141,0.4426223878572858,0.04803113155826044,0.038398905239197784,0.009632226319062659,0.06019999999999992,0.06083571428571429,7647543106.089998,0.1422000000000001,15.83378112126097,-36.53913653913652,63.46086346086348,76.87038206830293,-3.3622235505080638,0.7054,0.7508,0.6665,0.6694,111073497.0,329479.0,55421885.0,-5.103487383045085,63.78896882494004,0.6655007770753241,0.44385922292467606,0.04675353508050084,0.03599084865943211,0.010762686421068729,0.08430000000000004,0.05929285714285716,7722058668.089998,0.13680000000000003,20.743145743145753,-28.571428571428577,71.42857142857142,84.01274840816797,0.6678333333333333,0.6590998778411299,0.5914142857142857,0.6157096130515269,0.5546800000000001,0.5588383734928927,1202118.0,74430366.66666667,1916858.0,56123344.28571428
2023-12-17,0.6466,0.6627,0.6181,0.638,47438897.0,129795.0,23787812.0,0.6513666666666666,0.6261428571428571,0.5664999999999999,0.6454499694602824,0.6270929073414839,0.5739484191177648,59.03153153153154,0.6869143373173593,0.44608566268264044,0.047790717043020736,0.04027726759996238,0.007513449443058359,0.04459999999999997,0.061564285714285724,7600104209.089998,0.11130000000000007,14.3779132305486,-39.59283959283959,60.40716040716041,65.09886509886512,-1.3300340241261894,0.6692,0.6969,0.6367,0.6467,74515562.0,226161.0,36285487.0,-3.3622235505080638,60.14226709499771,0.6779576121427141,0.4426223878572858,0.04803113155826044,0.038398905239197784,0.009632226319062659,0.06019999999999992,0.06083571428571429,7647543106.089998,0.1422000000000001,15.83378112126097,-36.53913653913652,63.46086346086348,76.87038206830293,0.6738,0.652899938920565,0.6104857142857144,0.6234572097886453,0.56029,0.5672061474459505,873514.0,51281104.333333336,2020508.0,57354449.71428572
2023-12-18,0.6383,0.7093,0.589,0.7081,110354695.0,343533.0,53706060.0,0.6642666666666667,0.6570571428571429,0.574905,0.6767749847301412,0.6473446805061129,0.5867247601541682,66.58649027861296,0.710091880008068,0.439718119991932,0.05264975732831123,0.04275176554563215,0.009897991782679083,0.12030000000000007,0.06535714285714288,7710458904.089998,0.1703,30.501290084777,-14.987714987715012,85.01228501228499,69.62676962676964,10.93529688234372,0.6466,0.6627,0.6181,0.638,47438897.0,129795.0,23787812.0,-1.3300340241261894,59.03153153153154,0.6869143373173593,0.44608566268264044,0.047790717043020736,0.04027726759996238,0.007513449443058359,0.04459999999999997,0.061564285714285724,7600104209.089998,0.11130000000000007,14.3779132305486,-39.59283959283959,60.40716040716041,65.09886509886512,0.6513666666666666,0.6454499694602824,0.6261428571428571,0.6270929073414839,0.5664999999999999,0.5739484191177648,685435.0,38498394.666666664,2071441.0,58219737.0
2023-12-19,0.7083,0.7447,0.6861,0.7075,97325725.0,275289.0,48513252.0,0.6845333333333333,0.6719714285714286,0.584155,0.6921374923650706,0.6623835103795848,0.5982271639490093,67.86516853932585,0.7292012644886292,0.43910873551137075,0.05580883724039565,0.04536317988458485,0.010445657355810795,0.058599999999999985,0.0671357142857143,7613133179.089998,0.19430000000000003,32.83890349230192,-15.198315198315198,84.8016848016848,76.74037674037675,-0.1129464915996079,0.6383,0.7093,0.589,0.7081,110354695.0,343533.0,53706060.0,10.93529688234372,66.58649027861296,0.710091880008068,0.439718119991932,0.05264975732831123,0.04275176554563215,0.009897991782679083,0.12030000000000007,0.06535714285714288,7710458904.089998,0.1703,30.501290084777,-14.987714987715012,85.01228501228499,69.62676962676964,0.6642666666666667,0.6767749847301412,0.6570571428571429,0.6473446805061129,0.574905,0.5867247601541682,699489.0,37926453.0,2221417.0,59470155.428571425
2023-12-20,0.7079,0.79,0.6911,0.7359,105564100.0,316110.0,53756759.0,0.7171666666666665,0.6872714285714286,0.59454,0.7140187461825354,0.6807626327846885,0.6113388626205323,73.62188648427932,0.7519339796882508,0.4371460203117491,0.05991342876991601,0.04827322966165109,0.011640199108264922,0.09889999999999999,0.07122142857142859,7718697279.089998,0.20750000000000002,45.86719524281469,-16.692378895402662,83.30762110459735,84.37386363952238,3.955360926684564,0.7083,0.7447,0.6861,0.7075,97325725.0,275289.0,48513252.0,-0.1129464915996079,67.86516853932585,0.7292012644886292,0.43910873551137075,0.05580883724039565,0.04536317988458485,0.010445657355810795,0.058599999999999985,0.0671357142857143,7613133179.089998,0.19430000000000003,32.83890349230192,-15.198315198315198,84.8016848016848,76.74037674037675,0.6845333333333333,0.6921374923650706,0.6719714285714286,0.6623835103795848,0.584155,0.5982271639490093,748617.0,42002374.666666664,2176896.0,55083387.28571428
2023-12-21,0.7359,0.7644,0.699,0.7644,74435388.0,204177.0,36246217.0,0.7359333333333332,0.6957142857142856,0.60504,0.7392093730912677,0.7016719745885165,0.6259161137995292,73.95686353557753,0.778371023736301,0.4317089762636991,0.06472000699082325,0.05156258512748552,0.01315742186333773,0.06540000000000001,0.07221428571428572,7793132667.089998,0.27269999999999994,45.13005505980634,-7.8987966676951755,92.10120333230482,86.73683641286233,3.872808805544228,0.7079,0.79,0.6911,0.7359,105564100.0,316110.0,53756759.0,3.955360926684564,73.62188648427932,0.7519339796882508,0.4371460203117491,0.05991342876991601,0.04827322966165109,0.011640199108264922,0.09889999999999999,0.07122142857142859,7718697279.089998,0.20750000000000002,45.86719524281469,-16.692378895402662,83.30762110459735,84.37386363952238,0.7171666666666665,0.7140187461825354,0.6872714285714286,0.6807626327846885,0.59454,0.6113388626205323,934932.0,51992023.666666664,1938241.0,47658170.85714286
2023-12-22,0.7642,0.7798,0.7057,0.7206,63255263.0,206660.0,31345172.0,0.7403,0.7030285714285714,0.6131550000000001,0.7299046865456338,0.7064039809413873,0.6349336267710026,67.28441754916794,0.7923695021739989,0.4339404978260013,0.06425427759705182,0.05410092362139878,0.010153353975653041,0.07410000000000005,0.07566428571428573,7729877404.089998,0.11750000000000005,33.99033097805877,-21.41314409132984,78.58685590867016,84.66522678185744,-5.7053127453546155,0.7359,0.7644,0.699,0.7644,74435388.0,204177.0,36246217.0,3.872808805544228,73.95686353557753,0.778371023736301,0.4317089762636991,0.06472000699082325,0.05156258512748552,0.01315742186333773,0.06540000000000001,0.07221428571428572,7793132667.089998,0.27269999999999994,45.13005505980634,-7.8987966676951755,92.10120333230482,86.73683641286233,0.7359333333333332,0.7392093730912677,0.6957142857142856,0.7016719745885165,0.60504,0.6259161137995292,795576.0,46172076.0,1824544.0,43959638.85714286
2023-12-23,0.7204,0.7495,0.7005,0.7359,41554112.0,141738.0,20369750.0,0.7403,0.7157714285714285,0.6220600000000001,0.7329023432728169,0.7137779857060405,0.644549471840431,71.43407122232918,0.8072915239738768,0.4368284760261233,0.06437766023615332,0.0561562709443497,0.008221389291803625,0.049000000000000044,0.07530000000000002,7771431516.089998,0.10709999999999997,43.39438815276695,-16.692378895402662,83.30762110459735,84.66522678185746,2.1515824541921096,0.7642,0.7798,0.7057,0.7206,63255263.0,206660.0,31345172.0,-5.7053127453546155,67.28441754916794,0.7923695021739989,0.4339404978260013,0.06425427759705182,0.05410092362139878,0.010153353975653041,0.07410000000000005,0.07566428571428573,7729877404.089998,0.11750000000000005,33.99033097805877,-21.41314409132984,78.58685590867016,84.66522678185744,0.7403,0.7299046865456338,0.7030285714285714,0.7064039809413873,0.6131550000000001,0.6349336267710026,726947.0,40449382.666666664,1701725.0,40520108.428571425
2023-12-24,0.736,0.7519,0.6958,0.7099,46167494.0,153629.0,22333473.0,0.7221333333333333,0.7260428571428571,0.630425,0.7214011716364084,0.7128084892795303,0.6507733316651518,67.11295493117105,0.8156579500641679,0.4451920499358322,0.06166660492221676,0.057258337739923115,0.004408267182293646,0.05610000000000004,0.07721428571428575,7725264022.089998,0.0045999999999999375,34.34897804693413,-24.71459426103056,75.28540573896943,79.05996091741231,-3.546195652173915,0.7204,0.7495,0.7005,0.7359,41554112.0,141738.0,20369750.0,2.1515824541921096,71.43407122232918,0.8072915239738768,0.4368284760261233,0.06437766023615332,0.0561562709443497,0.008221389291803625,0.049000000000000044,0.07530000000000002,7771431516.089998,0.10709999999999997,43.39438815276695,-16.692378895402662,83.30762110459735,84.66522678185746,0.7403,0.7329023432728169,0.7157714285714285,0.7137779857060405,0.6220600000000001,0.644549471840431,552575.0,29320379.666666668,1617302.0,38246431.71428572
2023-12-25,0.7097,0.7515,0.7036,0.7391,46277241.0,145779.0,23296362.0,0.7283,0.7304714285714287,0.6407499999999999,0.7302505858182042,0.7193813669596477,0.6591853953160898,73.6610558530987,0.8260445478790057,0.45545545212099414,0.061169150132982075,0.05804050021853491,0.003128649914447168,0.04789999999999994,0.0757,7771541263.089998,0.06969999999999998,50.315232865568426,-17.006348145673257,82.99365185432674,80.52889289929784,4.142595462871633,0.736,0.7519,0.6958,0.7099,46167494.0,153629.0,22333473.0,-3.546195652173915,67.11295493117105,0.8156579500641679,0.4451920499358322,0.06166660492221676,0.057258337739923115,0.004408267182293646,0.05610000000000004,0.07721428571428575,7725264022.089998,0.0045999999999999375,34.34897804693413,-24.71459426103056,75.28540573896943,79.05996091741231,0.7221333333333333,0.7214011716364084,0.7260428571428571,0.7128084892795303,0.630425,0.6507733316651518,502027.0,24682798.333333332,1641136.0,38038669.0
2023-12-26,0.7394,0.7952,0.7024,0.7666,90746725.0,340498.0,45863453.0,0.7385333333333332,0.7389142857142856,0.653855,0.7484252929091021,0.7311860252197357,0.6694153576669384,68.6261107313739,0.8356160748091862,0.4720939251908137,0.062276054213974974,0.05888761101762292,0.0033884431963520506,0.0928,0.07412857142857143,7862287988.089998,0.1198999999999999,27.10993201790748,-12.46730601569314,87.53269398430686,81.9372505258677,3.6786583716526917,0.7097,0.7515,0.7036,0.7391,46277241.0,145779.0,23296362.0,4.142595462871633,73.6610558530987,0.8260445478790057,0.45545545212099414,0.061169150132982075,0.05804050021853491,0.003128649914447168,0.04789999999999994,0.0757,7771541263.089998,0.06969999999999998,50.315232865568426,-17.006348145673257,82.99365185432674,80.52889289929784,0.7283,0.7302505858182042,0.7304714285714287,0.7193813669596477,0.6407499999999999,0.6591853953160898,441146.0,21999861.666666668,1443382.0,33694426.428571425
2023-12-27,0.7669,0.77,0.7134,0.7378,43538666.0,167106.0,21077149.0,0.7478333333333333,0.7391857142857142,0.66441,0.743112646454551,0.7328395189148018,0.6759281807462776,62.33031674208145,0.8394747266764983,0.48934527332350164,0.06013615223510649,0.059137319261119634,0.0009988329739868546,0.056599999999999984,0.0716,7818749322.089998,0.0998,17.33460559796438,-27.837051406401546,72.16294859359846,80.8964314774107,-3.7944973269005104,0.7394,0.7952,0.7024,0.7666,90746725.0,340498.0,45863453.0,3.6786583716526917,68.6261107313739,0.8356160748091862,0.4720939251908137,0.062276054213974974,0.05888761101762292,0.0033884431963520506,0.0928,0.07412857142857143,7862287988.089998,0.1198999999999999,27.10993201790748,-12.46730601569314,87.53269398430686,81.9372505258677,0.7385333333333332,0.7484252929091021,0.7389142857142856,0.7311860252197357,0.653855,0.6694153576669384,639906.0,30497762.666666668,1508591.0,33315883.714285713
2023-12-28,0.738,0.7551,0.6743,0.6837,46493273.0,164657.0,21105900.0,0.7293666666666665,0.7276571428571429,0.671705,0.7134063232272755,0.7205546391861013,0.6766683540085369,47.42612011439466,0.836408273543032,0.507001726456968,0.05345860906379818,0.058001577221655345,-0.004542968157857166,0.08079999999999998,0.07068571428571428,7772256049.089998,-0.024399999999999977,-3.062526584432168,-54.073714839961205,45.92628516003879,68.5406425793147,-7.357723577235774,0.7669,0.77,0.7134,0.7378,43538666.0,167106.0,21077149.0,-3.7944973269005104,62.33031674208145,0.8394747266764983,0.48934527332350164,0.06013615223510649,0.059137319261119634,0.0009988329739868546,0.056599999999999984,0.0716,7818749322.089998,0.0998,17.33460559796438,-27.837051406401546,72.16294859359846,80.8964314774107,0.7478333333333333,0.743112646454551,0.7391857142857142,0.7328395189148018,0.66441,0.6759281807462776,653383.0,30078988.0,1359587.0,28647368.0
2023-12-29,0.6837,0.7236,0.6613,0.687,40537912.0,150568.0,19757905.0,0.7028333333333333,0.722857142857143,0.680395,0.7002031616136377,0.712165979389576,0.6776523202934381,52.27390180878554,0.8272596562763124,0.5335303437236876,0.047880948641105814,0.05597745150554544,-0.00809650286443963,0.06230000000000002,0.06911428571428571,7812793961.089998,-0.020499999999999963,2.6292201971915174,-52.473326867119276,47.52667313288073,55.20530229550601,0.48266783677052516,0.738,0.7551,0.6743,0.6837,46493273.0,164657.0,21105900.0,-7.357723577235774,47.42612011439466,0.836408273543032,0.507001726456968,0.05345860906379818,0.058001577221655345,-0.004542968157857166,0.08079999999999998,0.07068571428571428,7772256049.089998,-0.024399999999999977,-3.062526584432168,-54.073714839961205,45.92628516003879,68.5406425793147,0.7293666666666665,0.7134063232272755,0.7276571428571429,0.7205546391861013,0.671705,0.6766683540085369,672261.0,29348834.0,1320067.0,26484465.57142857
2023-12-30,0.6869,0.7015,0.6668,0.6898,20756755.0,83368.0,9875403.0,0.6868333333333333,0.7162714285714287,0.688465,0.6950015808068188,0.706574484542182,0.6788092421702536,55.870335058567136,0.8167223937542518,0.5602076062457482,0.043188696758471035,0.053419700556130566,-0.010231003797659531,0.034700000000000064,0.06729285714285715,7833550716.089998,-0.04610000000000003,6.664604917272299,-51.11542192046558,48.88457807953442,47.445845457484666,0.42218663560926095,0.6837,0.7236,0.6613,0.687,40537912.0,150568.0,19757905.0,0.48266783677052516,52.27390180878554,0.8272596562763124,0.5335303437236876,0.047880948641105814,0.05597745150554544,-0.00809650286443963,0.06230000000000002,0.06911428571428571,7812793961.089998,-0.020499999999999963,2.6292201971915174,-52.473326867119276,47.52667313288073,55.20530229550601,0.7028333333333333,0.7002031616136377,0.722857142857143,0.712165979389576,0.680395,0.6776523202934381,482331.0,20646984.666666668,1263975.0,24829141.714285713
2023-12-31,0.69,0.707,0.665,0.6725,24413364.0,83877.0,11284780.0,0.6830999999999999,0.7109285714285714,0.697505,0.6837507904034095,0.6980558634066364,0.6782083619635628,54.59142933191376,0.7869962986067223,0.6080137013932778,0.03764019517796269,0.050263799480496994,-0.012623604302534307,0.041999999999999926,0.06710714285714285,7809137352.089998,-0.09189999999999998,5.407523510971779,-59.50533462657614,40.494665373423864,45.635305528613024,-2.5362318840579654,0.6869,0.7015,0.6668,0.6898,20756755.0,83368.0,9875403.0,0.42218663560926095,55.870335058567136,0.8167223937542518,0.5602076062457482,0.043188696758471035,0.053419700556130566,-0.010231003797659531,0.034700000000000064,0.06729285714285715,7833550716.089998,-0.04610000000000003,6.664604917272299,-51.11542192046558,48.88457807953442,47.445845457484666,0.6868333333333333,0.6950015808068188,0.7162714285714287,0.706574484542182,0.688465,0.6788092421702536,398593.0,16913069.333333332,1205605.0,23329949.285714287
2024-01-01,0.6726,0.7362,0.6708,0.7326,25869044.0,95950.0,12916894.0,0.6983,0.71,0.70398,0.7081753952017047,0.7066918975549773,0.683388517967033,53.349740224227524,0.7828164489573977,0.6251435510426024,0.03765843245616307,0.04774272607563021,-0.010084293619467138,0.06540000000000001,0.06318571428571429,7835006396.089998,0.01200000000000001,3.459963282022316,-46.75130694548169,53.24869305451831,47.54264550249221,8.920606601248892,0.69,0.707,0.665,0.6725,24413364.0,83877.0,11284780.0,-2.5362318840579654,54.59142933191376,0.7869962986067223,0.6080137013932778,0.03764019517796269,0.050263799480496994,-0.012623604302534307,0.041999999999999926,0.06710714285714285,7809137352.089998,-0.09189999999999998,5.407523510971779,-59.50533462657614,40.494665373423864,45.635305528613024,0.6830999999999999,0.6837507904034095,0.7109285714285714,0.6980558634066364,0.697505,0.6782083619635628,317813.0,13639362.666666666,1135853.0,21751564.57142857
2024-01-02,0.7326,0.7588,0.7016,0.7331,43697832.0,159036.0,21801248.0,0.7127333333333333,0.7052142857142857,0.709195,0.7206376976008524,0.713293923166233,0.6881229448273156,53.50109409190372,0.7805342923400621,0.6378557076599379,0.037283451036449144,0.045650871067794,-0.008367420031344858,0.05720000000000003,0.06308571428571429,7878704228.089998,-0.0028000000000000247,3.618374558303872,-46.377893950709506,53.62210604929049,49.1218214924109,0.06825006825006073,0.6726,0.7362,0.6708,0.7326,25869044.0,95950.0,12916894.0,8.920606601248892,53.349740224227524,0.7828164489573977,0.6251435510426024,0.03765843245616307,0.04774272607563021,-0.010084293619467138,0.06540000000000001,0.06318571428571429,7835006396.089998,0.01200000000000001,3.459963282022316,-46.75130694548169,53.24869305451831,47.54264550249221,0.6983,0.7081753952017047,0.71,0.7066918975549773,0.70398,0.683388517967033,263195.0,11359025.666666666,1086024.0,20268783.42857143
2024-01-03,0.7333,0.7407,0.5654,0.6581,77331193.0,311977.0,36412426.0,0.7079333333333334,0.6938285714285714,0.706835,0.6893688488004261,0.6994954423746748,0.6852636167485237,40.562833575934,0.7817500894785611,0.6319199105214389,0.030581873559050066,0.042637071566045216,-0.01205519800699515,0.1753,0.06854285714285714,7801373035.089998,-0.05179999999999996,-10.572088598994423,-59.66057441253264,40.33942558746737,49.07007489709207,-10.255011591435965,0.7326,0.7588,0.7016,0.7331,43697832.0,159036.0,21801248.0,0.06825006825006073,53.50109409190372,0.7805342923400621,0.6378557076599379,0.037283451036449144,0.045650871067794,-0.008367420031344858,0.05720000000000003,0.06308571428571429,7878704228.089998,-0.0028000000000000247,3.618374558303872,-46.377893950709506,53.62210604929049,49.1218214924109,0.7127333333333333,0.7206376976008524,0.7052142857142857,0.713293923166233,0.709195,0.6881229448273156,338863.0,15334307.333333334,904562.0,16831325.57142857
2024-01-04,0.6576,0.7296,0.6418,0.7261,41563087.0,152191.0,21171444.0,0.7057666666666665,0.6998857142857143,0.70967,0.7077344244002131,0.706146581781006,0.6891527961058072,45.760460482621205,0.7828925188255621,0.636447481174438,0.0304073399393322,0.04019112524070262,-0.009783785301370418,0.08779999999999999,0.07014285714285716,7842936122.089998,-0.013000000000000012,-5.010465724751434,-30.06962576153179,69.9303742384682,54.63063529174203,10.416666666666668,0.7333,0.7407,0.5654,0.6581,77331193.0,311977.0,36412426.0,-10.255011591435965,40.562833575934,0.7817500894785611,0.6319199105214389,0.030581873559050066,0.042637071566045216,-0.01205519800699515,0.1753,0.06854285714285714,7801373035.089998,-0.05179999999999996,-10.572088598994423,-59.66057441253264,40.33942558746737,49.07007489709207,0.7079333333333334,0.6893688488004261,0.6938285714285714,0.6994954423746748,0.706835,0.6852636167485237,566963.0,23710189.333333332,1049433.0,19022079.42857143
2024-01-05,0.7262,0.7476,0.6655,0.6896,53156409.0,216054.0,26573779.0,0.6912666666666666,0.7002571428571428,0.711815,0.6986672122001065,0.7020099363357545,0.6891953869528731,46.5121512151215,0.779580641814479,0.644049358185521,0.02701239377072895,0.037555378946707886,-0.010542985175978938,0.08210000000000006,0.07071428571428573,7789779713.089998,-0.07699999999999996,-4.301970580072167,-45.953002610966074,54.04699738903393,54.77226573832318,-5.039933902506192,0.6576,0.7296,0.6418,0.7261,41563087.0,152191.0,21171444.0,10.416666666666668,45.760460482621205,0.7828925188255621,0.636447481174438,0.0304073399393322,0.04019112524070262,-0.009783785301370418,0.08779999999999999,0.07014285714285716,7842936122.089998,-0.013000000000000012,-5.010465724751434,-30.06962576153179,69.9303742384682,54.63063529174203,0.7057666666666665,0.7077344244002131,0.6998857142857143,0.706146581781006,0.70967,0.6891527961058072,623204.0,26461706.0,1036967.0,19031442.85714286
2024-01-06,0.69,0.6901,0.619,0.6485,37822694.0,136486.0,17522196.0,0.6880666666666665,0.6943571428571429,0.71234,0.6735836061000533,0.6886324522518158,0.6853196358145043,40.70608251807741,0.7778219991335654,0.6468580008664345,0.02076606963554717,0.03419751708447574,-0.013431447448928574,0.07110000000000005,0.07229285714285714,7751957019.089998,-0.08930000000000005,-11.876613670335646,-63.838120104438666,36.16187989556134,53.379750507687845,-6.014492753623186,0.7262,0.7476,0.6655,0.6896,53156409.0,216054.0,26573779.0,-5.039933902506192,46.5121512151215,0.779580641814479,0.644049358185521,0.02701239377072895,0.037555378946707886,-0.010542985175978938,0.08210000000000006,0.07071428571428573,7789779713.089998,-0.07699999999999996,-4.301970580072167,-45.953002610966074,54.04699738903393,54.77226573832318,0.6912666666666666,0.6986672122001065,0.7002571428571428,0.7020099363357545,0.711815,0.6891953869528731,680222.0,28052549.666666668,1102453.0,20005139.14285714
2024-01-07,0.6484,0.6621,0.6092,0.622,25658808.0,89352.0,11620122.0,0.6533666666666665,0.6871428571428572,0.708035,0.6477918030500267,0.6719743391888618,0.679289194308361,40.662842574888465,0.7850041195767687,0.6310658804232312,0.013521615459714753,0.030062336759523547,-0.016540721299808794,0.05290000000000006,0.07206428571428572,7726298211.089998,-0.06169999999999998,-12.382025637413719,-75.36988685813752,24.63011314186248,38.27966347548593,-4.071560764959898,0.69,0.6901,0.619,0.6485,37822694.0,136486.0,17522196.0,-6.014492753623186,40.70608251807741,0.7778219991335654,0.6468580008664345,0.02076606963554717,0.03419751708447574,-0.013431447448928574,0.07110000000000005,0.07229285714285714,7751957019.089998,-0.08930000000000005,-11.876613670335646,-63.838120104438666,36.16187989556134,53.379750507687845,0.6880666666666665,0.6735836061000533,0.6943571428571429,0.6886324522518158,0.71234,0.6853196358145043,504731.0,21755806.333333332,1155571.0,21097538.14285714
2024-01-08,0.622,0.6835,0.5666,0.6818,56603982.0,196069.0,28038681.0,0.6507666666666666,0.6798857142857143,0.70675,0.6647959015250133,0.6744307543916463,0.6795283186599456,44.28485936564931,0.7846096983784345,0.6288903016215655,0.012462038934949016,0.026542277194608645,-0.014080238259659629,0.1169,0.07699285714285717,7782902193.089998,-0.0052000000000000934,-7.752672168854014,-49.34725848563971,50.65274151436029,37.148244850594715,9.61414790996784,0.6484,0.6621,0.6092,0.622,25658808.0,89352.0,11620122.0,-4.071560764959898,40.662842574888465,0.7850041195767687,0.6310658804232312,0.013521615459714753,0.030062336759523547,-0.016540721299808794,0.05290000000000006,0.07206428571428572,7726298211.089998,-0.06169999999999998,-12.382025637413719,-75.36988685813752,24.63011314186248,38.27966347548593,0.6533666666666665,0.6477918030500267,0.6871428571428572,0.6719743391888618,0.708035,0.679289194308361,441892.0,18572032.333333332,1161046.0,21145444.14285714
2024-01-09,0.6819,0.6908,0.6246,0.6468,50087315.0,173724.0,25354207.0,0.6502,0.6675571428571428,0.702295,0.6557979507625067,0.6675230657937348,0.6764113359304269,38.22720125786164,0.7832660403071545,0.6213239596928455,0.008697846057312608,0.022973390967149437,-0.014275544909836829,0.06619999999999993,0.07509285714285716,7732814878.089998,-0.04299999999999993,-15.627445864857803,-60.21505376344085,39.78494623655916,38.355933630927325,-5.147382314122292,0.622,0.6835,0.5666,0.6818,56603982.0,196069.0,28038681.0,9.61414790996784,44.28485936564931,0.7846096983784345,0.6288903016215655,0.012462038934949016,0.026542277194608645,-0.014080238259659629,0.1169,0.07699285714285717,7782902193.089998,-0.0052000000000000934,-7.752672168854014,-49.34725848563971,50.65274151436029,37.148244850594715,0.6507666666666666,0.6647959015250133,0.6798857142857143,0.6744307543916463,0.70675,0.6795283186599456,421907.0,19060333.0,1261165.0,23305699.42857143
2024-01-10,0.6472,0.737,0.6294,0.7171,54953483.0,188128.0,28118156.0,0.6818999999999998,0.6759857142857143,0.6999299999999999,0.6864489753812533,0.679917299345301,0.6802864467941958,48.11920770488823,0.7758700899601761,0.6239899100398237,0.011257548548539886,0.020630222483427527,-0.009372673934887641,0.10760000000000003,0.07873571428571431,7787768361.089998,0.04459999999999997,-2.805638384386022,-21.561530506721855,78.43846949327813,56.29205241473253,10.800370828182935,0.6819,0.6908,0.6246,0.6468,50087315.0,173724.0,25354207.0,-5.147382314122292,38.22720125786164,0.7832660403071545,0.6213239596928455,0.008697846057312608,0.022973390967149437,-0.014275544909836829,0.06619999999999993,0.07509285714285716,7732814878.089998,-0.04299999999999993,-15.627445864857803,-60.21505376344085,39.78494623655916,38.355933630927325,0.6502,0.6557979507625067,0.6675571428571428,0.6675230657937348,0.702295,0.6764113359304269,459145.0,21671003.333333332,1275853.0,23813265.0
2024-01-11,0.7171,0.78,0.6969,0.7251,68750989.0,232549.0,36542922.0,0.6963333333333331,0.6758428571428572,0.700155,0.7057744876906267,0.6912129745089757,0.6845544042423676,54.105513685045615,0.776379087227634,0.6239309127723659,0.013772898949945156,0.019258757776731056,-0.0054858588267859,0.08310000000000006,0.07890000000000001,7856519350.089998,-0.007500000000000062,6.055287406757359,-25.582479030754918,74.41752096924507,64.2136455663608,1.1156045181982999,0.6472,0.737,0.6294,0.7171,54953483.0,188128.0,28118156.0,10.800370828182935,48.11920770488823,0.7758700899601761,0.6239899100398237,0.011257548548539886,0.020630222483427527,-0.009372673934887641,0.10760000000000003,0.07873571428571431,7787768361.089998,0.04459999999999997,-2.805638384386022,-21.561530506721855,78.43846949327813,56.29205241473253,0.6818999999999998,0.6864489753812533,0.6759857142857143,0.679917299345301,0.6999299999999999,0.6802864467941958,557921.0,27170348.0,1152004.0,22628369.285714287
2024-01-12,0.7252,0.7311,0.652,0.6853,45121278.0,172785.0,21342995.0,0.7091666666666665,0.6752285714285714,0.697625,0.6955372438453133,0.6897347308817317,0.6846254133621421,49.84279637506935,0.7721946107144659,0.6230553892855342,0.012411730188083947,0.017889352259001637,-0.00547762207091769,0.07909999999999995,0.08010000000000002,7811398072.089998,-0.047799999999999954,-0.24745269286754468,-44.12861136999068,55.87138863000932,69.57579303084418,-5.501930501930493,0.7171,0.78,0.6969,0.7251,68750989.0,232549.0,36542922.0,1.1156045181982999,54.105513685045615,0.776379087227634,0.6239309127723659,0.013772898949945156,0.019258757776731056,-0.0054858588267859,0.08310000000000006,0.07890000000000001,7856519350.089998,-0.007500000000000062,6.055287406757359,-25.582479030754918,74.41752096924507,64.2136455663608,0.6963333333333331,0.7057744876906267,0.6758428571428572,0.6912129745089757,0.700155,0.6845544042423676,594401.0,30005095.0,1232362.0,24824294.714285713
2024-01-13,0.6856,0.6997,0.6559,0.6891,20110179.0,82784.0,9846010.0,0.6998333333333333,0.6810285714285714,0.696585,0.6923186219226567,0.6895760481612987,0.6850515644705095,49.9353885914713,0.7710138363755086,0.6221561636244914,0.011506977110408267,0.016612877229282962,-0.005105900118874695,0.04379999999999995,0.08075,7831508251.089998,0.031000000000000028,-0.10147868947519845,-42.3578751164958,57.64212488350421,62.643678160919556,0.5105017502917238,0.7252,0.7311,0.652,0.6853,45121278.0,172785.0,21342995.0,-5.501930501930493,49.84279637506935,0.7721946107144659,0.6230553892855342,0.012411730188083947,0.017889352259001637,-0.00547762207091769,0.07909999999999995,0.08010000000000002,7811398072.089998,-0.047799999999999954,-0.24745269286754468,-44.12861136999068,55.87138863000932,69.57579303084418,0.7091666666666665,0.6955372438453133,0.6752285714285714,0.6897347308817317,0.697625,0.6846254133621421,593462.0,28668024.333333332,1189093.0,24077039.85714286
2024-01-14,0.689,0.6931,0.6501,0.6515,17893525.0,64146.0,8368097.0,0.6753,0.685242857142857,0.6922050000000001,0.6719093109613283,0.680057036120974,0.68185617737808,48.131672597864764,0.7664092550915098,0.6180007449084903,0.007667561142310153,0.014823814011888401,-0.007156252869578248,0.04300000000000004,0.08082142857142859,7813614726.089998,-0.0746,-3.122676579925654,-59.878844361603,40.12115563839699,51.21155638397019,-5.442670537010157,0.6856,0.6997,0.6559,0.6891,20110179.0,82784.0,9846010.0,0.5105017502917238,49.9353885914713,0.7710138363755086,0.6221561636244914,0.011506977110408267,0.016612877229282962,-0.005105900118874695,0.04379999999999995,0.08075,7831508251.089998,0.031000000000000028,-0.10147868947519845,-42.3578751164958,57.64212488350421,62.643678160919556,0.6998333333333333,0.6923186219226567,0.6810285714285714,0.6895760481612987,0.696585,0.6850515644705095,488118.0,22577309.0,1135391.0,22980441.85714286
2024-01-15,0.652,0.6944,0.6504,0.6846,25516964.0,82896.0,13302926.0,0.6750666666666666,0.6856428571428571,0.688105,0.6782546554806641,0.6811927770907306,0.6821174938182629,45.51401869158878,0.7535457075949512,0.6226642924050487,0.007212547934913549,0.013301560796493432,-0.006089012861579883,0.04400000000000004,0.07929285714285715,7839131690.089998,-0.0050000000000000044,-6.552006552006562,-44.45479962721344,55.54520037278656,51.10282696489594,4.999999999999994,0.689,0.6931,0.6501,0.6515,17893525.0,64146.0,8368097.0,-5.442670537010157,48.131672597864764,0.7664092550915098,0.6180007449084903,0.007667561142310153,0.014823814011888401,-0.007156252869578248,0.04300000000000004,0.08082142857142859,7813614726.089998,-0.0746,-3.122676579925654,-59.878844361603,40.12115563839699,51.21155638397019,0.6753,0.6719093109613283,0.685242857142857,0.680057036120974,0.6922050000000001,0.68185617737808,319715.0,13185700.666666666,1110185.0,22515866.85714286
2024-01-16,0.6846,0.7068,0.6641,0.6903,27079883.0,86381.0,13410037.0,0.6754666666666665,0.6918571428571428,0.68573,0.684277327740332,0.6834695828180479,0.6828967801212855,46.03850425768234,0.7468842002688929,0.624575799731107,0.007228562681997008,0.01208696117359415,-0.004858398491597141,0.04269999999999996,0.07825714285714287,7866211573.089998,0.04180000000000006,-5.838221252216602,-41.79869524697111,58.20130475302889,51.289220254737494,0.8326029798422494,0.652,0.6944,0.6504,0.6846,25516964.0,82896.0,13302926.0,4.999999999999994,45.51401869158878,0.7535457075949512,0.6226642924050487,0.007212547934913549,0.013301560796493432,-0.006089012861579883,0.04400000000000004,0.07929285714285715,7839131690.089998,-0.0050000000000000044,-6.552006552006562,-44.45479962721344,55.54520037278656,51.10282696489594,0.6750666666666666,0.6782546554806641,0.6856428571428571,0.6811927770907306,0.688105,0.6821174938182629,229826.0,10505677.666666666,997012.0,20410759.0
2024-01-17,0.6901,0.6989,0.6683,0.6773,22970125.0,64719.0,11282330.0,0.6840666666666667,0.6861714285714285,0.68541,0.680788663870166,0.681927187113536,0.6823637534430678,52.00752823086575,0.746675802258008,0.6241441977419919,0.006121696028777324,0.010893908144630786,-0.004772212115853462,0.03059999999999996,0.06792142857142858,7843241448.089998,0.055300000000000016,2.917489743200119,-48.125585754451734,51.87441424554827,55.20697312378792,-1.8548036516446937,0.6846,0.7068,0.6641,0.6903,27079883.0,86381.0,13410037.0,0.8326029798422494,46.03850425768234,0.7468842002688929,0.624575799731107,0.007228562681997008,0.01208696117359415,-0.004858398491597141,0.04269999999999996,0.07825714285714287,7866211573.089998,0.04180000000000006,-5.838221252216602,-41.79869524697111,58.20130475302889,51.289220254737494,0.6754666666666665,0.684277327740332,0.6918571428571428,0.6834695828180479,0.68573,0.6828967801212855,233423.0,11693686.666666666,909669.0,18704449.0
2024-01-18,0.6774,0.6793,0.6066,0.6191,41366719.0,110651.0,19071776.0,0.6622333333333332,0.6710285714285715,0.682015,0.649944331935083,0.6662203903351519,0.6763386340675375,38.57813834329633,0.7500600090980918,0.6139699909019083,0.0005419948500009486,0.008823525485704819,-0.00828153063570387,0.07269999999999999,0.06684285714285713,7801874729.089998,-0.06269999999999998,-14.736262222834318,-75.39831302717901,24.601686972820985,44.89246865713273,-8.606436374372604,0.6901,0.6989,0.6683,0.6773,22970125.0,64719.0,11282330.0,-1.8548036516446937,52.00752823086575,0.746675802258008,0.6241441977419919,0.006121696028777324,0.010893908144630786,-0.004772212115853462,0.03059999999999996,0.06792142857142858,7843241448.089998,0.055300000000000016,2.917489743200119,-48.125585754451734,51.87441424554827,55.20697312378792,0.6840666666666667,0.680788663870166,0.6861714285714285,0.681927187113536,0.68541,0.6823637534430678,233996.0,12665097.666666666,786260.0,16299331.0
2024-01-19,0.6192,0.6345,0.581,0.6179,26546443.0,85809.0,12942629.0,0.6381,0.6614000000000001,0.67842,0.6339221659675416,0.654140292751364,0.6707730498706291,41.722465943200184,0.7520974363803492,0.6047425636196508,-0.003931468977815267,0.006272526593000802,-0.010203995570816068,0.05349999999999999,0.0648,7775328286.089998,-0.028900000000000037,-10.397331786542917,-75.96063730084349,24.039362699156516,33.505154639175274,-0.2099483204134315,0.6774,0.6793,0.6066,0.6191,41366719.0,110651.0,19071776.0,-8.606436374372604,38.57813834329633,0.7500600090980918,0.6139699909019083,0.0005419948500009486,0.008823525485704819,-0.00828153063570387,0.07269999999999999,0.06684285714285713,7801874729.089998,-0.06269999999999998,-14.736262222834318,-75.39831302717901,24.601686972820985,44.89246865713273,0.6622333333333332,0.649944331935083,0.6710285714285715,0.6662203903351519,0.682015,0.6763386340675375,261751.0,14588047.666666666,664362.0,13803453.0
2024-01-20,0.6179,0.6191,0.5969,0.6124,13475021.0,37964.0,6130348.0,0.6164666666666666,0.6504428571428571,0.6754149999999999,0.6231610829837708,0.643705219563523,0.6652137117877122,45.45911949685535,0.7547911537835833,0.5960388462164165,-0.007830262928636311,0.0034519686886733797,-0.011282231617309691,0.022199999999999998,0.06130714285714286,7761853265.089998,-0.1046999999999999,-5.566692367000758,-78.53795688847232,21.462043111527674,23.367697594501738,-0.8901116685547741,0.6192,0.6345,0.581,0.6179,26546443.0,85809.0,12942629.0,-0.2099483204134315,41.722465943200184,0.7520974363803492,0.6047425636196508,-0.003931468977815267,0.006272526593000802,-0.010203995570816068,0.05349999999999999,0.0648,7775328286.089998,-0.028900000000000037,-10.397331786542917,-75.96063730084349,24.039362699156516,33.505154639175274,0.6381,0.6339221659675416,0.6614000000000001,0.654140292751364,0.67842,0.6707730498706291,261179.0,14432245.0,577386.0,12603400.714285715
2024-01-21,0.6123,0.6191,0.5913,0.5933,10576850.0,31881.0,4895803.0,0.6078666666666667,0.6421285714285715,0.66845,0.6082305414918854,0.6311039146726423,0.6583647868555491,46.32145603691362,0.7510782097871718,0.5858217902128282,-0.012319286531944806,0.00029771764454974243,-0.01261700417649455,0.027799999999999936,0.05951428571428569,7751276415.089998,-0.13179999999999992,-4.614147909967836,-87.48828491096529,12.5117150890347,19.337706966572977,-3.103054058468056,0.6179,0.6191,0.5969,0.6124,13475021.0,37964.0,6130348.0,-0.8901116685547741,45.45911949685535,0.7547911537835833,0.5960388462164165,-0.007830262928636311,0.0034519686886733797,-0.011282231617309691,0.022199999999999998,0.06130714285714286,7761853265.089998,-0.1046999999999999,-5.566692367000758,-78.53795688847232,21.462043111527674,23.367697594501738,0.6164666666666666,0.6231610829837708,0.6504428571428571,0.643705219563523,0.6754149999999999,0.6652137117877122,234424.0,12714917.666666666,532566.0,12072591.857142856
2024-01-22,0.5933,0.5982,0.5502,0.5599,34151490.0,92518.0,16884889.0,0.5885333333333332,0.6243142857142858,0.6597899999999999,0.5840652707459426,0.6133029360044817,0.6489871881074016,33.24168270552654,0.7498587667110149,0.5697212332889848,-0.018360324551266904,-0.003433890794613587,-0.014926433756653317,0.04799999999999993,0.054592857142857124,7717124925.089998,-0.12540000000000007,-17.879143443825175,-95.77893820713666,4.221061792863329,12.731606664475246,-5.6295297488623115,0.6123,0.6191,0.5913,0.5933,10576850.0,31881.0,4895803.0,-3.103054058468056,46.32145603691362,0.7510782097871718,0.5858217902128282,-0.012319286531944806,0.00029771764454974243,-0.01261700417649455,0.027799999999999936,0.05951428571428569,7751276415.089998,-0.13179999999999992,-4.614147909967836,-87.48828491096529,12.5117150890347,19.337706966572977,0.6078666666666667,0.6082305414918854,0.6421285714285715,0.6311039146726423,0.66845,0.6583647868555491,155654.0,7989593.333333333,500301.0,11576549.857142856
2024-01-23,0.5601,0.5744,0.525,0.5706,34015362.0,96667.0,16739888.0,0.5745999999999999,0.6072142857142857,0.655415,0.5773326353729713,0.6026272020033613,0.6415217416209824,38.77430760164997,0.7539335053415749,0.5568964946584251,-0.0220305358250803,-0.00715321980070693,-0.01487731602437337,0.0494,0.05339285714285713,7751140287.089998,-0.11850000000000005,-11.781076066790364,-82.11764705882354,17.88235294117646,11.53837660769151,1.874665238350286,0.5933,0.5982,0.5502,0.5599,34151490.0,92518.0,16884889.0,-5.6295297488623115,33.24168270552654,0.7498587667110149,0.5697212332889848,-0.018360324551266904,-0.003433890794613587,-0.014926433756653317,0.04799999999999993,0.054592857142857124,7717124925.089998,-0.12540000000000007,-17.879143443825175,-95.77893820713666,4.221061792863329,12.731606664475246,0.5885333333333332,0.5840652707459426,0.6243142857142858,0.6133029360044817,0.6597899999999999,0.6489871881074016,162363.0,9303680.0,509923.0,12088258.857142856
2024-01-24,0.5707,0.6018,0.5586,0.6008,25330695.0,71745.0,12489360.0,0.5770999999999998,0.5962857142857143,0.6491499999999999,0.5890663176864857,0.602170401502521,0.6376434805142221,30.571333110591397,0.7446315275603826,0.5536684724396171,-0.022245880431913223,-0.01017175192694819,-0.012074128504965033,0.043200000000000016,0.04879285714285713,7776470982.089998,-0.05069999999999997,-16.218100683307767,-70.27450980392157,29.725490196078425,17.27630164337275,5.274224636411427,0.5601,0.5744,0.525,0.5706,34015362.0,96667.0,16739888.0,1.874665238350286,38.77430760164997,0.7539335053415749,0.5568964946584251,-0.0220305358250803,-0.00715321980070693,-0.01487731602437337,0.0494,0.05339285714285713,7751140287.089998,-0.11850000000000005,-11.781076066790364,-82.11764705882354,17.88235294117646,11.53837660769151,0.5745999999999999,0.5773326353729713,0.6072142857142857,0.6026272020033613,0.655415,0.6415217416209824,221066.0,12840193.333333334,520209.0,12563951.857142856
2024-01-25,0.6008,0.6024,0.5662,0.5797,20699582.0,60994.0,9618477.0,0.5837,0.5906571428571429,0.6436550000000001,0.5843831588432429,0.5965528011268907,0.632125053798582,26.728553137003857,0.7419431151459741,0.5453668848540261,-0.023844274292743384,-0.01290625640010723,-0.010938017892636154,0.03620000000000001,0.04544285714285713,7755771400.089998,-0.1049,-20.05240656461178,-73.45948568655993,26.540514313440074,24.716119150231666,-3.511984021304928,0.5707,0.6018,0.5586,0.6008,25330695.0,71745.0,12489360.0,5.274224636411427,30.571333110591397,0.7446315275603826,0.5536684724396171,-0.022245880431913223,-0.01017175192694819,-0.012074128504965033,0.043200000000000016,0.04879285714285713,7776470982.089998,-0.05069999999999997,-16.218100683307767,-70.27450980392157,29.725490196078425,17.27630164337275,0.5770999999999998,0.5890663176864857,0.5962857142857143,0.602170401502521,0.6491499999999999,0.6376434805142221,260930.0,15371379.0,527235.0,12736384.714285715
2024-01-26,0.5793,0.6193,0.5737,0.61,17607077.0,55249.0,9626158.0,0.5968333333333332,0.5895285714285715,0.64173,0.5971915794216214,0.599914600845168,0.6300179058177646,37.570155166721705,0.7411204602009077,0.5423395397990923,-0.02240775353649649,-0.014806555827385083,-0.0076011977091114055,0.045599999999999974,0.043049999999999984,7773378477.089998,-0.08030000000000004,-10.987888515978405,-53.24532453245325,46.75467546754675,34.34022665902176,5.299499395822536,0.6008,0.6024,0.5662,0.5797,20699582.0,60994.0,9618477.0,-3.511984021304928,26.728553137003857,0.7419431151459741,0.5453668848540261,-0.023844274292743384,-0.01290625640010723,-0.010938017892636154,0.03620000000000001,0.04544285714285713,7755771400.089998,-0.1049,-20.05240656461178,-73.45948568655993,26.540514313440074,24.716119150231666,0.5837,0.5843831588432429,0.5906571428571429,0.5965528011268907,0.6436550000000001,0.632125053798582,229406.0,12949241.666666666,477578.0,11385913.42857143
2024-01-27,0.6101,0.6244,0.6051,0.6235,11834264.0,38971.0,5894738.0,0.6043999999999999,0.5911142857142858,0.641805,0.6103457897108107,0.605810950633876,0.6293971528827395,39.50735764555344,0.7411350182538825,0.5424749817461174,-0.019949992219932766,-0.015835243105894622,-0.004114749114038144,0.019299999999999984,0.04129999999999999,7785212741.089998,-0.05379999999999996,-9.51966332897982,-45.81958195819579,54.18041804180421,42.491869274263685,2.196361252253742,0.5793,0.6193,0.5737,0.61,17607077.0,55249.0,9626158.0,5.299499395822536,37.570155166721705,0.7411204602009077,0.5423395397990923,-0.02240775353649649,-0.014806555827385083,-0.0076011977091114055,0.045599999999999974,0.043049999999999984,7773378477.089998,-0.08030000000000004,-10.987888515978405,-53.24532453245325,46.75467546754675,34.34022665902176,0.5968333333333332,0.5971915794216214,0.5895285714285715,0.599914600845168,0.64173,0.6300179058177646,187988.0,10577998.333333334,447018.0,10912131.857142856
2024-01-28,0.6235,0.633,0.5936,0.602,15816111.0,55703.0,8043250.0,0.6118333333333332,0.5923571428571428,0.637815,0.6061728948554053,0.604858212975407,0.6267879002272405,41.65261382799327,0.7367908987143666,0.5388391012856334,-0.0195121451232525,-0.016570623509366198,-0.002941521613886302,0.03939999999999999,0.041042857142857124,7769396630.089998,-0.017100000000000004,-7.597851112816578,-57.64576457645766,42.35423542354234,47.76310964429778,-3.4482758620689773,0.6101,0.6244,0.6051,0.6235,11834264.0,38971.0,5894738.0,2.196361252253742,39.50735764555344,0.7411350182538825,0.5424749817461174,-0.019949992219932766,-0.015835243105894622,-0.004114749114038144,0.019299999999999984,0.04129999999999999,7785212741.089998,-0.05379999999999996,-9.51966332897982,-45.81958195819579,54.18041804180421,42.491869274263685,0.6043999999999999,0.6103457897108107,0.5911142857142858,0.605810950633876,0.641805,0.6293971528827395,155214.0,8379791.0,448025.0,10878473.285714285
2024-01-29,0.6023,0.632,0.5917,0.6281,18268477.0,57378.0,9430986.0,0.6178666666666667,0.6021000000000001,0.63688,0.6171364474277026,0.6106686597315553,0.6269128621103605,40.24179620034543,0.7358518216144624,0.5379081783855376,-0.0168646906159019,-0.01662943693067334,-0.00023525368522855916,0.0403,0.04077857142857141,7787665107.089998,0.010199999999999987,-8.252994449313466,-43.2893289328933,56.71067106710671,51.081774844151106,4.283579611489299,0.6235,0.633,0.5936,0.602,15816111.0,55703.0,8043250.0,-3.4482758620689773,41.65261382799327,0.7367908987143666,0.5388391012856334,-0.0195121451232525,-0.016570623509366198,-0.002941521613886302,0.03939999999999999,0.041042857142857124,7769396630.089998,-0.017100000000000004,-7.597851112816578,-57.64576457645766,42.35423542354234,47.76310964429778,0.6118333333333332,0.6061728948554053,0.5923571428571428,0.604858212975407,0.637815,0.6267879002272405,149923.0,7854715.333333333,471847.0,11328108.57142857
2024-01-30,0.6281,0.641,0.5947,0.5997,25184227.0,74206.0,12721191.0,0.6099333333333332,0.6062571428571429,0.6310100000000001,0.6084182237138513,0.6079264947986665,0.6243211609569927,35.49007046764895,0.7236737588840804,0.5383462411159198,-0.016863810980616845,-0.016676311740662045,-0.00018749923995479978,0.04630000000000001,0.04103571428571427,7762480880.089998,-0.012700000000000045,-13.124728378965667,-57.04427832087406,42.95572167912594,47.34020938992501,-4.521572997930263,0.6023,0.632,0.5917,0.6281,18268477.0,57378.0,9430986.0,4.283579611489299,40.24179620034543,0.7358518216144624,0.5379081783855376,-0.0168646906159019,-0.01662943693067334,-0.00023525368522855916,0.0403,0.04077857142857141,7787665107.089998,0.010199999999999987,-8.252994449313466,-43.2893289328933,56.71067106710671,51.081774844151106,0.6178666666666667,0.6171364474277026,0.6021000000000001,0.6106686597315553,0.63688,0.6269128621103605,152052.0,7789658.0,436707.0,10263265.285714285
2024-01-31,0.5997,0.6031,0.5629,0.5665,28237735.0,81866.0,14258280.0,0.5981,0.6013571428571429,0.62308,0.5874591118569257,0.5975698710989998,0.6188143837229935,33.33333333333334,0.7087195530851959,0.5374404469148041,-0.019319374673990586,-0.01720492432732775,-0.002114450346662834,0.040200000000000014,0.04172142857142856,7734243145.089998,-0.026800000000000046,-16.359072789015205,-73.10434219053792,26.895657809462076,42.18735018523159,-5.536101384025347,0.6281,0.641,0.5947,0.5997,25184227.0,74206.0,12721191.0,-4.521572997930263,35.49007046764895,0.7236737588840804,0.5383462411159198,-0.016863810980616845,-0.016676311740662045,-0.00018749923995479978,0.04630000000000001,0.04103571428571427,7762480880.089998,-0.012700000000000045,-13.124728378965667,-57.04427832087406,42.95572167912594,47.34020938992501,0.6099333333333332,0.6084182237138513,0.6062571428571429,0.6079264947986665,0.6310100000000001,0.6243211609569927,187287.0,10065142.333333334,414246.0,9689165.714285715
2024-02-01,0.566,0.5763,0.5386,0.5418,29989447.0,83508.0,14632991.0,0.5693333333333332,0.5959428571428571,0.6159049999999999,0.5646295559284629,0.5836274033242499,0.6114796805112798,37.06925393108063,0.7036158041115523,0.5281941958884475,-0.022993455918952965,-0.018362630645652796,-0.004630825273300169,0.03770000000000007,0.03922142857142857,7704253698.089998,-0.018100000000000005,-12.48586658052011,-85.5172413793104,14.482758620689593,28.11137936975922,-4.275618374558304,0.5997,0.6031,0.5629,0.5665,28237735.0,81866.0,14258280.0,-5.536101384025347,33.33333333333334,0.7087195530851959,0.5374404469148041,-0.019319374673990586,-0.01720492432732775,-0.002114450346662834,0.040200000000000014,0.04172142857142856,7734243145.089998,-0.026800000000000046,-16.359072789015205,-73.10434219053792,26.895657809462076,42.18735018523159,0.5981,0.5874591118569257,0.6013571428571429,0.5975698710989998,0.62308,0.6188143837229935,213450.0,12136819.0,424367.0,9941868.57142857
2024-02-02,0.5419,0.5798,0.5389,0.5694,31267144.0,75307.0,15749776.0,0.5592333333333332,0.5901428571428572,0.60992,0.5670147779642314,0.5800705524931874,0.6074720918911579,42.545342760528754,0.6928041067870977,0.5270358932129023,-0.023408266513508025,-0.01937175781922384,-0.004036508694284183,0.040899999999999936,0.03832142857142856,7735520842.089998,-0.0011999999999999789,-7.849166531801255,-61.724137931034484,38.275862068965516,26.55142616637241,5.074737036353564,0.566,0.5763,0.5386,0.5418,29989447.0,83508.0,14632991.0,-4.275618374558304,37.06925393108063,0.7036158041115523,0.5281941958884475,-0.022993455918952965,-0.018362630645652796,-0.004630825273300169,0.03770000000000007,0.03922142857142857,7704253698.089998,-0.018100000000000005,-12.48586658052011,-85.5172413793104,14.482758620689593,28.11137936975922,0.5693333333333332,0.5646295559284629,0.5959428571428571,0.5836274033242499,0.6159049999999999,0.6114796805112798,239580.0,13870820.666666666,446881.0,10658227.714285715
2024-02-03,0.5694,0.5742,0.5531,0.5617,13062803.0,33785.0,6028435.0,0.5576333333333333,0.5813142857142858,0.60543,0.5643573889821156,0.5754779143698906,0.6031128450443809,42.25954198473282,0.6885589448608871,0.522301055139113,-0.02408074471136734,-0.020313555197652544,-0.003767189513714797,0.021100000000000008,0.038242857142857134,7722458039.089998,-0.039100000000000024,-8.278902677988253,-68.36206896551728,31.63793103448272,28.132183908045956,-1.3523006673691675,0.5419,0.5798,0.5389,0.5694,31267144.0,75307.0,15749776.0,5.074737036353564,42.545342760528754,0.6928041067870977,0.5270358932129023,-0.023408266513508025,-0.01937175781922384,-0.004036508694284183,0.040899999999999936,0.03832142857142856,7735520842.089998,-0.0011999999999999789,-7.849166531801255,-61.724137931034484,38.275862068965516,26.55142616637241,0.5592333333333332,0.5670147779642314,0.5901428571428572,0.5800705524931874,0.60992,0.6074720918911579,240681.0,14880349.0,466939.0,11533030.285714285
2024-02-04,0.5616,0.5622,0.5206,0.5245,20453555.0,54641.0,9089918.0,0.5518666666666666,0.5702428571428572,0.597425,0.5444286944910578,0.5627334357774179,0.5956259074211065,40.046296296296305,0.6792781129845604,0.5155718870154395,-0.027300712020671636,-0.021710986562256365,-0.005589725458415271,0.04160000000000008,0.03922857142857143,7702004484.089998,-0.05520000000000003,-11.596157087476833,-96.76079734219269,3.239202657807319,24.384331920418532,-6.60612535612536,0.5694,0.5742,0.5531,0.5617,13062803.0,33785.0,6028435.0,-1.3523006673691675,42.25954198473282,0.6885589448608871,0.522301055139113,-0.02408074471136734,-0.020313555197652544,-0.003767189513714797,0.021100000000000008,0.038242857142857134,7722458039.089998,-0.039100000000000024,-8.278902677988253,-68.36206896551728,31.63793103448272,28.132183908045956,0.5576333333333333,0.5643573889821156,0.5813142857142858,0.5754779143698906,0.60543,0.6031128450443809,192600.0,12137067.333333334,461753.0,11552129.857142856
2024-02-05,0.5244,0.5431,0.5086,0.5272,22066436.0,58099.0,10540269.0,0.5378,0.5558285714285714,0.5892700000000001,0.5358143472455289,0.5538500768330634,0.5891091543333822,44.80787551603685,0.6643844838510553,0.5141555161489448,-0.029296974590403924,-0.023228184167885878,-0.006068790422518046,0.034499999999999975,0.038264285714285716,7724070920.089998,-0.08279999999999998,-5.840328630112513,-85.95166163141997,14.048338368580026,16.308490686956702,0.5339435545385249,0.5616,0.5622,0.5206,0.5245,20453555.0,54641.0,9089918.0,-6.60612535612536,40.046296296296305,0.6792781129845604,0.5155718870154395,-0.027300712020671636,-0.021710986562256365,-0.005589725458415271,0.04160000000000008,0.03922857142857143,7702004484.089998,-0.05520000000000003,-11.596157087476833,-96.76079734219269,3.239202657807319,24.384331920418532,0.5518666666666666,0.5444286944910578,0.5702428571428572,0.5627334357774179,0.597425,0.5956259074211065,163733.0,10289376.333333334,460691.0,11701653.857142856
2024-02-06,0.527,0.5421,0.521,0.5288,17981873.0,46310.0,8884406.0,0.5268333333333333,0.5457,0.5818450000000001,0.5323071736227645,0.5475875576247976,0.5833654253492505,43.165467625899296,0.6492871537709387,0.5144028462290614,-0.03039949398731212,-0.024662446131771126,-0.005737047855540994,0.021100000000000008,0.036242857142857146,7742052793.089998,-0.0947,-7.3256221521205696,-84.74320241691842,15.256797583081571,10.848112869822986,0.341555977229606,0.5244,0.5431,0.5086,0.5272,22066436.0,58099.0,10540269.0,0.5339435545385249,44.80787551603685,0.6643844838510553,0.5141555161489448,-0.029296974590403924,-0.023228184167885878,-0.006068790422518046,0.034499999999999975,0.038264285714285716,7724070920.089998,-0.08279999999999998,-5.840328630112513,-85.95166163141997,14.048338368580026,16.308490686956702,0.5378,0.5358143472455289,0.5558285714285714,0.5538500768330634,0.5892700000000001,0.5891091543333822,146525.0,8552874.0,461412.0,11860122.857142856
2024-02-07,0.5289,0.5643,0.5243,0.5585,18905161.0,51318.0,9933678.0,0.5381666666666666,0.5445571428571429,0.578815,0.5454035868113822,0.5503156682185982,0.5809972896017029,43.07238781526368,0.6446354023720667,0.5129945976279332,-0.028547627486458893,-0.02543948240270868,-0.0031081450837502148,0.040000000000000036,0.03601428571428572,7760957954.089998,-0.04349999999999998,-7.040612516644473,-62.31117824773417,37.68882175226583,22.33131923464249,5.596521081489877,0.527,0.5421,0.521,0.5288,17981873.0,46310.0,8884406.0,0.341555977229606,43.165467625899296,0.6492871537709387,0.5144028462290614,-0.03039949398731212,-0.024662446131771126,-0.005737047855540994,0.021100000000000008,0.036242857142857146,7742052793.089998,-0.0947,-7.3256221521205696,-84.74320241691842,15.256797583081571,10.848112869822986,0.5268333333333333,0.5323071736227645,0.5457,0.5475875576247976,0.5818450000000001,0.5833654253492505,159050.0,9504864.333333334,433516.0,11312010.714285715
2024-02-08,0.5586,0.5643,0.5469,0.559,16044010.0,39468.0,7747742.0,0.5487666666666667,0.5470142857142858,0.57587,0.5522017934056911,0.5524867511639487,0.578902309639636,46.364594309799806,0.6395634797951935,0.5121765202048065,-0.026731519800759607,-0.025697889882318865,-0.0010336299184407413,0.01739999999999997,0.034671428571428575,7777001964.089998,-0.06909999999999994,-3.5708124892185555,-61.9335347432024,38.06646525679759,30.337361530715015,0.07160759040459487,0.5289,0.5643,0.5243,0.5585,18905161.0,51318.0,9933678.0,5.596521081489877,43.07238781526368,0.6446354023720667,0.5129945976279332,-0.028547627486458893,-0.02543948240270868,-0.0031081450837502148,0.040000000000000036,0.03601428571428572,7760957954.089998,-0.04349999999999998,-7.040612516644473,-62.31117824773417,37.68882175226583,22.33131923464249,0.5381666666666666,0.5454035868113822,0.5445571428571429,0.5503156682185982,0.578815,0.5809972896017029,155727.0,9786117.666666666,402968.0,10694210.42857143
2024-02-09,0.5592,0.6181,0.5567,0.6083,43339745.0,115063.0,22575710.0,0.5752666666666666,0.5525714285714286,0.5756650000000001,0.5802508967028455,0.5664400633729615,0.5817020896739563,49.72011853803095,0.6388880895530363,0.5124419104469639,-0.021071247171784102,-0.024772561340211916,0.003701314168427814,0.06140000000000001,0.035800000000000005,7820341709.089998,0.008599999999999941,-0.2786885245901649,-24.697885196374678,75.30211480362532,50.352467270896256,8.780400572246052,0.5586,0.5643,0.5469,0.559,16044010.0,39468.0,7747742.0,0.07160759040459487,46.364594309799806,0.6395634797951935,0.5121765202048065,-0.026731519800759607,-0.025697889882318865,-0.0010336299184407413,0.01739999999999997,0.034671428571428575,7777001964.089998,-0.06909999999999994,-3.5708124892185555,-61.9335347432024,38.06646525679759,30.337361530715015,0.5487666666666667,0.5522017934056911,0.5470142857142858,0.5524867511639487,0.57587,0.578902309639636,137096.0,8855275.333333334,358928.0,9710603.42857143
2024-02-10,0.6084,0.6348,0.6003,0.6276,29077526.0,73485.0,15152899.0,0.5982999999999999,0.5619857142857143,0.57738,0.6039254483514227,0.5817300475297211,0.5860733192288177,50.662358642972535,0.6443661446789339,0.5103938553210661,-0.014856831326611974,-0.02278941533749193,0.007932584010879956,0.034500000000000086,0.0368857142857143,7849419235.089998,0.06110000000000004,0.6575781876503539,-10.12084592145013,89.87915407854987,67.74924471299094,3.155818540433924,0.5592,0.6181,0.5567,0.6083,43339745.0,115063.0,22575710.0,8.780400572246052,49.72011853803095,0.6388880895530363,0.5124419104469639,-0.021071247171784102,-0.024772561340211916,0.003701314168427814,0.06140000000000001,0.035800000000000005,7820341709.089998,0.008599999999999941,-0.2786885245901649,-24.697885196374678,75.30211480362532,50.352467270896256,0.5752666666666666,0.5802508967028455,0.5525714285714286,0.5664400633729615,0.5756650000000001,0.5817020896739563,205849.0,13419043.333333334,398684.0,10685736.857142856
2024-02-11,0.6281,0.6487,0.622,0.6313,25167220.0,74614.0,12441827.0,0.6223999999999998,0.5772428571428572,0.5809500000000001,0.6176127241757113,0.5941225356472908,0.5903806221594065,55.02228316763798,0.651527840565911,0.5103721594340892,-0.009523521689208114,-0.02013623660783517,0.010612714918627055,0.026700000000000057,0.03597857142857145,7874586455.089998,0.08950000000000002,4.867109634551503,-12.41970021413282,87.58029978586718,84.2538562226808,0.5094730138512945,0.6084,0.6348,0.6003,0.6276,29077526.0,73485.0,15152899.0,3.155818540433924,50.662358642972535,0.6443661446789339,0.5103938553210661,-0.014856831326611974,-0.02278941533749193,0.007932584010879956,0.034500000000000086,0.0368857142857143,7849419235.089998,0.06110000000000004,0.6575781876503539,-10.12084592145013,89.87915407854987,67.74924471299094,0.5982999999999999,0.6039254483514227,0.5619857142857143,0.5817300475297211,0.57738,0.5860733192288177,228016.0,15158783.666666666,438384.0,11989231.714285715
2024-02-12,0.6316,0.6737,0.622,0.6675,32903368.0,92351.0,16142397.0,0.6421333333333332,0.5972857142857143,0.585795,0.6425563620878556,0.612466901735468,0.5977253248108916,56.5275016567263,0.666025128872807,0.505564871127193,-0.0023487232930745616,-0.01657873394488305,0.014230010651808487,0.05169999999999997,0.03679285714285716,7907489823.089998,0.09809999999999997,6.272886483044093,-3.7552998182919364,96.24470018170807,91.23471801537505,5.683977200759963,0.6281,0.6487,0.622,0.6313,25167220.0,74614.0,12441827.0,0.5094730138512945,55.02228316763798,0.651527840565911,0.5103721594340892,-0.009523521689208114,-0.02013623660783517,0.010612714918627055,0.026700000000000057,0.03597857142857145,7874586455.089998,0.08950000000000002,4.867109634551503,-12.41970021413282,87.58029978586718,84.2538562226808,0.6223999999999998,0.6176127241757113,0.5772428571428572,0.5941225356472908,0.5809500000000001,0.5903806221594065,263162.0,16723478.666666666,458357.0,12468075.857142856
2024-02-13,0.6675,0.6874,0.6492,0.6673,29895835.0,105441.0,14877881.0,0.6553666666666665,0.6170714285714285,0.5891200000000001,0.6549281810439278,0.626175176301601,0.6043514843527114,62.35380116959064,0.6771055873364911,0.5011344126635091,0.003283369163076477,-0.012606313323291143,0.015889682486367622,0.03820000000000001,0.036214285714285734,7877593988.089998,0.10560000000000003,11.272302818075698,-11.241610738255039,88.75838926174497,90.86112974310674,-0.0299625468164761,0.6316,0.6737,0.622,0.6675,32903368.0,92351.0,16142397.0,5.683977200759963,56.5275016567263,0.666025128872807,0.505564871127193,-0.0023487232930745616,-0.01657873394488305,0.014230010651808487,0.05169999999999997,0.03679285714285716,7907489823.089998,0.09809999999999997,6.272886483044093,-3.7552998182919364,96.24470018170807,91.23471801537505,0.6421333333333332,0.6425563620878556,0.5972857142857143,0.612466901735468,0.585795,0.5977253248108916,240450.0,14579041.0,492609.0,13268379.857142856
2024-02-14,0.6672,0.6861,0.6521,0.6815,25862342.0,78932.0,12212543.0,0.6720999999999999,0.6346428571428572,0.59421,0.6682140905219639,0.6400063822262008,0.6116989620334056,72.58444619010211,0.6912169102259161,0.4972030897740839,0.00879132343313127,-0.00832678597200666,0.01711810940513793,0.03400000000000003,0.035771428571428586,7903456330.089998,0.15700000000000003,20.300088261253315,-3.299776286353477,96.70022371364652,93.90110438569987,2.1432853717026346,0.6675,0.6874,0.6492,0.6673,29895835.0,105441.0,14877881.0,-0.0299625468164761,62.35380116959064,0.6771055873364911,0.5011344126635091,0.003283369163076477,-0.012606313323291143,0.015889682486367622,0.03820000000000001,0.036214285714285734,7877593988.089998,0.10560000000000003,11.272302818075698,-11.241610738255039,88.75838926174497,90.86112974310674,0.6553666666666665,0.6549281810439278,0.6170714285714285,0.626175176301601,0.5891200000000001,0.6043514843527114,272406.0,14487368.333333334,551740.0,14124590.57142857
2024-02-15,0.6815,0.6881,0.6425,0.6536,28944745.0,91151.0,13073598.0,0.6674666666666665,0.6481571428571428,0.59639,0.660907045260982,0.6434047866696506,0.6156895370778431,71.6834755624515,0.696791214083664,0.49598878591633605,0.010780845172540188,-0.004505259743097291,0.015286104915637479,0.045600000000000085,0.036335714285714305,7874511585.089998,0.12639999999999996,20.63492063492063,-19.220055710306454,80.77994428969355,88.74618575502836,-4.093910491562735,0.6672,0.6861,0.6521,0.6815,25862342.0,78932.0,12212543.0,2.1432853717026346,72.58444619010211,0.6912169102259161,0.4972030897740839,0.00879132343313127,-0.00832678597200666,0.01711810940513793,0.03400000000000003,0.035771428571428586,7903456330.089998,0.15700000000000003,20.300088261253315,-3.299776286353477,96.70022371364652,93.90110438569987,0.6720999999999999,0.6682140905219639,0.6346428571428572,0.6400063822262008,0.59421,0.6116989620334056,276724.0,14410940.333333334,579354.0,14450142.714285715
2024-02-16,0.6536,0.7328,0.6481,0.7074,72685261.0,242117.0,37346949.0,0.6808333333333332,0.6623142857142856,0.600585,0.684153522630491,0.6594035900022379,0.6244238668799532,74.29577464788731,0.7121463831508306,0.48902361684916945,0.0165084665333588,-0.0003025144878060727,0.016810981021164875,0.0847,0.039464285714285736,7947196846.089998,0.17859999999999998,24.236037934668065,-11.329170383586076,88.67082961641393,88.71699920658466,8.231334149326816,0.6815,0.6881,0.6425,0.6536,28944745.0,91151.0,13073598.0,-4.093910491562735,71.6834755624515,0.696791214083664,0.49598878591633605,0.010780845172540188,-0.004505259743097291,0.015286104915637479,0.045600000000000085,0.036335714285714305,7874511585.089998,0.12639999999999996,20.63492063492063,-19.220055710306454,80.77994428969355,88.74618575502836,0.6674666666666665,0.660907045260982,0.6481571428571428,0.6434047866696506,0.59639,0.6156895370778431,275524.0,13388007.333333334,631037.0,15210979.285714285
2024-02-17,0.7075,0.7897,0.6869,0.7872,67818947.0,243043.0,34858284.0,0.7160666666666667,0.6851142857142857,0.609845,0.7356767613152455,0.6913526925016784,0.6399263557485291,81.66245436675091,0.7491866320453183,0.4705033679546816,0.027173600459545977,0.0051927085016643375,0.021980891957881638,0.1028,0.04530000000000002,8015015793.089998,0.22870000000000001,40.14598540145986,-0.8893632159373702,99.11063678406263,89.52047023005672,11.265017667844521,0.6536,0.7328,0.6481,0.7074,72685261.0,242117.0,37346949.0,8.231334149326816,74.29577464788731,0.7121463831508306,0.48902361684916945,0.0165084665333588,-0.0003025144878060727,0.016810981021164875,0.0847,0.039464285714285736,7947196846.089998,0.17859999999999998,24.236037934668065,-11.329170383586076,88.67082961641393,88.71699920658466,0.6808333333333332,0.684153522630491,0.6623142857142856,0.6594035900022379,0.600585,0.6244238668799532,412200.0,20877696.666666668,758091.0,17321156.285714287
2024-02-18,0.7871,0.8745,0.7817,0.8239,87443889.0,368875.0,44125227.0,0.7728333333333333,0.7126285714285715,0.6196349999999999,0.7797883806576227,0.7244895193762588,0.6574476552010501,92.0978627671541,0.7887166342854303,0.4505533657145696,0.038147439285367235,0.011783654658404918,0.026363784626962317,0.0928000000000001,0.04895714285714288,8102459682.089998,0.2648999999999999,57.08293612964728,-13.828915004099503,86.17108499590049,91.3175171321257,4.6753906746283755,0.7075,0.7897,0.6869,0.7872,67818947.0,243043.0,34858284.0,11.265017667844521,81.66245436675091,0.7491866320453183,0.4705033679546816,0.027173600459545977,0.0051927085016643375,0.021980891957881638,0.1028,0.04530000000000002,8015015793.089998,0.22870000000000001,40.14598540145986,-0.8893632159373702,99.11063678406263,89.52047023005672,0.7160666666666667,0.7356767613152455,0.6851142857142857,0.6913526925016784,0.609845,0.6399263557485291,576311.0,28426277.0,927649.0,20136211.285714287
2024-02-19,0.8239,0.9959,0.8239,0.9793,98145176.0,450423.0,50504013.0,0.8634666666666666,0.7571714285714286,0.6386149999999999,0.8795441903288113,0.7881921395321941,0.6881002594676167,94.4717686405666,0.8714702952507554,0.40575970474924444,0.058707028800921046,0.021168329486908145,0.0375386993140129,0.17200000000000004,0.05877857142857146,8200604858.089998,0.371,85.75493171471926,-3.495472731101297,96.5045272688987,93.92874968295395,18.861512319456246,0.7871,0.8745,0.7817,0.8239,87443889.0,368875.0,44125227.0,4.6753906746283755,92.0978627671541,0.7887166342854303,0.4505533657145696,0.038147439285367235,0.011783654658404918,0.026363784626962317,0.0928000000000001,0.04895714285714288,8102459682.089998,0.2648999999999999,57.08293612964728,-13.828915004099503,86.17108499590049,91.3175171321257,0.7728333333333333,0.7797883806576227,0.7126285714285715,0.7244895193762588,0.6196349999999999,0.6574476552010501,854035.0,38776820.0,1221910.0,24662411.285714287
2024-02-20,0.9793,1.097,0.87,1.0547,125671558.0,661406.0,63492469.0,0.9526333333333333,0.8125142857142856,0.663025,0.9671220951644056,0.8548191046491456,0.7230145204707008,95.17265074729428,0.9580938545871447,0.36795614541285526,0.08016075815013357,0.03296681521955323,0.04719394293058034,0.22699999999999998,0.07348571428571431,8326276416.089998,0.4270999999999999,99.45158850226927,-7.386066003143007,92.61393399685699,91.76318208721874,7.699377106096193,0.8239,0.9959,0.8239,0.9793,98145176.0,450423.0,50504013.0,18.861512319456246,94.4717686405666,0.8714702952507554,0.40575970474924444,0.058707028800921046,0.021168329486908145,0.0375386993140129,0.17200000000000004,0.05877857142857146,8200604858.089998,0.371,85.75493171471926,-3.495472731101297,96.5045272688987,93.92874968295395,0.8634666666666666,0.8795441903288113,0.7571714285714286,0.7881921395321941,0.6386149999999999,0.6881002594676167,1062341.0,43162508.0,1579982.0,29571213.57142857
2024-02-21,1.0546,1.163,0.9409,1.1455,101897604.0,589388.0,51893076.0,1.0598333333333332,0.8788,0.69321,1.0563110475822028,0.9274893284868593,0.7632512328068246,95.63121890547264,1.0525736709518667,0.33384632904813316,0.10329902749039843,0.04703325767372228,0.05626576981667615,0.22210000000000008,0.08649285714285718,8428174020.089998,0.5142,105.10295434198747,-2.8404479792241637,97.15955202077583,95.42600442884385,8.619381756116061,0.9793,1.097,0.87,1.0547,125671558.0,661406.0,63492469.0,7.699377106096193,95.17265074729428,0.9580938545871447,0.36795614541285526,0.08016075815013357,0.03296681521955323,0.04719394293058034,0.22699999999999998,0.07348571428571431,8326276416.089998,0.4270999999999999,99.45158850226927,-7.386066003143007,92.61393399685699,91.76318208721874,0.9526333333333333,0.9671220951644056,0.8125142857142856,0.8548191046491456,0.663025,0.7230145204707008,1480704.0,52707236.333333336,2135947.0,36516154.71428572
2024-02-22,1.1453,1.2098,1.0238,1.1053,112309686.3,652348.0,56569922.1,1.1018333333333332,0.9433285714285714,0.720005,1.0808055237911014,0.9719419963651443,0.7958273058728412,89.99853565675794,1.1183054656630098,0.3217045343369902,0.117043266688721,0.06103525947672203,0.05600800721199897,0.18599999999999994,0.09853571428571432,8315864333.789998,0.43779999999999997,97.72808586762072,-16.00061246363498,83.99938753636502,91.2576245179993,-3.4925347070636548,1.0546,1.163,0.9409,1.1455,101897604.0,589388.0,51893076.0,8.619381756116061,95.63121890547264,1.0525736709518667,0.33384632904813316,0.10329902749039843,0.04703325767372228,0.05626576981667615,0.22210000000000008,0.08649285714285718,8428174020.089998,0.5142,105.10295434198747,-2.8404479792241637,97.15955202077583,95.42600442884385,1.0598333333333332,1.0563110475822028,0.8788,0.9274893284868593,0.69321,0.7632512328068246,1701217.0,55296519.333333336,2646403.0,42184802.28571428
2024-02-23,1.1053,1.2353,1.0313,1.0581,100444560.8,522589.0,51509938.8,1.1029666666666664,0.9934285714285715,0.744825,1.0694527618955507,0.9934814972738583,0.8208056576944753,83.0346650998825,1.1629618694326653,0.32668813056733464,0.12271247669665208,0.07337070292070805,0.04934177377594404,0.20399999999999996,0.10872142857142861,8215419772.989998,0.39080000000000004,73.94377774124612,-27.90551181102362,72.09448818897638,84.41780924870575,-4.2703338460146485,1.1453,1.2098,1.0238,1.1053,112309686.3,652348.0,56569922.1,-3.4925347070636548,89.99853565675794,1.1183054656630098,0.3217045343369902,0.117043266688721,0.06103525947672203,0.05600800721199897,0.18599999999999994,0.09853571428571432,8315864333.789998,0.43779999999999997,97.72808586762072,-16.00061246363498,83.99938753636502,91.2576245179993,1.1018333333333332,1.0808055237911014,0.9433285714285714,0.9719419963651443,0.720005,0.7958273058728412,1903142.0,57318489.03333333,3207600.0,48398562.87142857
2024-02-24,1.0579,1.098,0.98,1.078,60038449.0,341905.0,30198632.0,1.0804666666666665,1.0349714285714284,0.7725,1.0737263809477753,1.0146111229553938,0.8453003569616682,83.04960375697095,1.202341331803165,0.3426586681968348,0.12734319705390118,0.08416520174734668,0.0431779953065545,0.1180000000000001,0.11468571428571431,8275458221.989998,0.3965000000000001,71.76545570427024,-25.648133050709276,74.35186694929072,76.81524755821073,1.8999905473107104,1.1053,1.2353,1.0313,1.0581,100444560.8,522589.0,51509938.8,-4.2703338460146485,83.0346650998825,1.1629618694326653,0.32668813056733464,0.12271247669665208,0.07337070292070805,0.04934177377594404,0.20399999999999996,0.10872142857142861,8215419772.989998,0.39080000000000004,73.94377774124612,-27.90551181102362,72.09448818897638,84.41780924870575,1.1029666666666664,1.0694527618955507,0.9934285714285715,0.9934814972738583,0.744825,0.8208056576944753,1764325.0,53324312.300000004,3488072.0,50421847.12857143
2024-02-25,1.078,1.1412,1.073,1.1037,50817861.0,324784.0,25127946.0,1.0799333333333332,1.074942857142857,0.801325,1.0887131904738876,1.0368833422165453,0.8699098467748426,83.57975547341485,1.2391499343720593,0.3635000656279405,0.13157019223916588,0.09364619984571051,0.03792399239345537,0.06820000000000004,0.11765000000000003,8326276082.989998,0.45009999999999994,74.82971645810233,-21.457687917821644,78.54231208217836,74.99622240681516,2.384044526901654,1.0579,1.098,0.98,1.078,60038449.0,341905.0,30198632.0,1.8999905473107104,83.04960375697095,1.202341331803165,0.3426586681968348,0.12734319705390118,0.08416520174734668,0.0431779953065545,0.1180000000000001,0.11468571428571431,8275458221.989998,0.3965000000000001,71.76545570427024,-25.648133050709276,74.35186694929072,76.81524755821073,1.0804666666666665,1.0737263809477753,1.0349714285714284,1.0146111229553938,0.7725,0.8453003569616682,1516842.0,46092830.96666667,3586934.0,49756182.557142854
2024-02-26,1.1036,1.1499,1.0509,1.1159,56107193.0,309265.0,27538668.0,1.0992,1.0944571428571428,0.8306799999999999,1.1023065952369437,1.056637506662409,0.8933374804153338,82.99970562260819,1.2702932108546086,0.39106678914539117,0.13435578456677588,0.1017881167899236,0.032567667776852285,0.09899999999999998,0.12102857142857146,8382383275.989998,0.40849999999999986,67.1760299625468,-20.141700404858327,79.85829959514167,77.58415954220358,1.1145342515404113,1.078,1.1412,1.073,1.1037,50817861.0,324784.0,25127946.0,2.384044526901654,83.57975547341485,1.2391499343720593,0.3635000656279405,0.13157019223916588,0.09364619984571051,0.03792399239345537,0.06820000000000004,0.11765000000000003,8326276082.989998,0.45009999999999994,74.82971645810233,-21.457687917821644,78.54231208217836,74.99622240681516,1.0799333333333332,1.0887131904738876,1.074942857142857,1.0368833422165453,0.801325,0.8699098467748426,1189278.0,35612172.26666667,3542843.0,47042285.27142857
2024-02-27,1.1157,1.1219,1.0567,1.0753,40726953.0,207283.0,19204362.0,1.0982999999999998,1.0974,0.8565200000000001,1.0888032976184718,1.0613031299968068,0.910667244185302,78.34120589052515,1.2894747957441968,0.42356520425580335,0.1317683622073047,0.10778416587339983,0.023984196333904875,0.06519999999999992,0.12295714285714286,8341656322.989998,0.2880999999999999,61.14191518057843,-26.9905533063428,73.0094466936572,77.13668612365909,-3.6210450838038892,1.1036,1.1499,1.0509,1.1159,56107193.0,309265.0,27538668.0,1.1145342515404113,82.99970562260819,1.2702932108546086,0.39106678914539117,0.13435578456677588,0.1017881167899236,0.032567667776852285,0.09899999999999998,0.12102857142857146,8382383275.989998,0.40849999999999986,67.1760299625468,-20.141700404858327,79.85829959514167,77.58415954220358,1.0992,1.1023065952369437,1.0944571428571428,1.056637506662409,0.8306799999999999,0.8933374804153338,975954.0,27621748.666666668,3401685.0,43761521.699999996
2024-02-28,1.0753,1.3811,1.0678,1.3484,130332043.9,892029.0,66511208.9,1.1798666666666664,1.1263857142857143,0.89599,1.218601648809236,1.133077347497605,0.9523560780724161,84.07070603862267,1.3577160472800371,0.43426395271996265,0.15002530067544229,0.11623239283380832,0.03379290784163397,0.3132999999999999,0.14290714285714287,8471988366.8899975,0.5245000000000001,97.85766691122524,-4.427294882209579,95.57270511779042,82.81348380219644,25.397563470659364,1.1157,1.1219,1.0567,1.0753,40726953.0,207283.0,19204362.0,-3.6210450838038892,78.34120589052515,1.2894747957441968,0.42356520425580335,0.1317683622073047,0.10778416587339983,0.023984196333904875,0.06519999999999992,0.12295714285714286,8341656322.989998,0.2880999999999999,61.14191518057843,-26.9905533063428,73.0094466936572,77.13668612365909,1.0982999999999998,1.0888032976184718,1.0974,1.0613031299968068,0.8565200000000001,0.910667244185302,841332.0,23956992.0,2947562.0,37434649.27142857
2024-02-29,1.3489,1.518,1.2848,1.4711,89854618.3,778012.0,45748664.2,1.2982666666666665,1.1786428571428573,0.9391299999999999,1.344850824404618,1.2175830106232037,1.0017602611131384,88.0763856544015,1.4466361341604967,0.4316238658395031,0.17240751399748222,0.1274674170665431,0.044940096930939116,0.23320000000000007,0.15630714285714284,8561842985.189998,0.4918000000000001,125.07649938800492,-5.39142430164386,94.60857569835613,87.73024250326792,9.059233449477357,1.0753,1.3811,1.0678,1.3484,130332043.9,892029.0,66511208.9,25.397563470659364,84.07070603862267,1.3577160472800371,0.43426395271996265,0.15002530067544229,0.11623239283380832,0.03379290784163397,0.3132999999999999,0.14290714285714287,8471988366.8899975,0.5245000000000001,97.85766691122524,-4.427294882209579,95.57270511779042,82.81348380219644,1.1798666666666664,1.218601648809236,1.1263857142857143,1.133077347497605,0.89599,0.9523560780724161,1408577.0,37751412.96666667,3250203.0,39522953.97142857
2024-03-01,1.4713,1.84,1.4709,1.724,123306920.8,921929.0,62463620.1,1.5145,1.2737714285714286,0.9939499999999999,1.5344254122023089,1.3441872579674028,1.0705449981499824,89.94185132798995,1.5890682262020728,0.398831773797927,0.2081530370959752,0.14360454107242954,0.06454849602354568,0.3691,0.17662142857142857,8685149905.989998,0.6693,143.709358213175,-10.059838695689887,89.94016130431012,93.37381404015224,17.17528716101406,1.3489,1.518,1.2848,1.4711,89854618.3,778012.0,45748664.2,9.059233449477357,88.0763856544015,1.4466361341604967,0.4316238658395031,0.17240751399748222,0.1274674170665431,0.044940096930939116,0.23320000000000007,0.15630714285714284,8561842985.189998,0.4918000000000001,125.07649938800492,-5.39142430164386,94.60857569835613,87.73024250326792,1.2982666666666665,1.344850824404618,1.1786428571428573,1.2175830106232037,0.9391299999999999,1.0017602611131384,1877324.0,43821411.699999996,3375867.0,37977059.98571429
2024-03-02,1.724,1.942,1.572,1.8011,90790158.6,691003.0,44835562.6,1.6654,1.3770714285714285,1.05244,1.6677627061011544,1.458415443475552,1.1401216649928412,89.92046617843926,1.7226860801825012,0.38219391981749884,0.23993710177888605,0.16287105321372086,0.07706604856516519,0.3699999999999999,0.19570714285714286,8775940064.589998,0.6556,128.79827235772353,-12.143411186762048,87.85658881323796,90.80177527196808,4.472157772621807,1.4713,1.84,1.4709,1.724,123306920.8,921929.0,62463620.1,17.17528716101406,89.94185132798995,1.5890682262020728,0.398831773797927,0.2081530370959752,0.14360454107242954,0.06454849602354568,0.3691,0.17662142857142857,8685149905.989998,0.6693,143.709358213175,-10.059838695689887,89.94016130431012,93.37381404015224,1.5145,1.5344254122023089,1.2737714285714286,1.3441872579674028,0.9939499999999999,1.0705449981499824,2591970.0,58241164.4,3775207.0,39541871.6
2024-03-03,1.8019,1.9716,1.6383,1.7702,73211732.7,639597.0,36762107.7,1.7651000000000001,1.4722857142857144,1.107575,1.718981353050577,1.5363615826066641,1.2001291254697135,87.42979194683966,1.824299249624644,0.3908507503753561,0.25963986354721924,0.18222481528042056,0.07741504826679868,0.33329999999999993,0.2128857142857143,8702728331.889997,0.6649,114.85617186551767,-17.548139757776426,82.45186024222359,86.74953678659057,-1.759254120650428,1.724,1.942,1.572,1.8011,90790158.6,691003.0,44835562.6,4.472157772621807,89.92046617843926,1.7226860801825012,0.38219391981749884,0.23993710177888605,0.16287105321372086,0.07706604856516519,0.3699999999999999,0.19570714285714286,8775940064.589998,0.6556,128.79827235772353,-12.143411186762048,87.85658881323796,90.80177527196808,1.6654,1.6677627061011544,1.3770714285714285,1.458415443475552,1.05244,1.1401216649928412,2390944.0,51015948.96666667,4124305.0,41632861.68571429
2024-03-04,1.7706,1.9163,1.697,1.725,76045947.0,581762.0,38039915.0,1.7654333333333332,1.5593000000000001,1.16046,1.7219906765252886,1.5835211869549979,1.2501168278059314,82.31215876592427,1.8962345547166135,0.4246854452833866,0.2685119434107597,0.1994822409064884,0.06902970250427129,0.21929999999999983,0.21626428571428566,8626682384.889997,0.6669,76.146226896763,-22.385620915032675,77.61437908496734,82.6409427134763,-2.5753981701118187,1.8019,1.9716,1.6383,1.7702,73211732.7,639597.0,36762107.7,-1.759254120650428,87.42979194683966,1.824299249624644,0.3908507503753561,0.25963986354721924,0.18222481528042056,0.07741504826679868,0.33329999999999993,0.2128857142857143,8702728331.889997,0.6649,114.85617186551767,-17.548139757776426,82.45186024222359,86.74953678659057,1.7651000000000001,1.718981353050577,1.4722857142857144,1.5363615826066641,1.107575,1.2001291254697135,2252529.0,48020430.13333333,4439118.0,43294884.78571428
2024-03-05,1.7253,1.9499,1.29,1.736,114500441.0,966290.0,56168521.0,1.7437333333333331,1.6536857142857142,1.213185,1.7289953382626444,1.6216408902162482,1.296391415633938,81.26663607159249,1.9555461017344804,0.4708238982655195,0.2732805308433255,0.2142418988938558,0.05903863194946968,0.6598999999999999,0.24718571428571426,8741182825.889997,0.6579999999999999,64.5965677443823,-22.858251673619876,77.14174832638014,79.06932921785703,0.620181997333793,1.7706,1.9163,1.697,1.725,76045947.0,581762.0,38039915.0,-2.5753981701118187,82.31215876592427,1.8962345547166135,0.4246854452833866,0.2685119434107597,0.1994822409064884,0.06902970250427129,0.21929999999999983,0.21626428571428566,8626682384.889997,0.6669,76.146226896763,-22.385620915032675,77.61437908496734,82.6409427134763,1.7654333333333332,1.7219906765252886,1.5593000000000001,1.5835211869549979,1.16046,1.2501168278059314,1912362.0,39879195.1,4711615.0,44795062.928571425
2024-03-06,1.736,2.478,1.6925,2.428,164464509.4,1647695.0,86713519.4,1.9629999999999999,1.8079142857142858,1.301905,2.0784976691313224,1.823230667662186,1.4041636617640392,87.92807712781689,2.1752458775019075,0.42856412249809284,0.32910457477660837,0.23721443407040632,0.09189014070620205,0.7855000000000003,0.2874285714285714,8905647335.289997,1.3243,111.95984286337844,-3.3377837116155042,96.6622162883845,83.80611456657734,39.86175115207373,1.7253,1.9499,1.29,1.736,114500441.0,966290.0,56168521.0,0.620181997333793,81.26663607159249,1.9555461017344804,0.4708238982655195,0.2732805308433255,0.2142418988938558,0.05903863194946968,0.6598999999999999,0.24718571428571426,8741182825.889997,0.6579999999999999,64.5965677443823,-22.858251673619876,77.14174832638014,79.06932921785703,1.7437333333333331,1.7289953382626444,1.6536857142857142,1.6216408902162482,1.213185,1.296391415633938,2187649.0,43656847.900000006,5470622.0,50075657.071428575
2024-03-07,2.429,2.86,2.4049,2.5759,139603799.7,1624316.0,70399123.7,2.2466333333333335,1.9657428571428572,1.39533,2.327198834565661,2.01139800074664,1.5157575987388925,90.88634341637012,2.3919561846851174,0.39870381531488275,0.38088917244768083,0.26594938174586125,0.11493979070181959,0.45509999999999984,0.30665,9045251134.989998,1.46,133.0498507192617,-15.111702127659576,84.88829787234042,86.23075416236837,6.04775627830383,1.736,2.478,1.6925,2.428,164464509.4,1647695.0,86713519.4,39.86175115207373,87.92807712781689,2.1752458775019075,0.42856412249809284,0.32910457477660837,0.23721443407040632,0.09189014070620205,0.7855000000000003,0.2874285714285714,8905647335.289997,1.3243,111.95984286337844,-3.3377837116155042,96.6622162883845,83.80611456657734,1.9629999999999999,2.0784976691313224,1.8079142857142858,1.823230667662186,1.301905,1.4041636617640392,3195747.0,60307318.46666667,6226288.0,52961701.428571425
2024-03-08,2.5759,2.9533,2.4498,2.7453,105816955.0,1090393.0,52391473.6,2.5830666666666664,2.111642857142857,1.4932349999999999,2.5362494172828303,2.19487350055998,1.632856875049474,93.92377382068105,2.615159281664983,0.37131071833501683,0.43063392364356146,0.2988862901254013,0.13174763351816016,0.5034999999999998,0.32804285714285714,9151068089.989998,1.67,159.45562801247516,-10.54071859321949,89.4592814067805,90.3365985225018,6.576342249310921,2.429,2.86,2.4049,2.5759,139603799.7,1624316.0,70399123.7,6.04775627830383,90.88634341637012,2.3919561846851174,0.39870381531488275,0.38088917244768083,0.26594938174586125,0.11493979070181959,0.45509999999999984,0.30665,9045251134.989998,1.46,133.0498507192617,-15.111702127659576,84.88829787234042,86.23075416236837,2.2466333333333335,2.327198834565661,1.9657428571428572,2.01139800074664,1.39533,1.5157575987388925,4238301.0,71093721.36666667,7072592.0,56483195.64285714
2024-03-09,2.7458,3.111,2.6915,3.0775,84660903.0,924424.0,43495967.0,2.7995666666666668,2.2939857142857143,1.605915,2.8068747086414154,2.415530125419985,1.7704419345685718,94.77361279054146,2.886280288789437,0.325549711210563,0.49120050735949605,0.3373491335722203,0.15385137378727576,0.4195000000000002,0.3495785714285714,9235728992.989998,1.7291,185.48237476808907,-1.6261346536575934,98.3738653463424,90.90714820848778,12.080268045742592,2.5759,2.9533,2.4498,2.7453,105816955.0,1090393.0,52391473.6,6.576342249310921,93.92377382068105,2.615159281664983,0.37131071833501683,0.43063392364356146,0.2988862901254013,0.13174763351816016,0.5034999999999998,0.32804285714285714,9151068089.989998,1.67,159.45562801247516,-10.54071859321949,89.4592814067805,90.3365985225018,2.5830666666666664,2.5362494172828303,2.111642857142857,2.19487350055998,1.4932349999999999,1.632856875049474,4362404.0,69834705.56666668,7241056.0,55044317.571428575
2024-03-10,3.0778,3.126,2.6688,2.7662,59123344.0,624648.0,28353447.0,2.8629999999999995,2.436271428571429,1.69526,2.786537354320708,2.503197594064989,1.8652760360382317,83.00575739527497,3.03931567616509,0.35120432383491007,0.5082221839761458,0.3715237436530054,0.13669844032314044,0.45719999999999983,0.37736428571428565,9176605648.989998,1.2951,150.62970009966477,-17.338923425377086,82.66107657462291,90.16474110924862,-10.124114627331208,2.7458,3.111,2.6915,3.0775,84660903.0,924424.0,43495967.0,12.080268045742592,94.77361279054146,2.886280288789437,0.325549711210563,0.49120050735949605,0.3373491335722203,0.15385137378727576,0.4195000000000002,0.3495785714285714,9235728992.989998,1.7291,185.48237476808907,-1.6261346536575934,98.3738653463424,90.90714820848778,2.7995666666666668,2.8068747086414154,2.2939857142857143,2.415530125419985,1.605915,1.7704419345685718,3639133.0,55428854.76666667,7474477.0,54852946.77142857
2024-03-11,2.7662,2.9563,2.65,2.7033,59152057.0,651256.0,28379446.0,2.8489999999999998,2.5760285714285716,1.7776900000000002,2.7449186771603538,2.5532231955487417,1.9450878421298285,80.89288494472989,3.158059158709296,0.39732084129070433,0.5107488857814848,0.3993687720787013,0.1113801137027835,0.30630000000000024,0.3921714285714285,9117453591.989998,0.9793000000000001,142.25289004391075,-20.427197603054164,79.57280239694583,86.86924810597039,-2.2738775215096507,3.0778,3.126,2.6688,2.7662,59123344.0,624648.0,28353447.0,-10.124114627331208,83.00575739527497,3.03931567616509,0.35120432383491007,0.5082221839761458,0.3715237436530054,0.13669844032314044,0.45719999999999983,0.37736428571428565,9176605648.989998,1.2951,150.62970009966477,-17.338923425377086,82.66107657462291,90.16474110924862,2.8629999999999995,2.786537354320708,2.436271428571429,2.503197594064989,1.69526,1.8652760360382317,2639465.0,41413629.199999996,7459528.0,53651709.52857143
2024-03-12,2.703,2.816,2.52,2.6735,59360362.0,655372.0,29210831.0,2.7143333333333337,2.7099571428571427,1.85409,2.7092093385801768,2.583292396661556,2.0144604285936545,81.23436522826768,3.256104526390703,0.4520754736092969,0.5045307873579588,0.42040117513455283,0.08412961222340593,0.2959999999999998,0.40865714285714283,9058093229.989998,0.8724000000000003,148.62828977959643,-21.985229812457476,78.01477018754252,80.0828830530371,-1.091379948205684,2.7662,2.9563,2.65,2.7033,59152057.0,651256.0,28379446.0,-2.2738775215096507,80.89288494472989,3.158059158709296,0.39732084129070433,0.5107488857814848,0.3993687720787013,0.1113801137027835,0.30630000000000024,0.3921714285714285,9117453591.989998,0.9793000000000001,142.25289004391075,-20.427197603054164,79.57280239694583,86.86924810597039,2.8489999999999998,2.7449186771603538,2.5760285714285716,2.5532231955487417,1.7776900000000002,1.9450878421298285,2200328.0,33409620.0,7529022.0,52271642.52857143
2024-03-13,2.6741,2.8565,2.5875,2.6555,49077895.0,498810.0,23881727.0,2.677433333333333,2.7424571428571425,1.9316000000000002,2.6823546692900884,2.6013442974961674,2.0755118163466397,78.37450614335953,3.3307146072465077,0.5324853927534927,0.4924735217855898,0.4348156444647603,0.0576578773208295,0.26900000000000013,0.40549285714285715,9009015334.989998,0.8853,96.93711064965885,-25.55398653052357,74.44601346947644,77.34452868465495,-0.6955611233686164,2.703,2.816,2.52,2.6735,59360362.0,655372.0,29210831.0,-1.091379948205684,81.23436522826768,3.256104526390703,0.4520754736092969,0.5045307873579588,0.42040117513455283,0.08412961222340593,0.2959999999999998,0.40865714285714283,9058093229.989998,0.8724000000000003,148.62828977959643,-21.985229812457476,78.01477018754252,80.0828830530371,2.7143333333333337,2.7092093385801768,2.7099571428571427,2.583292396661556,1.85409,2.0144604285936545,1931276.0,28647908.0,7218104.0,48420543.95714285
2024-03-14,2.6558,3.0,2.5295,2.8513,85485331.0,1050013.0,41728518.0,2.7267666666666663,2.7818,2.0212600000000003,2.7668273346450443,2.6638332231221256,2.1493964052660073,79.0397239521966,3.4144989773473986,0.628021022652602,0.4930340855475732,0.4464593326813229,0.046574752866250346,0.4704999999999999,0.42244285714285706,9094500665.989998,1.1263,93.82095030929236,-14.961873638344212,85.03812636165578,79.16630333955827,7.361247081858574,2.6741,2.8565,2.5875,2.6555,49077895.0,498810.0,23881727.0,-0.6955611233686164,78.37450614335953,3.3307146072465077,0.5324853927534927,0.4924735217855898,0.4348156444647603,0.0576578773208295,0.26900000000000013,0.40549285714285715,9009015334.989998,0.8853,96.93711064965885,-25.55398653052357,74.44601346947644,77.34452868465495,2.677433333333333,2.6823546692900884,2.7424571428571425,2.6013442974961674,1.9316000000000002,2.0755118163466397,1805438.0,27157334.666666668,6069219.0,39444573.614285715
2024-03-15,2.8516,2.8697,2.3535,2.6836,95852064.0,1208566.0,46099765.0,2.7301333333333333,2.7729857142857144,2.10154,2.7252136673225222,2.668774917341594,2.200272938097816,70.94099162011173,3.4502511046438,0.7528288953561999,0.474476873844881,0.45206284091403454,0.022414032930846484,0.5162,0.43295,8998648601.989998,0.9476000000000002,55.66125290023203,-24.09586056644879,75.90413943355121,78.46275975489449,-5.891429372983578,2.6558,3.0,2.5295,2.8513,85485331.0,1050013.0,41728518.0,7.361247081858574,79.0397239521966,3.4144989773473986,0.628021022652602,0.4930340855475732,0.4464593326813229,0.046574752866250346,0.4704999999999999,0.42244285714285706,9094500665.989998,1.1263,93.82095030929236,-14.961873638344212,85.03812636165578,79.16630333955827,2.7267666666666663,2.7668273346450443,2.7818,2.6638332231221256,2.0212600000000003,2.1493964052660073,2204195.0,31607025.333333332,5494916.0,35348772.800000004
2024-03-16,2.6836,2.69,2.281,2.4223,64622244.0,668778.0,31071124.0,2.6523999999999996,2.6793857142857145,2.1674700000000002,2.5737568336612613,2.6071561880061958,2.2214183725646905,62.54746707602812,3.437415694819074,0.8975243051809263,0.4336861595610637,0.44838750464344035,-0.014701345082376638,0.4089999999999998,0.4357357142857143,8934026357.989998,-0.005700000000000038,34.49003386819165,-38.32788671023965,61.67211328976035,74.20479302832246,-9.736920554479068,2.8516,2.8697,2.3535,2.6836,95852064.0,1208566.0,46099765.0,-5.891429372983578,70.94099162011173,3.4502511046438,0.7528288953561999,0.474476873844881,0.45206284091403454,0.022414032930846484,0.5162,0.43295,8998648601.989998,0.9476000000000002,55.66125290023203,-24.09586056644879,75.90413943355121,78.46275975489449,2.7301333333333333,2.7252136673225222,2.7729857142857144,2.668774917341594,2.10154,2.200272938097816,2757389.0,37236670.0,5613089.0,34449957.28571428
2024-03-17,2.4225,3.0236,2.3466,2.8099,96730511.0,1127861.0,48400917.0,2.6386,2.685628571428572,2.25217,2.6918284168306306,2.6578421410046467,2.277464241844244,68.35563715970481,3.4507704875863072,1.0535695124136928,0.427704988432021,0.44425100140115653,-0.01654601296913555,0.677,0.4602857142857143,9030756868.989998,0.23399999999999999,58.733476443339725,-17.216775599128546,82.78322440087146,73.45315904139436,15.991744066047472,2.6836,2.69,2.281,2.4223,64622244.0,668778.0,31071124.0,-9.736920554479068,62.54746707602812,3.437415694819074,0.8975243051809263,0.4336861595610637,0.44838750464344035,-0.014701345082376638,0.4089999999999998,0.4357357142857143,8934026357.989998,-0.005700000000000038,34.49003386819165,-38.32788671023965,61.67211328976035,74.20479302832246,2.6523999999999996,2.5737568336612613,2.6793857142857145,2.6071561880061958,2.1674700000000002,2.2214183725646905,2927357.0,39633135.666666664,5357443.0,32674979.714285713
2024-03-18,2.81,2.8867,2.4541,2.4885,90959792.0,913265.0,44483285.0,2.5735666666666663,2.654942857142857,2.32283,2.5901642084153154,2.615506605753485,2.2975628854781256,62.28163304700319,3.3885669105582976,1.2570930894417027,0.39250600833454286,0.43390200278783386,-0.04139599445329101,0.4325999999999999,0.47552142857142854,8939797076.989998,-0.2567999999999997,44.2608695652174,-34.72222222222221,65.27777777777779,69.91103848946987,-11.441281138790032,2.4225,3.0236,2.3466,2.8099,96730511.0,1127861.0,48400917.0,15.991744066047472,68.35563715970481,3.4507704875863072,1.0535695124136928,0.427704988432021,0.44425100140115653,-0.01654601296913555,0.677,0.4602857142857143,9030756868.989998,0.23399999999999999,58.733476443339725,-17.216775599128546,82.78322440087146,73.45315904139436,2.6386,2.6918284168306306,2.685628571428572,2.6578421410046467,2.25217,2.277464241844244,3005205.0,41857268.666666664,5860656.0,35538904.0
2024-03-19,2.4881,2.6044,2.1555,2.3792,104160182.0,1235441.0,50578025.0,2.5591999999999997,2.6129,2.37437,2.484682104207658,2.5564299543151137,2.305337848765923,60.0293145387638,3.3363376482140943,1.4124023517859052,0.3517363685620509,0.4174688759426773,-0.06573250738062636,0.4489000000000001,0.46044999999999997,8835636894.989998,-0.6983000000000001,37.05069124423963,-52.09626787582838,47.90373212417162,65.3215781009403,-4.376833728547896,2.81,2.8867,2.4541,2.4885,90959792.0,913265.0,44483285.0,-11.441281138790032,62.28163304700319,3.3885669105582976,1.2570930894417027,0.39250600833454286,0.43390200278783386,-0.04139599445329101,0.4325999999999999,0.47552142857142854,8939797076.989998,-0.2567999999999997,44.2608695652174,-34.72222222222221,65.27777777777779,69.91103848946987,2.5735666666666663,2.5901642084153154,2.654942857142857,2.615506605753485,2.32283,2.2975628854781256,2709904.0,41318442.0,6122665.0,37839452.428571425
2024-03-20,2.3783,2.85,2.35,2.7465,93769320.0,1067141.0,47046402.0,2.5380666666666665,2.6259,2.4381399999999998,2.615591052103829,2.6039474657363355,2.347353291740597,55.525868350740836,3.3131515942690664,1.5631284057309331,0.34508623633503266,0.40299234802114836,-0.0579061116861157,0.5,0.4400571428571428,8929406214.989998,-0.01969999999999983,13.11779242174631,-39.10355486862439,60.89644513137561,58.025985011108354,15.481646554261461,2.4881,2.6044,2.1555,2.3792,104160182.0,1235441.0,50578025.0,-4.376833728547896,60.0293145387638,3.3363376482140943,1.4124023517859052,0.3517363685620509,0.4174688759426773,-0.06573250738062636,0.4489000000000001,0.46044999999999997,8835636894.989998,-0.6983000000000001,37.05069124423963,-52.09626787582838,47.90373212417162,65.3215781009403,2.5591999999999997,2.484682104207658,2.6129,2.5564299543151137,2.37437,2.305337848765923,3276567.0,47820742.333333336,6702734.0,40891908.71428572
2024-03-21,2.7465,2.7687,2.4929,2.5148,51279796.0,491625.0,25081283.0,2.5468333333333333,2.5778285714285714,2.47768,2.5651955260519146,2.5816605993022517,2.3633005972891117,48.969889064976236,3.2857221708641005,1.6696378291358995,0.3174602212131803,0.38588592265955474,-0.06842570144637444,0.2757999999999998,0.42724999999999996,8878126418.989998,-0.1884999999999999,-2.371986490158773,-62.97784647089127,37.02215352910873,48.607443594885325,-8.436191516475516,2.3783,2.85,2.35,2.7465,93769320.0,1067141.0,47046402.0,15.481646554261461,55.525868350740836,3.3131515942690664,1.5631284057309331,0.34508623633503266,0.40299234802114836,-0.0579061116861157,0.5,0.4400571428571428,8929406214.989998,-0.01969999999999983,13.11779242174631,-39.10355486862439,60.89644513137561,58.025985011108354,2.5380666666666665,2.615591052103829,2.6259,2.6039474657363355,2.4381399999999998,2.347353291740597,3215847.0,47369237.333333336,7271065.0,44201148.0
2024-03-22,2.5152,2.589,2.3624,2.4283,38641477.0,427229.0,18775156.0,2.5632,2.541357142857143,2.5090399999999997,2.496747763025957,2.543320449476689,2.3694910165949103,44.5018731788539,3.2526353353382964,1.7654446646617032,0.2852978421722625,0.36576830656209636,-0.08047046438983385,0.2265999999999999,0.40747142857142854,8839484941.989998,-0.24520000000000008,-11.547007613011317,-71.89077794951054,28.109222050489457,42.0092735703246,-3.454993638676844,2.7465,2.7687,2.4929,2.5148,51279796.0,491625.0,25081283.0,-8.436191516475516,48.969889064976236,3.2857221708641005,1.6696378291358995,0.3174602212131803,0.38588592265955474,-0.06842570144637444,0.2757999999999998,0.42724999999999996,8878126418.989998,-0.1884999999999999,-2.371986490158773,-62.97784647089127,37.02215352910873,48.607443594885325,2.5468333333333333,2.5651955260519146,2.5778285714285714,2.5816605993022517,2.47768,2.3633005972891117,2794207.0,40901903.333333336,6712677.0,41822971.571428575
2024-03-23,2.4282,2.55,2.3843,2.4178,23802580.0,226053.0,11755680.0,2.453633333333333,2.540714285714286,2.54142,2.457273881512979,2.5119403371075166,2.3740918721572997,37.12076841981961,3.201229783115383,1.8816102168846172,0.2560105327564748,0.3438167518009721,-0.08780621904449731,0.16569999999999974,0.3893428571428571,8815682361.989998,-0.2376999999999998,-21.43623070674249,-72.97269448737762,27.027305512622384,30.719560364073534,-0.4283007989457105,2.5152,2.589,2.3624,2.4283,38641477.0,427229.0,18775156.0,-3.454993638676844,44.5018731788539,3.2526353353382964,1.7654446646617032,0.2852978421722625,0.36576830656209636,-0.08047046438983385,0.2265999999999999,0.40747142857142854,8839484941.989998,-0.24520000000000008,-11.547007613011317,-71.89077794951054,28.109222050489457,42.0092735703246,2.5632,2.496747763025957,2.541357142857143,2.543320449476689,2.5090399999999997,2.3694910165949103,1985995.0,30300947.0,5931340.0,37919456.0
2024-03-24,2.4177,2.6497,2.3858,2.5838,26710781.0,241820.0,13863841.0,2.4766333333333335,2.5084142857142857,2.58436,2.5205369407564895,2.5299052528306376,2.3940640748089854,46.22485305074924,3.120679835447813,2.0480401645521873,0.24338930135941617,0.3237312617126609,-0.08034196035324476,0.2639,0.37553571428571425,8842393142.989998,-0.26750000000000007,-6.593883305617809,-50.662366086856345,49.337633913143655,34.82472049208517,6.870165860114991,2.4282,2.55,2.3843,2.4178,23802580.0,226053.0,11755680.0,-0.4283007989457105,37.12076841981961,3.201229783115383,1.8816102168846172,0.2560105327564748,0.3438167518009721,-0.08780621904449731,0.16569999999999974,0.3893428571428571,8815682361.989998,-0.2376999999999998,-21.43623070674249,-72.97269448737762,27.027305512622384,30.719560364073534,2.453633333333333,2.457273881512979,2.540714285714286,2.5119403371075166,2.54142,2.3740918721572997,1144907.0,18537373.0,5488615.0,35160106.85714286
2024-03-25,2.5837,2.73,2.4853,2.6643,42939866.0,453794.0,21438295.0,2.5553000000000003,2.5335285714285716,2.630775,2.5924184703782447,2.5635039396229784,2.419800829589082,49.19865209172351,2.9890967482419826,2.272453251758017,0.23714885737186986,0.30641478084450274,-0.06926592347263288,0.24469999999999992,0.37113571428571424,8885333008.989998,-0.019300000000000317,-1.442681167462001,-41.389240870867425,58.610759129132575,44.991899518299554,3.1195572241359293,2.4177,2.6497,2.3858,2.5838,26710781.0,241820.0,13863841.0,6.870165860114991,46.22485305074924,3.120679835447813,2.0480401645521873,0.24338930135941617,0.3237312617126609,-0.08034196035324476,0.2639,0.37553571428571425,8842393142.989998,-0.26750000000000007,-6.593883305617809,-50.662366086856345,49.337633913143655,34.82472049208517,2.4766333333333335,2.5205369407564895,2.5084142857142857,2.5299052528306376,2.58436,2.3940640748089854,895102.0,14798225.666666666,4602574.0,30226238.85714286
2024-03-26,2.6644,3.05,2.6577,2.8292,76998170.0,845295.0,40437469.0,2.6924333333333332,2.5978142857142856,2.650835,2.7108092351891226,2.6299279547172336,2.458791226771074,53.03095191746156,3.0062681576808505,2.295401842319149,0.24271148550274546,0.2936741217761513,-0.05096263627340586,0.39229999999999965,0.3780142857142856,8962331178.989998,0.40690000000000026,5.823826444735358,-24.68418110676352,75.31581889323647,61.08807064517091,6.185257468848524,2.5837,2.73,2.4853,2.6643,42939866.0,453794.0,21438295.0,3.1195572241359293,49.19865209172351,2.9890967482419826,2.272453251758017,0.23714885737186986,0.30641478084450274,-0.06926592347263288,0.24469999999999992,0.37113571428571424,8885333008.989998,-0.019300000000000317,-1.442681167462001,-41.389240870867425,58.610759129132575,44.991899518299554,2.5553000000000003,2.5924184703782447,2.5335285714285716,2.5635039396229784,2.630775,2.419800829589082,921667.0,15685938.666666666,4143103.0,26934097.42857143
2024-03-27,2.8289,3.3425,2.811,3.1064,122743982.9,1451152.0,63121904.9,2.866633333333333,2.649228571428572,2.67736,2.9086046175945612,2.749045966037925,2.5204682527928766,57.972910846270814,3.084644503691709,2.270075496308291,0.266416547593856,0.28822260693969226,-0.021806059345836237,0.5314999999999999,0.3967642857142856,9085075161.889997,0.2965,16.97985313500281,-19.890480202190396,80.1095197978096,71.34536594005955,9.809466577114774,2.6644,3.05,2.6577,2.8292,76998170.0,845295.0,40437469.0,6.185257468848524,53.03095191746156,3.0062681576808505,2.295401842319149,0.24271148550274546,0.2936741217761513,-0.05096263627340586,0.39229999999999965,0.3780142857142856,8962331178.989998,0.40690000000000026,5.823826444735358,-24.68418110676352,75.31581889323647,61.08807064517091,2.6924333333333332,2.7108092351891226,2.5978142857142856,2.6299279547172336,2.650835,2.458791226771074,1540909.0,25246535.0,3752957.0,25485446.57142857
2024-03-28,3.1062,3.48,3.0071,3.2624,83435104.8,893455.0,43433800.5,3.0660000000000003,2.7560285714285717,2.703215,3.0855023087972806,2.8773844745284434,2.591128419193555,57.37293303203128,3.187107007417088,2.2193229925829123,0.2943972481200099,0.2894575351757558,0.004939712944254104,0.4729000000000001,0.3969357142857142,9168510266.689997,0.7738999999999998,14.417984778872794,-16.42884107210268,83.57115892789732,79.66549920631446,5.028652372674011,2.8289,3.3425,2.811,3.1064,122743982.9,1451152.0,63121904.9,9.809466577114774,57.972910846270814,3.084644503691709,2.270075496308291,0.266416547593856,0.28822260693969226,-0.021806059345836237,0.5314999999999999,0.3967642857142856,9085075161.889997,0.2965,16.97985313500281,-19.890480202190396,80.1095197978096,71.34536594005955,2.866633333333333,2.9086046175945612,2.649228571428572,2.749045966037925,2.67736,2.5204682527928766,2750241.0,41665889.63333333,4136968.0,27781946.985714283
2024-03-29,3.2623,3.37,3.0754,3.1026,41201965.0,461768.0,20019895.0,3.157133333333333,2.852357142857143,2.70447,3.09405115439864,2.933688355896332,2.6398399983179783,57.535971223021576,3.192561260232985,2.2163787397670154,0.30021691664483097,0.29160941146957087,0.0086075051752601,0.2946,0.38110714285714276,9127308301.689997,0.7233999999999998,15.61335519451481,-28.4937712344281,71.5062287655719,78.39563583042629,-4.895319253287569,3.1062,3.48,3.0071,3.2624,83435104.8,893455.0,43433800.5,5.028652372674011,57.37293303203128,3.187107007417088,2.2193229925829123,0.2943972481200099,0.2894575351757558,0.004939712944254104,0.4729000000000001,0.3969357142857142,9168510266.689997,0.7738999999999998,14.417984778872794,-16.42884107210268,83.57115892789732,79.66549920631446,3.0660000000000003,3.0855023087972806,2.7560285714285717,2.8773844745284434,2.703215,2.591128419193555,3189902.0,48997724.800000004,4538798.0,30403735.199999996
2024-03-30,3.1031,3.2254,2.9493,3.2046,45685479.0,435668.0,23348368.0,3.1898666666666666,2.9647571428571426,2.72639,3.14932557719932,3.0014162669222486,2.6936266651448375,64.92540161025681,3.2631084536853097,2.18967154631469,0.3094919627352768,0.2951859217227121,0.014306041012564719,0.2761,0.3716142857142856,9172993780.689997,0.45809999999999995,32.295751971266995,-20.792751981879945,79.20724801812005,78.09487857052977,3.27092262576134,3.2623,3.37,3.0754,3.1026,41201965.0,461768.0,20019895.0,-4.895319253287569,57.535971223021576,3.192561260232985,2.2163787397670154,0.30021691664483097,0.29160941146957087,0.0086075051752601,0.2946,0.38110714285714276,9127308301.689997,0.7233999999999998,15.61335519451481,-28.4937712344281,71.5062287655719,78.39563583042629,3.157133333333333,3.09405115439864,2.852357142857143,2.933688355896332,2.70447,2.6398399983179783,2806375.0,42191866.800000004,4573337.0,30581555.057142854
2024-03-31,3.2053,3.27,3.0042,3.0508,32823604.0,329209.0,15515578.0,3.1193333333333335,3.031471428571429,2.7437650000000002,3.10006278859966,3.0137622001916866,2.727643173226282,55.04629435669698,3.299498314591993,2.1880316854080073,0.30096281693451177,0.29634130076507204,0.004621516169439732,0.26580000000000004,0.3422428571428571,9140170176.689997,0.536,8.573258834833997,-32.404681011702515,67.59531898829748,72.76959859066316,-4.820141640408063,3.1031,3.2254,2.9493,3.2046,45685479.0,435668.0,23348368.0,3.27092262576134,64.92540161025681,3.2631084536853097,2.18967154631469,0.3094919627352768,0.2951859217227121,0.014306041012564719,0.2761,0.3716142857142856,9172993780.689997,0.45809999999999995,32.295751971266995,-20.792751981879945,79.20724801812005,78.09487857052977,3.1898666666666666,3.14932557719932,2.9647571428571426,3.0014162669222486,2.72639,2.6936266651448375,1790891.0,28934021.166666668,4782952.0,32237653.34285714
2024-04-01,3.0503,3.0828,2.82,2.8803,37123924.0,416017.0,17624544.0,3.0452333333333335,3.0623285714285715,2.754105,2.99018139429983,2.980396650143765,2.7421819186333023,58.761180679785326,3.312024826253155,2.196185173746845,0.277249522453177,0.29252294510269305,-0.015273422649516033,0.26280000000000037,0.3301142857142857,9103046252.689997,0.45199999999999996,15.744424352019282,-45.27746319365797,54.72253680634203,67.1750346042532,-5.573222306002686,3.2053,3.27,3.0042,3.0508,32823604.0,329209.0,15515578.0,-4.820141640408063,55.04629435669698,3.299498314591993,2.1880316854080073,0.30096281693451177,0.29634130076507204,0.004621516169439732,0.26580000000000004,0.3422428571428571,9140170176.689997,0.536,8.573258834833997,-32.404681011702515,67.59531898829748,72.76959859066316,3.1193333333333335,3.10006278859966,3.031471428571429,3.0137622001916866,2.7437650000000002,2.727643173226282,1226645.0,19627947.0,4870341.0,32473615.771428566
2024-04-02,2.8803,2.8811,2.5963,2.67,42890041.0,464068.0,20286042.0,2.8670333333333335,3.039585714285714,2.75483,2.830090697149915,2.9027974876078235,2.735307450192036,56.22165169020111,3.312247772458563,2.197412227541437,0.23873512338713798,0.2817653807595821,-0.04303025737244409,0.28480000000000016,0.3183928571428571,9060156211.689997,0.25219999999999976,12.222595830531269,-71.68141592920355,28.318584070796447,50.212146621811996,-7.301322778877204,3.0503,3.0828,2.82,2.8803,37123924.0,416017.0,17624544.0,-5.573222306002686,58.761180679785326,3.312024826253155,2.196185173746845,0.277249522453177,0.29252294510269305,-0.015273422649516033,0.26280000000000037,0.3301142857142857,9103046252.689997,0.45199999999999996,15.744424352019282,-45.27746319365797,54.72253680634203,67.1750346042532,3.0452333333333335,2.99018139429983,3.0623285714285715,2.980396650143765,2.754105,2.7421819186333023,1180894.0,18829496.666666668,4832564.0,31928794.199999996
2024-04-03,2.6708,2.7673,2.51,2.5802,34203842.0,324953.0,16898718.0,2.7101666666666664,2.9644142857142852,2.741275,2.7051453485749573,2.8221481157058674,2.7205353120785087,45.962612284535076,3.301990452276007,2.180559547723993,0.19867586345349286,0.26514747729836424,-0.06647161384487138,0.2573000000000003,0.30105714285714286,9025952369.689997,-0.0036000000000000476,-6.054979064263611,-80.51181102362204,19.488188976377955,34.176436617838824,-3.392242024861457,2.8803,2.8811,2.5963,2.67,42890041.0,464068.0,20286042.0,-7.301322778877204,56.22165169020111,3.312247772458563,2.197412227541437,0.23873512338713798,0.2817653807595821,-0.04303025737244409,0.28480000000000016,0.3183928571428571,9060156211.689997,0.25219999999999976,12.222595830531269,-71.68141592920355,28.318584070796447,50.212146621811996,2.8670333333333335,2.830090697149915,3.039585714285714,2.9027974876078235,2.75483,2.735307450192036,1209294.0,17808721.333333332,4451337.0,29050018.914285712
2024-04-04,2.5803,2.8789,2.5253,2.6985,40502692.0,404827.0,20389015.0,2.6495666666666664,2.8838571428571425,2.74202,2.7018226742874787,2.7912360867794,2.7184367109281746,54.719695801860134,3.3024523203422915,2.1815876796577087,0.17446332802452957,0.24701064744359733,-0.07254731941906775,0.3535999999999997,0.30661428571428573,9066455061.689997,0.03420000000000023,7.30475584539525,-69.92662848962061,30.073371510379392,25.960048185851278,4.58086269038485,2.6708,2.7673,2.51,2.5802,34203842.0,324953.0,16898718.0,-3.392242024861457,45.962612284535076,3.301990452276007,2.180559547723993,0.19867586345349286,0.26514747729836424,-0.06647161384487138,0.2573000000000003,0.30105714285714286,9025952369.689997,-0.0036000000000000476,-6.054979064263611,-80.51181102362204,19.488188976377955,34.176436617838824,2.7101666666666664,2.7051453485749573,2.9644142857142852,2.8221481157058674,2.741275,2.7205353120785087,1205038.0,18269768.0,3325138.0,22446706.5
2024-04-05,2.6988,2.7262,2.51,2.6104,30142864.0,252012.0,14274524.0,2.6296999999999997,2.813542857142857,2.7514250000000002,2.6561113371437393,2.7460270650845504,2.7081475003635864,54.67474457051907,3.2953357313560243,2.207514268643976,0.14647728655711356,0.2269039752663006,-0.08042668870918704,0.21620000000000017,0.3058714285714285,9036312197.689997,-0.21880000000000033,7.499073425853475,-79.36478963219862,20.635210367801385,23.39892361818626,-3.2755298651252422,2.5803,2.8789,2.5253,2.6985,40502692.0,404827.0,20389015.0,4.58086269038485,54.719695801860134,3.3024523203422915,2.1815876796577087,0.17446332802452957,0.24701064744359733,-0.07254731941906775,0.3535999999999997,0.30661428571428573,9066455061.689997,0.03420000000000023,7.30475584539525,-69.92662848962061,30.073371510379392,25.960048185851278,2.6495666666666664,2.7018226742874787,2.8838571428571425,2.7912360867794,2.74202,2.7184367109281746,1193848.0,19191258.333333332,2836510.0,19154594.285714287
2024-04-06,2.6103,2.6856,2.584,2.6308,15414346.0,135828.0,7699052.0,2.6465666666666667,2.7315714285714288,2.74247,2.6434556685718693,2.7172202988134124,2.7007810717575307,55.44033510420922,3.288221422497394,2.196718577502606,0.12450899439253282,0.20642497909154706,-0.08191598469901423,0.10159999999999991,0.3012928571428572,9051726543.689997,-0.4756,8.80966167590369,-77.6092122098337,22.390787790166303,24.366456556115708,0.7853503428724568,2.6988,2.7262,2.51,2.6104,30142864.0,252012.0,14274524.0,-3.2755298651252422,54.67474457051907,3.2953357313560243,2.207514268643976,0.14647728655711356,0.2269039752663006,-0.08042668870918704,0.21620000000000017,0.3058714285714285,9036312197.689997,-0.21880000000000033,7.499073425853475,-79.36478963219862,20.635210367801385,23.39892361818626,2.6296999999999997,2.6561113371437393,2.813542857142857,2.7460270650845504,2.7514250000000002,2.7081475003635864,981792.0,17187419.0,2626754.0,18333827.0
2024-04-07,2.6311,2.7981,2.621,2.7068,19259770.0,166418.0,9739680.0,2.649333333333333,2.682428571428571,2.7533849999999997,2.6751278342859344,2.714615224110059,2.7013543030187184,53.292996358963364,3.286331282570108,2.2204387174298916,0.11194114162093793,0.18752821159742522,-0.07558706997648729,0.1770999999999998,0.29509285714285716,9070986313.689997,-0.5556000000000001,4.76043037386793,-77.73197949130393,22.268020508696072,21.764672888887933,2.8771236365018384,2.6103,2.6856,2.584,2.6308,15414346.0,135828.0,7699052.0,0.7853503428724568,55.44033510420922,3.288221422497394,2.196718577502606,0.12450899439253282,0.20642497909154706,-0.08191598469901423,0.10159999999999991,0.3012928571428572,9051726543.689997,-0.4756,8.80966167590369,-77.6092122098337,22.390787790166303,24.366456556115708,2.6465666666666667,2.6434556685718693,2.7315714285714288,2.7172202988134124,2.74247,2.7007810717575307,792667.0,14120863.666666666,2326914.0,16098210.42857143
2024-04-08,2.7064,2.85,2.6295,2.8067,23816141.0,217609.0,11835716.0,2.7147666666666663,2.6719142857142857,2.7747599999999997,2.7409139171429673,2.7376364180825448,2.7113872265407455,53.77318494965555,3.277979326045113,2.2715406739548865,0.10878808156773978,0.17178018559148817,-0.06299210402374839,0.22049999999999992,0.2933642857142857,9094802454.689997,-0.2958999999999996,5.344743459820611,-69.41237113402057,30.587628865979415,25.082145721613944,3.7060301507537794,2.6311,2.7981,2.621,2.7068,19259770.0,166418.0,9739680.0,2.8771236365018384,53.292996358963364,3.286331282570108,2.2204387174298916,0.11194114162093793,0.18752821159742522,-0.07558706997648729,0.1770999999999998,0.29509285714285716,9070986313.689997,-0.5556000000000001,4.76043037386793,-77.73197949130393,22.268020508696072,21.764672888887933,2.649333333333333,2.6751278342859344,2.682428571428571,2.714615224110059,2.7533849999999997,2.7013543030187184,554258.0,10571085.333333334,2164123.0,15273082.142857144
2024-04-09,2.8066,2.8478,2.5526,2.5856,20965932.0,202951.0,10024389.0,2.6997,2.6598571428571427,2.7667150000000005,2.6632569585714836,2.6996273135619084,2.699407490679722,43.731988472622476,3.276932593519547,2.256497406480454,0.08744037831731122,0.1549122241366528,-0.06747184581934157,0.2951999999999999,0.2864285714285715,9073836522.689997,-0.6190000000000002,-8.610207832602867,-92.2061855670103,7.793814432989701,20.21648793588841,-7.874296301574862,2.7064,2.85,2.6295,2.8067,23816141.0,217609.0,11835716.0,3.7060301507537794,53.77318494965555,3.277979326045113,2.2715406739548865,0.10878808156773978,0.17178018559148817,-0.06299210402374839,0.22049999999999992,0.2933642857142857,9094802454.689997,-0.2958999999999996,5.344743459820611,-69.41237113402057,30.587628865979415,25.082145721613944,2.7147666666666663,2.7409139171429673,2.6719142857142857,2.7376364180825448,2.7747599999999997,2.7113872265407455,519855.0,9758149.333333334,1965715.0,14446106.714285715
2024-04-10,2.5855,2.7069,2.406,2.6643,27740807.0,248614.0,13663208.0,2.6855333333333333,2.6718714285714285,2.77419,2.6637784792857415,2.6907954851714315,2.696063920138796,37.33020003438988,3.2731235190394483,2.2752564809605516,0.0759965609180604,0.13912909149293431,-0.06313253057487392,0.30089999999999995,0.2699571428571429,9101577329.689997,-0.3865000000000003,-14.231908318310582,-75.94972067039109,24.05027932960892,20.810574209526028,3.047766389479782,2.8066,2.8478,2.5526,2.5856,20965932.0,202951.0,10024389.0,-7.874296301574862,43.731988472622476,3.276932593519547,2.256497406480454,0.08744037831731122,0.1549122241366528,-0.06747184581934157,0.2951999999999999,0.2864285714285715,9073836522.689997,-0.6190000000000002,-8.610207832602867,-92.2061855670103,7.793814432989701,20.21648793588841,2.6997,2.6632569585714836,2.6598571428571427,2.6996273135619084,2.7667150000000005,2.699407490679722,586978.0,10533261.666666666,1704598.0,12980156.285714285
2024-04-11,2.6642,2.7384,2.5105,2.5486,26039282.0,238381.0,12655666.0,2.5994999999999995,2.650457142857143,2.780205,2.6061892396428705,2.6552466138785737,2.6820197372684347,29.060079793475737,3.2642595792410662,2.296150420758934,0.05693491981131915,0.12269025715661129,-0.06575533734529214,0.2279,0.2524571428571429,9075538047.689997,-0.3317000000000001,-21.879597842079445,-85.20746887966807,14.792531120331933,15.545541627643532,-4.339013587568506,2.5855,2.7069,2.406,2.6643,27740807.0,248614.0,13663208.0,3.047766389479782,37.33020003438988,3.2731235190394483,2.2752564809605516,0.0759965609180604,0.13912909149293431,-0.06313253057487392,0.30089999999999995,0.2699571428571429,9101577329.689997,-0.3865000000000003,-14.231908318310582,-75.94972067039109,24.05027932960892,20.810574209526028,2.6855333333333333,2.6637784792857415,2.6718714285714285,2.6907954851714315,2.77419,2.696063920138796,669174.0,11841104.333333334,1628259.0,12517940.57142857
2024-04-12,2.5489,2.5872,1.88,2.14,61676883.0,673899.0,28833521.0,2.4509666666666665,2.5832571428571427,2.766315,2.373094619821435,2.5264349604089302,2.6303988099095363,25.35838623796849,3.3068086117252675,2.2258213882747326,0.008756882821007839,0.09990358228949062,-0.09114669946848278,0.7072000000000003,0.2819285714285715,9013861164.689997,-0.5299999999999998,-31.025591439437882,-81.29496402877696,18.705035971223037,19.182615473721313,-16.042214288516615,2.6642,2.7384,2.5105,2.5486,26039282.0,238381.0,12655666.0,-4.339013587568506,29.060079793475737,3.2642595792410662,2.296150420758934,0.05693491981131915,0.12269025715661129,-0.06575533734529214,0.2279,0.2524571428571429,9075538047.689997,-0.3317000000000001,-21.879597842079445,-85.20746887966807,14.792531120331933,15.545541627643532,2.5994999999999995,2.6061892396428705,2.650457142857143,2.6552466138785737,2.780205,2.6820197372684347,689946.0,12114421.0,1461813.0,11413176.42857143
2024-04-13,2.1397,2.2531,1.59,1.9512,79314294.0,1017840.0,39087539.0,2.2132666666666663,2.4861714285714283,2.734685,2.1621473099107176,2.3826262203066975,2.565713208965771,19.2794117647059,3.3833638168837625,2.086006183116237,-0.04415020465369146,0.07109282490085421,-0.11524302955454567,0.6630999999999998,0.3095714285714286,8934546870.689997,-0.629,-39.11252574424265,-78.5,21.5,18.33252236385167,-8.809646212085802,2.5489,2.5872,1.88,2.14,61676883.0,673899.0,28833521.0,-16.042214288516615,25.35838623796849,3.3068086117252675,2.2258213882747326,0.008756882821007839,0.09990358228949062,-0.09114669946848278,0.7072000000000003,0.2819285714285715,9013861164.689997,-0.5299999999999998,-31.025591439437882,-81.29496402877696,18.705035971223037,19.182615473721313,2.4509666666666665,2.373094619821435,2.5832571428571427,2.5264349604089302,2.766315,2.6303988099095363,1160894.0,18384131.666666668,1883700.0,13493033.142857144
2024-04-14,1.9513,2.2533,1.8519,2.2256,65352351.0,875322.0,32416242.0,2.1055999999999995,2.4174285714285717,2.71275,2.193873654955359,2.343369665230023,2.5333214747785546,30.90345274460799,3.3999741019607965,2.025525898039204,-0.06320903153952484,0.0442324536127784,-0.10744148515230324,0.40139999999999976,0.31925714285714285,8999899221.689997,-0.4729000000000001,-27.04864297889079,-57.422293676312975,42.577706323687025,27.594247431636703,14.057295136575615,2.1397,2.2531,1.59,1.9512,79314294.0,1017840.0,39087539.0,-8.809646212085802,19.2794117647059,3.3833638168837625,2.086006183116237,-0.04415020465369146,0.07109282490085421,-0.11524302955454567,0.6630999999999998,0.3095714285714286,8934546870.689997,-0.629,-39.11252574424265,-78.5,21.5,18.33252236385167,2.2132666666666663,2.1621473099107176,2.4861714285714283,2.3826262203066975,2.734685,2.565713208965771,1930120.0,26858908.666666668,2765712.0,17977102.714285713
2024-04-15,2.225,2.388,2.0,2.0505,59131307.0,653440.0,29106952.0,2.0757666666666665,2.3094,2.6738150000000003,2.1221868274776794,2.270152248922517,2.487338477180597,30.837797893958992,3.4190470536514157,1.9285829463485848,-0.09138892119036868,0.017108178652148986,-0.10849709984251767,0.3879999999999999,0.32819999999999994,8940767914.689997,-0.5598999999999998,-28.809499010519733,-64.33273952443653,35.66726047556347,33.24832226641684,-7.842696629213488,1.9513,2.2533,1.8519,2.2256,65352351.0,875322.0,32416242.0,14.057295136575615,30.90345274460799,3.3999741019607965,2.025525898039204,-0.06320903153952484,0.0442324536127784,-0.10744148515230324,0.40139999999999976,0.31925714285714285,8999899221.689997,-0.4729000000000001,-27.04864297889079,-57.422293676312975,42.577706323687025,27.594247431636703,2.1055999999999995,2.193873654955359,2.4174285714285717,2.343369665230023,2.71275,2.5333214747785546,2567061.0,33445767.333333332,3474616.0,21216611.57142857
2024-04-16,2.0508,2.1251,1.929,2.1113,45741599.0,428593.0,22785007.0,2.1291333333333333,2.2416428571428573,2.62406,2.1167434137388397,2.230439186691888,2.451525288877683,36.14129086669644,3.3804772488222494,1.8676427511777507,-0.10757557067532764,-0.00782857121334634,-0.09974699946198129,0.19610000000000016,0.3218642857142857,8986509513.689997,-0.5194999999999999,-20.925093632958802,-59.55465901156024,40.44534098843975,39.563435929230096,2.950068266042509,2.225,2.388,2.0,2.0505,59131307.0,653440.0,29106952.0,-7.842696629213488,30.837797893958992,3.4190470536514157,1.9285829463485848,-0.09138892119036868,0.017108178652148986,-0.10849709984251767,0.3879999999999999,0.32819999999999994,8940767914.689997,-0.5598999999999998,-28.809499010519733,-64.33273952443653,35.66726047556347,33.24832226641684,2.0757666666666665,2.1221868274776794,2.3094,2.270152248922517,2.6738150000000003,2.487338477180597,2546602.0,33536911.0,3910447.0,23683931.0
2024-04-17,2.1118,2.1381,1.8755,1.9865,36538789.0,382898.0,18392327.0,2.049433333333333,2.144814285714286,2.5602650000000002,2.05162170686942,2.169454390018916,2.4072371661274277,35.52445506412444,3.305128430152788,1.8154015698472126,-0.12898704168861075,-0.03206026530839922,-0.09692677638021152,0.26260000000000017,0.3222428571428571,8949970724.689997,-0.7202999999999999,-23.009844198124185,-69.23733416091241,30.76266583908759,35.625089101030284,-5.933327019604138,2.0508,2.1251,1.929,2.1113,45741599.0,428593.0,22785007.0,2.950068266042509,36.14129086669644,3.3804772488222494,1.8676427511777507,-0.10757557067532764,-0.00782857121334634,-0.09974699946198129,0.19610000000000016,0.3218642857142857,8986509513.689997,-0.5194999999999999,-20.925093632958802,-59.55465901156024,40.44534098843975,39.563435929230096,2.1291333333333333,2.1167434137388397,2.2416428571428573,2.230439186691888,2.62406,2.451525288877683,1957355.0,28102733.666666668,4136089.0,25506876.42857143
2024-04-18,1.9875,2.0908,1.8845,2.0468,29755410.0,323338.0,15348218.0,2.0482,2.0731285714285717,2.507475,2.04921085343471,2.138790792514187,2.3729098169724345,33.64781452300899,3.2400530917597408,1.7748969082402588,-0.13948221650883408,-0.0535446555484862,-0.08593756096034788,0.20630000000000015,0.31172142857142854,8979726134.689997,-0.7599,-24.15045395590142,-63.74603174603174,36.25396825396826,35.82065836049855,2.983647798742145,2.1118,2.1381,1.8755,1.9865,36538789.0,382898.0,18392327.0,-5.933327019604138,35.52445506412444,3.305128430152788,1.8154015698472126,-0.12898704168861075,-0.03206026530839922,-0.09692677638021152,0.26260000000000017,0.3222428571428571,8949970724.689997,-0.7202999999999999,-23.009844198124185,-69.23733416091241,30.76266583908759,35.625089101030284,2.049433333333333,2.05162170686942,2.144814285714286,2.169454390018916,2.5602650000000002,2.4072371661274277,1464931.0,23428095.333333332,4270373.0,26182464.85714286
2024-04-19,2.0467,2.186,1.8546,2.1079,41070066.0,442607.0,20655237.0,2.0470666666666664,2.0685428571428575,2.4526399999999997,2.078555426717355,2.13106809438564,2.3476707867845836,37.21829373759984,3.1274070175697877,1.7778729824302117,-0.14124131682087437,-0.07108398780296384,-0.07015732901791054,0.3313999999999999,0.31994999999999996,9020796200.689997,-0.4777,-19.249923383389522,-58.89682539682541,41.10317460317459,36.039936232076826,2.9901793130405006,1.9875,2.0908,1.8845,2.0468,29755410.0,323338.0,15348218.0,2.983647798742145,33.64781452300899,3.2400530917597408,1.7748969082402588,-0.13948221650883408,-0.0535446555484862,-0.08593756096034788,0.20630000000000015,0.31172142857142854,8979726134.689997,-0.7599,-24.15045395590142,-63.74603174603174,36.25396825396826,35.82065836049855,2.0482,2.04921085343471,2.0731285714285717,2.138790792514187,2.507475,2.3729098169724345,1134829.0,18841850.666666668,4355330.0,26567115.14285714
2024-04-20,2.1083,2.5,2.0706,2.4909,39666782.0,426495.0,20742098.0,2.2152,2.145642857142857,2.424645,2.284727713358677,2.22102607078923,2.361311664233671,46.99566207103896,3.0386429512223874,1.8106470487776127,-0.1104572351072779,-0.07895863726382665,-0.03149859784345124,0.4293999999999998,0.3433642857142857,9060462982.689997,-0.1734,-5.317774061122094,-28.500000000000014,71.49999999999999,49.61904761904763,18.147322487312056,2.0467,2.186,1.8546,2.1079,41070066.0,442607.0,20655237.0,2.9901793130405006,37.21829373759984,3.1274070175697877,1.7778729824302117,-0.14124131682087437,-0.07108398780296384,-0.07015732901791054,0.3313999999999999,0.31994999999999996,9020796200.689997,-0.4777,-19.249923383389522,-58.89682539682541,41.10317460317459,36.039936232076826,2.0470666666666664,2.078555426717355,2.0685428571428575,2.13106809438564,2.4526399999999997,2.3476707867845836,1148843.0,18131927.333333332,4124038.0,25398788.85714286
2024-04-21,2.4917,2.5658,2.361,2.4196,34512297.0,400182.0,17085070.0,2.3394666666666666,2.1733571428571428,2.40161,2.3521638566793386,2.2706695530919223,2.3668629343066545,43.819934584265795,2.9769837088554967,1.8262362911445027,-0.09076762994582976,-0.08132043580022727,-0.009447194145602494,0.20479999999999965,0.34534285714285706,9025950685.689997,-0.129,-10.610314762819561,-34.158730158730165,65.84126984126983,59.48148148148149,-2.8936067744913045,2.1083,2.5,2.0706,2.4909,39666782.0,426495.0,20742098.0,18.147322487312056,46.99566207103896,3.0386429512223874,1.8106470487776127,-0.1104572351072779,-0.07895863726382665,-0.03149859784345124,0.4293999999999998,0.3433642857142857,9060462982.689997,-0.1734,-5.317774061122094,-28.500000000000014,71.49999999999999,49.61904761904763,2.2152,2.284727713358677,2.145642857142857,2.22102607078923,2.424645,2.361311664233671,1192440.0,18915184.333333332,3532693.0,22778011.57142857
2024-04-22,2.4197,2.5268,2.3759,2.4694,28081025.0,290582.0,13667945.0,2.4599666666666664,2.2332,2.39158,2.410781928339669,2.320352164818942,2.3766283691345924,42.581922146470184,2.954104586035812,1.8290554139641877,-0.07033426259773456,-0.07912320115972873,0.00878893856199417,0.15090000000000003,0.3403714285714285,9054031710.689997,0.3293999999999997,-12.01767199914492,-30.08427412943235,69.91572587056764,69.08566523727917,2.0539736330949965,2.4917,2.5658,2.361,2.4196,34512297.0,400182.0,17085070.0,-2.8936067744913045,43.819934584265795,2.9769837088554967,1.8262362911445027,-0.09076762994582976,-0.08132043580022727,-0.009447194145602494,0.20479999999999965,0.34534285714285706,9025950685.689997,-0.129,-10.610314762819561,-34.158730158730165,65.84126984126983,59.48148148148149,2.3394666666666666,2.3521638566793386,2.1733571428571428,2.2706695530919223,2.40161,2.3668629343066545,1269284.0,19494135.0,3057553.0,20587844.14285714
2024-04-23,2.4679,2.5596,2.3905,2.4499,25427610.0,253197.0,12875100.0,2.4462999999999995,2.2815714285714286,2.385065,2.430340964169835,2.352739123614206,2.383606619693203,46.725228051546885,2.941375380141029,1.8287546198589708,-0.055079239603098795,-0.07431440884840275,0.019235169245303954,0.16910000000000025,0.33136428571428567,9028604100.689997,0.4986999999999999,-5.248298267326734,-25.121908742598396,74.8780912574016,70.21169565641304,-0.7293650472061363,2.4197,2.5268,2.3759,2.4694,28081025.0,290582.0,13667945.0,2.0539736330949965,42.581922146470184,2.954104586035812,1.8290554139641877,-0.07033426259773456,-0.07912320115972873,0.00878893856199417,0.15090000000000003,0.3403714285714285,9054031710.689997,0.3293999999999997,-12.01767199914492,-30.08427412943235,69.91572587056764,69.08566523727917,2.4599666666666664,2.410781928339669,2.2332,2.320352164818942,2.39158,2.3766283691345924,1117259.0,17165037.666666668,2694695.0,18382271.714285713
2024-04-24,2.4497,2.6366,2.2101,2.2711,44646952.0,449212.0,21673427.0,2.3968,2.3222285714285715,2.363695,2.3507204820849177,2.3323293427106546,2.3728917035319457,40.94843462246777,2.9018495208541997,1.8255404791458,-0.05676286273148268,-0.07080409962501874,0.014041236893536063,0.4264999999999999,0.34033571428571424,8983957148.689997,0.045500000000000096,-14.758097811807968,-40.69139672587948,59.30860327412053,68.03414013402994,-7.29068865575376,2.4679,2.5596,2.3905,2.4499,25427610.0,253197.0,12875100.0,-0.7293650472061363,46.725228051546885,2.941375380141029,1.8287546198589708,-0.055079239603098795,-0.07431440884840275,0.019235169245303954,0.16910000000000025,0.33136428571428567,9028604100.689997,0.4986999999999999,-5.248298267326734,-25.121908742598396,74.8780912574016,70.21169565641304,2.4462999999999995,2.430340964169835,2.2815714285714286,2.352739123614206,2.385065,2.383606619693203,943961.0,14542705.0,2519299.0,16966570.714285713
2024-04-25,2.2711,2.38,2.2048,2.2976,30772217.0,308644.0,14976835.0,2.3395333333333332,2.3580571428571426,2.3480549999999996,2.324160241042459,2.3236470070329913,2.365721065100332,43.97445746111004,2.8740651799095187,1.8220448200904804,-0.05532111033655296,-0.0677075017673256,0.012386391430772636,0.1751999999999998,0.3365714285714286,9014729365.689997,0.2471000000000001,-9.848544298830731,-32.39059812726925,67.60940187273074,67.26536546808431,1.166835454185195,2.4497,2.6366,2.2101,2.2711,44646952.0,449212.0,21673427.0,-7.29068865575376,40.94843462246777,2.9018495208541997,1.8255404791458,-0.05676286273148268,-0.07080409962501874,0.014041236893536063,0.4264999999999999,0.34033571428571424,8983957148.689997,0.045500000000000096,-14.758097811807968,-40.69139672587948,59.30860327412053,68.03414013402994,2.3968,2.3507204820849177,2.3222285714285715,2.3323293427106546,2.363695,2.3728917035319457,992991.0,16072157.333333334,2585613.0,17435299.285714287
2024-04-26,2.2972,2.3105,2.1349,2.1585,22885282.0,212924.0,11209778.0,2.2424,2.365285714285714,2.32444,2.2413301205212295,2.2823602552747433,2.345985725566967,50.51011967131749,2.8392920212541624,1.8095879787458378,-0.06465738854181824,-0.06709747912222414,0.002440090580405896,0.1756000000000002,0.2986,8991844083.689997,0.04720000000000013,0.864485981308416,-45.68125358303076,54.31874641696923,60.41225052127351,-6.037785129723143,2.2711,2.38,2.2048,2.2976,30772217.0,308644.0,14976835.0,1.166835454185195,43.97445746111004,2.8740651799095187,1.8220448200904804,-0.05532111033655296,-0.0677075017673256,0.012386391430772636,0.1751999999999998,0.3365714285714286,9014729365.689997,0.2471000000000001,-9.848544298830731,-32.39059812726925,67.60940187273074,67.26536546808431,2.3395333333333332,2.324160241042459,2.3580571428571426,2.3236470070329913,2.3480549999999996,2.365721065100332,1011053.0,16508454.0,2570919.0,17382244.57142857
2024-04-27,2.1584,2.1991,2.0575,2.1862,20019350.0,181317.0,10121647.0,2.2140999999999997,2.3217571428571424,2.29841,2.2137650602606147,2.2583201914560576,2.3307680374177324,57.1117298147924,2.7836564979672658,1.8131635020327344,-0.0690256134770908,-0.06748310599319747,-0.0015425074838933267,0.14159999999999995,0.26134999999999997,9011863433.689997,0.1997,12.043870438704385,-57.39773161717856,42.60226838282144,54.843472224173816,1.2879911045218704,2.2972,2.3105,2.1349,2.1585,22885282.0,212924.0,11209778.0,-6.037785129723143,50.51011967131749,2.8392920212541624,1.8095879787458378,-0.06465738854181824,-0.06709747912222414,0.002440090580405896,0.1756000000000002,0.2986,8991844083.689997,0.04720000000000013,0.864485981308416,-45.68125358303076,54.31874641696923,60.41225052127351,2.2424,2.2413301205212295,2.365285714285714,2.2823602552747433,2.32444,2.345985725566967,970780.0,15953346.666666666,2341236.0,16032893.285714285
2024-04-28,2.1865,2.2876,2.141,2.1603,18516388.0,157485.0,9047530.0,2.1683333333333334,2.2847142857142857,2.26609,2.187032530130307,2.233815143592043,2.314532986235091,47.67400441689819,2.6911667801852417,1.8410132198147584,-0.07372749211894725,-0.06873198321834742,-0.0049955089005998266,0.14659999999999984,0.24314999999999998,8993347045.689997,0.11349999999999971,-2.934040258806625,-60.907928388746825,39.092071611253175,45.33769547034797,-1.198262062657225,2.1584,2.1991,2.0575,2.1862,20019350.0,181317.0,10121647.0,1.2879911045218704,57.1117298147924,2.7836564979672658,1.8131635020327344,-0.0690256134770908,-0.06748310599319747,-0.0015425074838933267,0.14159999999999995,0.26134999999999997,9011863433.689997,0.1997,12.043870438704385,-57.39773161717856,42.60226838282144,54.843472224173816,2.2140999999999997,2.2137650602606147,2.3217571428571424,2.2583201914560576,2.29841,2.3307680374177324,702885.0,12102753.333333334,2096058.0,14515686.0
2024-04-29,2.1605,2.2,2.0862,2.1672,22547642.0,236540.0,11405427.8,2.171233333333333,2.241542857142857,2.24517,2.1771162650651537,2.217161357694032,2.3005012732603207,54.72278429785511,2.64443734006443,1.84590265993557,-0.07602067348086994,-0.07018972127085193,-0.005830952210018003,0.11380000000000035,0.22356428571428572,9015894687.689997,0.05929999999999991,5.691294806144831,-60.02557544757037,39.97442455242964,40.55625484883476,0.3101133996759976,2.1865,2.2876,2.141,2.1603,18516388.0,157485.0,9047530.0,-1.198262062657225,47.67400441689819,2.6911667801852417,1.8410132198147584,-0.07372749211894725,-0.06873198321834742,-0.0049955089005998266,0.14659999999999984,0.24314999999999998,8993347045.689997,0.11349999999999971,-2.934040258806625,-60.907928388746825,39.092071611253175,45.33769547034797,2.1683333333333334,2.187032530130307,2.2847142857142857,2.233815143592043,2.26609,2.314532986235091,551726.0,10126318.333333334,1853361.0,13367466.0
2024-04-30,2.1672,2.1999,1.915,2.0226,32234745.0,297697.0,15608887.4,2.1167,2.1805,2.213085,2.099858132532577,2.1685210182705243,2.2740344853307666,46.638368831956356,2.5715897736597952,1.854580226340205,-0.08848603581877601,-0.07384898418043676,-0.014637051638339255,0.28489999999999993,0.22990714285714287,8983659942.689997,-0.4682999999999997,-4.201203050253389,-78.5166240409207,21.4833759590793,33.51662404092072,-6.672203765227004,2.1605,2.2,2.0862,2.1672,22547642.0,236540.0,11405427.8,0.3101133996759976,54.72278429785511,2.64443734006443,1.84590265993557,-0.07602067348086994,-0.07018972127085193,-0.005830952210018003,0.11380000000000035,0.22356428571428572,9015894687.689997,0.05929999999999991,5.691294806144831,-60.02557544757037,39.97442455242964,40.55625484883476,2.171233333333333,2.1771162650651537,2.241542857142857,2.217161357694032,2.24517,2.3005012732603207,575342.0,10191534.933333334,1799319.0,13044249.257142857
2024-05-01,2.0229,2.0605,1.8617,2.0139,41579206.9,392690.0,20753283.1,2.0679,2.143757142857143,2.18635,2.056879066266289,2.129865763702893,2.249259772442122,51.138630319148945,2.5182682175746196,1.8544317824253804,-0.09793797456421505,-0.07866678225719242,-0.019271192307022622,0.1988000000000003,0.22535,8942080735.789997,-0.40569999999999995,1.379310344827589,-79.62915601023019,20.37084398976982,27.2762148337596,-0.4449058282663452,2.1672,2.1999,1.915,2.0226,32234745.0,297697.0,15608887.4,-6.672203765227004,46.638368831956356,2.5715897736597952,1.854580226340205,-0.08848603581877601,-0.07384898418043676,-0.014637051638339255,0.28489999999999993,0.22990714285714287,8983659942.689997,-0.4682999999999997,-4.201203050253389,-78.5166240409207,21.4833759590793,33.51662404092072,2.1167,2.099858132532577,2.1805,2.1685210182705243,2.213085,2.2740344853307666,691722.0,12020615.066666668,1843819.0,13434790.314285714
2024-05-02,2.0134,2.0556,1.928,2.0017,23256549.6,194468.0,12113762.3,2.0127333333333333,2.1014857142857144,2.179435,2.029289533133144,2.0978243227771696,2.225682651257158,48.04778807029694,2.5210402031836203,1.837829796816379,-0.10520045677714673,-0.08397351716118329,-0.021226939615963447,0.12760000000000016,0.21972857142857144,8918824186.189997,-0.4676999999999998,-2.2034395153410213,-81.18925831202046,18.81074168797954,20.221653878942902,-0.581106585874631,2.0229,2.0605,1.8617,2.0139,41579206.9,392690.0,20753283.1,-0.4449058282663452,51.138630319148945,2.5182682175746196,1.8544317824253804,-0.09793797456421505,-0.07866678225719242,-0.019271192307022622,0.1988000000000003,0.22535,8942080735.789997,-0.40569999999999995,1.379310344827589,-79.62915601023019,20.37084398976982,27.2762148337596,2.0679,2.056879066266289,2.143757142857143,2.129865763702893,2.18635,2.249259772442122,926927.0,15922532.766666668,1787297.0,13303341.185714288
2024-05-03,2.0021,2.2159,1.9555,2.1722,30984053.7,269367.0,16247001.4,2.0625999999999998,2.103442857142857,2.190485,2.100744766566572,2.116418242082877,2.2205890654231433,52.542506919731125,2.5148681800104655,1.866101819989534,-0.09609043051346422,-0.08639689983163948,-0.009693530681824741,0.26039999999999996,0.21465714285714285,8949808239.889997,-0.27769999999999984,3.0504293372551006,-59.93031358885015,40.069686411149846,26.417090696299752,8.496079116927234,2.0134,2.0556,1.928,2.0017,23256549.6,194468.0,12113762.3,-0.581106585874631,48.04778807029694,2.5210402031836203,1.837829796816379,-0.10520045677714673,-0.08397351716118329,-0.021226939615963447,0.12760000000000016,0.21972857142857144,8918824186.189997,-0.4676999999999998,-2.2034395153410213,-81.18925831202046,18.81074168797954,20.221653878942902,2.0127333333333333,2.029289533133144,2.1014857142857144,2.0978243227771696,2.179435,2.225682651257158,884855.0,16158644.266666666,1673121.0,12894330.8
2024-05-04,2.1717,2.2476,2.1336,2.159,20875333.2,191627.0,9972261.4,2.1109666666666667,2.099557142857143,2.1871549999999997,2.1298723832832858,2.1270636815621575,2.2147234401447484,31.451883312842284,2.5113877265212228,1.8629222734787767,-0.08891088936085367,-0.08689969773748232,-0.00201119162337135,0.11399999999999988,0.19212857142857143,8928932906.689997,-0.11210000000000031,-13.3245011843109,-61.63375919473483,38.36624080526517,32.41555630146487,-0.5847953216374341,2.0021,2.2159,1.9555,2.1722,30984053.7,269367.0,16247001.4,8.496079116927234,52.542506919731125,2.5148681800104655,1.866101819989534,-0.09609043051346422,-0.08639689983163948,-0.009693530681824741,0.26039999999999996,0.21465714285714285,8949808239.889997,-0.27769999999999984,3.0504293372551006,-59.93031358885015,40.069686411149846,26.417090696299752,2.0625999999999998,2.100744766566572,2.103442857142857,2.116418242082877,2.190485,2.2205890654231433,856525.0,16371348.933333335,1729564.0,13613934.142857144
2024-05-05,2.1589,2.3856,2.1044,2.3614,36653911.8,344642.0,19020130.6,2.230866666666666,2.128285714285714,2.2027,2.245636191641643,2.185647761171618,2.228692636321439,47.16318970559564,2.529150247680324,1.8762497523196764,-0.06612679427706025,-0.08274511704539791,0.016618322768337662,0.2812000000000001,0.1975857142857143,8965586818.489996,0.06380000000000008,-2.4053562572325937,-35.51425990450379,64.48574009549621,47.64055577063709,9.379776738153694,2.1717,2.2476,2.1336,2.159,20875333.2,191627.0,9972261.4,-0.5847953216374341,31.451883312842284,2.5113877265212228,1.8629222734787767,-0.08891088936085367,-0.08689969773748232,-0.00201119162337135,0.11399999999999988,0.19212857142857143,8928932906.689997,-0.11210000000000031,-13.3245011843109,-61.63375919473483,38.36624080526517,32.41555630146487,2.1109666666666667,2.1298723832832858,2.099557142857143,2.1270636815621575,2.1871549999999997,2.2147234401447484,655462.0,12777675.033333333,1739874.0,13592593.342857143
2024-05-06,2.3611,2.5238,2.3159,2.3783,41851160.4,429899.0,20981297.8,2.2995666666666663,2.158442857142857,2.21605,2.3119680958208217,2.2338108208787135,2.242940956671778,45.4124282405076,2.5485440300216213,1.8835559699783786,-0.04617427768118754,-0.07543094917255584,0.029256671491368305,0.20789999999999997,0.2016571428571429,9007437978.889996,0.21979999999999977,-3.6891552603871336,-33.33333333333336,66.66666666666666,56.506215855809366,0.7284740163483072,2.1589,2.3856,2.1044,2.3614,36653911.8,344642.0,19020130.6,9.379776738153694,47.16318970559564,2.529150247680324,1.8762497523196764,-0.06612679427706025,-0.08274511704539791,0.016618322768337662,0.2812000000000001,0.1975857142857143,8965586818.489996,0.06380000000000008,-2.4053562572325937,-35.51425990450379,64.48574009549621,47.64055577063709,2.230866666666666,2.245636191641643,2.128285714285714,2.185647761171618,2.2027,2.228692636321439,805636.0,15079797.800000003,1927031.0,15017250.57142857
2024-05-07,2.378,2.4995,2.3345,2.3359,28903034.6,305837.0,14088696.7,2.3585333333333334,2.2032,2.23352,2.323934047910411,2.259333115659035,2.2517941988935135,44.38865918487891,2.551636209153723,1.9154037908462769,-0.03339809769660107,-0.06702437887736488,0.033626281180763815,0.16500000000000004,0.20136428571428572,8978534944.289995,0.14970000000000017,-4.653251153108284,-38.805007097690016,61.194992902309984,64.11579988815764,-1.7703952901597992,2.3611,2.5238,2.3159,2.3783,41851160.4,429899.0,20981297.8,0.7284740163483072,45.4124282405076,2.5485440300216213,1.8835559699783786,-0.04617427768118754,-0.07543094917255584,0.029256671491368305,0.20789999999999997,0.2016571428571429,9007437978.889996,0.21979999999999977,-3.6891552603871336,-33.33333333333336,66.66666666666666,56.506215855809366,2.2995666666666663,2.3119680958208217,2.158442857142857,2.2338108208787135,2.21605,2.242940956671778,966168.0,16657896.600000001,2120390.0,16385232.000000002
2024-05-08,2.3359,2.4079,2.124,2.1534,28615786.6,287390.0,13973229.3,2.2891999999999997,2.2231285714285716,2.2388500000000002,2.2386670239552053,2.2328498367442764,2.242423322808417,44.22756253065227,2.547216429328586,1.9304835706714143,-0.037566069529798796,-0.06113271700785167,0.02356664747805287,0.28390000000000004,0.19117857142857145,8949919157.689995,-0.006899999999999906,-5.182510677645203,-55.943210995317926,44.056789004682074,57.30614952455292,-7.812834453529693,2.378,2.4995,2.3345,2.3359,28903034.6,305837.0,14088696.7,-1.7703952901597992,44.38865918487891,2.551636209153723,1.9154037908462769,-0.03339809769660107,-0.06702437887736488,0.033626281180763815,0.16500000000000004,0.20136428571428572,8978534944.289995,0.14970000000000017,-4.653251153108284,-38.805007097690016,61.194992902309984,64.11579988815764,2.3585333333333334,2.323934047910411,2.2032,2.259333115659035,2.23352,2.2517941988935135,1080378.0,18030041.700000003,2128530.0,16168061.900000002
2024-05-09,2.1528,2.3079,2.1291,2.2618,27453765.0,278787.0,14154267.0,2.250366666666667,2.2602857142857142,2.2465450000000002,2.2502335119776027,2.2400873775582073,2.244268720636187,48.37479571454512,2.5487722931699954,1.944317706830005,-0.03175617772355954,-0.055257409150993246,0.023501231427433704,0.17879999999999985,0.19143571428571432,8977372922.689995,0.09460000000000024,-1.5581476323119792,-39.57106177314604,60.42893822685396,55.22690671128202,5.06317354143441,2.3359,2.4079,2.124,2.1534,28615786.6,287390.0,13973229.3,-7.812834453529693,44.22756253065227,2.547216429328586,1.9304835706714143,-0.037566069529798796,-0.06113271700785167,0.02356664747805287,0.28390000000000004,0.19117857142857145,8949919157.689995,-0.006899999999999906,-5.182510677645203,-55.943210995317926,44.056789004682074,57.30614952455292,2.2891999999999997,2.2386670239552053,2.2231285714285716,2.2328498367442764,2.2388500000000002,2.242423322808417,1023126.0,16347741.266666666,2023230.0,15199482.785714287
2024-05-10,2.2624,2.362,2.1321,2.2091,30124997.0,276380.0,15138964.2,2.2081,2.265557142857143,2.232455,2.2296667559888013,2.232340533168655,2.240919318670836,52.49261083743841,2.5121516588062645,1.9527583411937353,-0.031046363029514357,-0.05041519992669747,0.019368836897183113,0.22990000000000022,0.19531428571428575,8947247925.689995,0.18649999999999967,2.3442205235116864,-47.5305845038514,52.4694154961486,52.31838090922822,-2.3559052333804864,2.1528,2.3079,2.1291,2.2618,27453765.0,278787.0,14154267.0,5.06317354143441,48.37479571454512,2.5487722931699954,1.944317706830005,-0.03175617772355954,-0.055257409150993246,0.023501231427433704,0.17879999999999985,0.19143571428571432,8977372922.689995,0.09460000000000024,-1.5581476323119792,-39.57106177314604,60.42893822685396,55.22690671128202,2.250366666666667,2.2502335119776027,2.2602857142857142,2.2400873775582073,2.2465450000000002,2.244268720636187,872014.0,14072064.333333334,2107549.0,15490983.457142858
2024-05-11,2.2092,2.2626,2.179,2.192,13827095.2,137849.0,6702938.8,2.220966666666667,2.2702714285714287,2.221075,2.2108333779944007,2.2222553998764916,2.23626033594028,50.28872958980487,2.4868872873482,1.9552627126517996,-0.031500538263188105,-0.0466322675939956,0.015131729330807496,0.08360000000000012,0.1911714285714286,8933420830.489994,0.17810000000000015,0.2653005214527715,-50.11327594019027,49.88672405980973,54.26169259427078,-0.7785623755205451,2.2624,2.362,2.1321,2.2091,30124997.0,276380.0,15138964.2,-2.3559052333804864,52.49261083743841,2.5121516588062645,1.9527583411937353,-0.031046363029514357,-0.05041519992669747,0.019368836897183113,0.22990000000000022,0.19531428571428575,8947247925.689995,0.18649999999999967,2.3442205235116864,-47.5305845038514,52.4694154961486,52.31838090922822,2.2081,2.2296667559888013,2.265557142857143,2.232340533168655,2.232455,2.240919318670836,842557.0,14422153.5,2114562.0,15332692.42857143
2024-05-12,2.192,2.2404,2.15,2.1673,10937165.8,93349.0,5410622.9,2.1894666666666662,2.2425428571428574,2.2059699999999998,2.1890666889972,2.208516549907369,2.2296926848983487,50.34888357256779,2.4453903711159133,1.9665496288840865,-0.03346776343756863,-0.043999366762710206,0.010531603325141574,0.09040000000000026,0.18715714285714294,8922483664.689995,0.16559999999999997,0.3240290700365689,-53.8438302371243,46.156169762875706,49.50410310627802,-1.1268248175182558,2.2092,2.2626,2.179,2.192,13827095.2,137849.0,6702938.8,-0.7785623755205451,50.28872958980487,2.4868872873482,1.9552627126517996,-0.031500538263188105,-0.0466322675939956,0.015131729330807496,0.08360000000000012,0.1911714285714286,8933420830.489994,0.17810000000000015,0.2653005214527715,-50.11327594019027,49.88672405980973,54.26169259427078,2.220966666666667,2.2108333779944007,2.2702714285714287,2.2222553998764916,2.221075,2.23626033594028,693016.0,11998723.333333334,2060784.0,14865646.342857143
2024-05-13,2.1685,2.2235,2.0205,2.1234,25873344.1,259379.0,12284906.6,2.1609,2.2061285714285717,2.189645,2.1562333444986,2.1872374124305267,2.219569572050887,47.89463564699098,2.4020328723369286,1.9772571276630717,-0.03812963201080022,-0.042825419812328215,0.004695787801527997,0.20299999999999985,0.19352857142857147,8896610320.589994,-0.048799999999999955,-2.021040974529331,-60.47424860293004,39.52575139706996,45.189548406585146,-2.0797786488355867,2.192,2.2404,2.15,2.1673,10937165.8,93349.0,5410622.9,-1.1268248175182558,50.34888357256779,2.4453903711159133,1.9665496288840865,-0.03346776343756863,-0.043999366762710206,0.010531603325141574,0.09040000000000026,0.18715714285714294,8922483664.689995,0.16559999999999997,0.3240290700365689,-53.8438302371243,46.156169762875706,49.50410310627802,2.1894666666666662,2.1890666889972,2.2425428571428574,2.208516549907369,2.2059699999999998,2.2296926848983487,507578.0,9084175.299999999,1809491.0,12921430.957142858
2024-05-14,2.1232,2.1388,1.9816,2.002,22765301.5,202918.0,10396375.8,2.097566666666667,2.1584285714285714,2.17619,2.0791166722492997,2.1409280593228948,2.198848660426993,48.98721730580135,2.4006054408798123,1.9517745591201876,-0.051031897907083845,-0.04446671543127934,-0.006565182475804503,0.15719999999999978,0.1844071428571429,8873845019.089994,-0.15700000000000003,-1.0184910511223388,-78.80984745506724,21.190152544932765,35.624024568292825,-5.708364732479295,2.1685,2.2235,2.0205,2.1234,25873344.1,259379.0,12284906.6,-2.0797786488355867,47.89463564699098,2.4020328723369286,1.9772571276630717,-0.03812963201080022,-0.042825419812328215,0.004695787801527997,0.20299999999999985,0.19352857142857147,8896610320.589994,-0.048799999999999955,-2.021040974529331,-60.47424860293004,39.52575139706996,45.189548406585146,2.1609,2.1562333444986,2.2061285714285717,2.1872374124305267,2.189645,2.219569572050887,490577.0,8132822.766666667,1638971.0,11679089.357142856
2024-05-15,2.0028,2.2748,1.9737,2.2567,34937198.1,297905.0,17932434.5,2.1273666666666666,2.1731857142857143,2.174145,2.1679083361246496,2.169871044492171,2.2043583118148984,59.612034837688036,2.394612784733463,1.9536772152665374,-0.04024100198072933,-0.04362157274116934,0.003380570760440009,0.3010999999999999,0.19171428571428573,8908782217.189995,-0.10470000000000024,12.056209345051894,-44.83048002685466,55.16951997314534,38.628474638382706,12.67725184741361,2.1232,2.1388,1.9816,2.002,22765301.5,202918.0,10396375.8,-5.708364732479295,48.98721730580135,2.4006054408798123,1.9517745591201876,-0.051031897907083845,-0.04446671543127934,-0.006565182475804503,0.15719999999999978,0.1844071428571429,8873845019.089994,-0.15700000000000003,-1.0184910511223388,-78.80984745506724,21.190152544932765,35.624024568292825,2.097566666666667,2.0791166722492997,2.1584285714285714,2.1409280593228948,2.17619,2.198848660426993,555646.0,9363968.433333334,1536052.0,11151614.942857144
2024-05-16,2.2563,2.3393,2.16,2.2826,31322656.0,285984.0,15562513.0,2.1804333333333332,2.176157142857143,2.18035,2.2252541680623246,2.1980532833691284,2.2118099011658603,61.00101825017623,2.405890935717284,1.9548090642827156,-0.029261912557167147,-0.0407496407043689,0.011487728147201753,0.17930000000000001,0.19540714285714286,8940104873.189995,-0.0956999999999999,14.033071888894444,-42.442371986626796,57.557628013373204,44.63910017715045,1.1656251385010854,2.0028,2.2748,1.9737,2.2567,34937198.1,297905.0,17932434.5,12.67725184741361,59.612034837688036,2.394612784733463,1.9536772152665374,-0.04024100198072933,-0.04362157274116934,0.003380570760440009,0.3010999999999999,0.19171428571428573,8908782217.189995,-0.10470000000000024,12.056209345051894,-44.83048002685466,55.16951997314534,38.628474638382706,2.1273666666666666,2.1679083361246496,2.1731857142857143,2.169871044492171,2.174145,2.2043583118148984,760202.0,13537905.633333335,1546567.0,11717215.685714286
2024-05-17,2.2821,2.3859,2.2236,2.3467,24682250.7,239253.0,12591797.0,2.2953333333333332,2.1958142857142855,2.1883749999999997,2.2859770840311624,2.2352149625268463,2.224656577245302,57.45535332820642,2.42589573704486,1.9508542629551395,-0.015213202466830555,-0.03564235305686123,0.020429150590030677,0.1623000000000001,0.18840000000000004,8964787123.889996,0.010799999999999699,8.033330264248217,-32.194146518814804,67.8058534811852,60.17766715590127,2.8307260856228913,2.2563,2.3393,2.16,2.2826,31322656.0,285984.0,15562513.0,1.1656251385010854,61.00101825017623,2.405890935717284,1.9548090642827156,-0.029261912557167147,-0.0407496407043689,0.011487728147201753,0.17930000000000001,0.19540714285714286,8940104873.189995,-0.0956999999999999,14.033071888894444,-42.442371986626796,57.557628013373204,44.63910017715045,2.1804333333333332,2.2252541680623246,2.176157142857143,2.1980532833691284,2.18035,2.2118099011658603,786807.0,14630441.1,1553764.0,11918393.685714286
2024-05-18,2.3467,2.4255,2.2619,2.2773,16521185.1,158530.0,8114359.2,2.3021999999999996,2.2079999999999997,2.1942250000000003,2.281638542015581,2.2457362218951347,2.229670236555273,54.82266612311456,2.4345806476732745,1.953869352326726,-0.009569190829479712,-0.03042772061138493,0.02085852978190522,0.1636000000000002,0.1919428571428572,8948265938.789995,0.1238999999999999,5.479388605836033,-44.81003453917472,55.18996546082528,60.18448231846124,-2.957344355904032,2.2821,2.3859,2.2236,2.3467,24682250.7,239253.0,12591797.0,2.8307260856228913,57.45535332820642,2.42589573704486,1.9508542629551395,-0.015213202466830555,-0.03564235305686123,0.020429150590030677,0.1623000000000001,0.18840000000000004,8964787123.889996,0.010799999999999699,8.033330264248217,-32.194146518814804,67.8058534811852,60.17766715590127,2.2953333333333332,2.2859770840311624,2.1958142857142855,2.2352149625268463,2.1883749999999997,2.224656577245302,823142.0,15362248.166666666,1516637.0,11554512.657142857
2024-05-19,2.2774,2.3104,2.1821,2.1995,13293825.0,120957.0,6350200.4,2.2744999999999997,2.2125999999999997,2.1958399999999996,2.2405692710077902,2.2341771664213512,2.226796880692866,42.653598330156996,2.4358649057252997,1.9558150942746997,-0.0112444615884848,-0.026591068806804907,0.015346607218320107,0.12829999999999986,0.1810214285714286,8934972113.789995,-0.06230000000000002,-6.856102312187695,-58.95291765133612,41.04708234866388,54.680967096891465,-3.420567313603235,2.3467,2.4255,2.2619,2.2773,16521185.1,158530.0,8114359.2,-2.957344355904032,54.82266612311456,2.4345806476732745,1.953869352326726,-0.009569190829479712,-0.03042772061138493,0.02085852978190522,0.1636000000000002,0.1919428571428572,8948265938.789995,0.1238999999999999,5.479388605836033,-44.81003453917472,55.18996546082528,60.18448231846124,2.3021999999999996,2.281638542015581,2.2079999999999997,2.2457362218951347,2.1942250000000003,2.229670236555273,683767.0,12089556.4,1537318.0,11756144.142857144
2024-05-20,2.1992,2.4403,2.161,2.4251,34090699.4,338173.0,17272647.5,2.3006333333333333,2.2557,2.2159649999999997,2.332834635503895,2.2819078748160133,2.24568289205545,51.785441782389746,2.462244484155315,1.9696855158446842,0.005567727550055412,-0.020159309535432844,0.025727037085488257,0.2793000000000001,0.1861214285714286,8969062813.189995,0.2160000000000002,1.9677921204221516,-14.149866869532108,85.85013313046788,60.69572697998569,10.271917060749374,2.2774,2.3104,2.1821,2.1995,13293825.0,120957.0,6350200.4,-3.420567313603235,42.653598330156996,2.4358649057252997,1.9558150942746997,-0.0112444615884848,-0.026591068806804907,0.015346607218320107,0.12829999999999986,0.1810214285714286,8934972113.789995,-0.06230000000000002,-6.856102312187695,-58.95291765133612,41.04708234866388,54.680967096891465,2.2744999999999997,2.2405692710077902,2.2125999999999997,2.2341771664213512,2.1958399999999996,2.226796880692866,518740.0,9018785.533333333,1564926.0,11890369.5
2024-05-21,2.4253,2.566,2.3751,2.5282,38256801.8,384725.0,19503284.3,2.3842666666666665,2.3308714285714283,2.24168,2.4305173177519475,2.34348090611201,2.2725892832882644,57.01159483701597,2.505872805193119,1.9774871948068813,0.026900722145207112,-0.010747303199304854,0.03764802534451196,0.19089999999999963,0.1879714285714286,9007319614.989994,0.33619999999999983,8.232372961171276,-6.381901063650151,93.61809893634985,73.50510480516056,4.242774089803323,2.1992,2.4403,2.161,2.4251,34090699.4,338173.0,17272647.5,10.271917060749374,51.785441782389746,2.462244484155315,1.9696855158446842,0.005567727550055412,-0.020159309535432844,0.025727037085488257,0.2793000000000001,0.1861214285714286,8969062813.189995,0.2160000000000002,1.9677921204221516,-14.149866869532108,85.85013313046788,60.69572697998569,2.3006333333333333,2.332834635503895,2.2557,2.2819078748160133,2.2159649999999997,2.24568289205545,617660.0,10579069.033333333,1643720.0,12602903.914285716
2024-05-22,2.5283,2.71,2.4744,2.5385,46951470.5,532362.0,23353461.0,2.4972666666666665,2.3711285714285713,2.26852,2.4845086588759737,2.392235679584007,2.297914113451287,66.05787674088899,2.5390530924402483,1.9979869075597518,0.0441296982850532,0.00022809709756675678,0.04390160118748644,0.2355999999999998,0.18452142857142856,9054271085.489994,0.3712,17.883347264790572,-23.29213635746299,76.707863642537,85.39203190311827,0.4034331368903913,2.4253,2.566,2.3751,2.5282,38256801.8,384725.0,19503284.3,4.242774089803323,57.01159483701597,2.505872805193119,1.9774871948068813,0.026900722145207112,-0.010747303199304854,0.03764802534451196,0.19089999999999963,0.1879714285714286,9007319614.989994,0.33619999999999983,8.232372961171276,-6.381901063650151,93.61809893634985,73.50510480516056,2.3842666666666665,2.4305173177519475,2.3308714285714283,2.34348090611201,2.24168,2.2725892832882644,843855.0,14375377.4,1825527.0,13903890.842857143
2024-05-23,2.5382,2.561,2.2183,2.362,34473148.1,264912.0,16117053.8,2.476233333333333,2.382471428571429,2.27801,2.423254329437987,2.3846767596880056,2.304017531217831,53.95359848484849,2.5476309807547977,2.0083890192452025,0.0430455092403732,0.008791579526128046,0.03425392971424516,0.3426999999999998,0.19622857142857142,9019797937.389994,0.23859999999999992,4.430099920417363,-47.26334374575579,52.73665625424421,74.35420627771036,-6.941927350090604,2.5283,2.71,2.4744,2.5385,46951470.5,532362.0,23353461.0,0.4034331368903913,66.05787674088899,2.5390530924402483,1.9979869075597518,0.0441296982850532,0.00022809709756675678,0.04390160118748644,0.2355999999999998,0.18452142857142856,9054271085.489994,0.3712,17.883347264790572,-23.29213635746299,76.707863642537,85.39203190311827,2.4972666666666665,2.4845086588759737,2.3711285714285713,2.392235679584007,2.26852,2.297914113451287,1255260.0,20043130.933333334,2059984.0,14678323.200000001
2024-05-24,2.363,2.411,2.25,2.31,14449272.2,93887.0,6535595.1,2.4034999999999997,2.3772285714285712,2.28556,2.3666271647189934,2.3660075697660043,2.3045872901494664,53.983418870904075,2.5495470124397475,2.021572987560252,0.03755737811715809,0.014544739244334057,0.023012638872824034,0.16100000000000003,0.19130714285714284,9005348665.189993,0.3080000000000003,4.567470915757554,-54.32568246638597,45.67431753361402,58.37294581013176,-2.24291155311045,2.5382,2.561,2.2183,2.362,34473148.1,264912.0,16117053.8,-6.941927350090604,53.95359848484849,2.5476309807547977,2.0083890192452025,0.0430455092403732,0.008791579526128046,0.03425392971424516,0.3426999999999998,0.19622857142857142,9019797937.389994,0.23859999999999992,4.430099920417363,-47.26334374575579,52.73665625424421,74.35420627771036,2.476233333333333,2.423254329437987,2.382471428571429,2.3846767596880056,2.27801,2.304017531217831,1181999.0,19657933.03333333,2038912.0,14757543.314285714
2024-05-25,2.308,2.364,2.279,2.295,9151890.7,56162.0,4445955.5,2.3223333333333334,2.379757142857143,2.28224,2.3308135823594966,2.348255677324503,2.303674214897136,54.073078139829164,2.5438706709849233,2.0206093290150764,0.03163297477997107,0.01796238635146146,0.013670588428509607,0.08499999999999996,0.19140714285714283,8996196774.489992,0.0383,4.698905109489049,-56.36289555887547,43.637104441124535,47.349359409660934,-0.5632582322356977,2.363,2.411,2.25,2.31,14449272.2,93887.0,6535595.1,-2.24291155311045,53.983418870904075,2.5495470124397475,2.021572987560252,0.03755737811715809,0.014544739244334057,0.023012638872824034,0.16100000000000003,0.19130714285714284,9005348665.189993,0.3080000000000003,4.567470915757554,-54.32568246638597,45.67431753361402,58.37294581013176,2.4034999999999997,2.3666271647189934,2.3772285714285712,2.3660075697660043,2.28556,2.3045872901494664,891161.0,15335369.966666667,1893546.0,13892371.614285713
2024-05-26,2.294,2.328,2.2,2.235,11156821.3,66518.0,4903499.0,2.28,2.3848285714285713,2.275075,2.282906791179748,2.3199417579933774,2.297133813478361,52.604447180118484,2.5334577179735316,2.0166922820264688,0.021844533706334435,0.018738815822436056,0.003105717883898379,0.12799999999999967,0.19409285714285707,8985039953.189993,-0.04760000000000009,3.123702302403908,-64.51174792883337,35.48825207116663,41.599891348635076,-2.5719267654751596,2.308,2.364,2.279,2.295,9151890.7,56162.0,4445955.5,-0.5632582322356977,54.073078139829164,2.5438706709849233,2.0206093290150764,0.03163297477997107,0.01796238635146146,0.013670588428509607,0.08499999999999996,0.19140714285714283,8996196774.489992,0.0383,4.698905109489049,-56.36289555887547,43.637104441124535,47.349359409660934,2.3223333333333334,2.3308135823594966,2.379757142857143,2.348255677324503,2.28224,2.303674214897136,414961.0,9032868.133333333,1791178.0,13368313.942857143
2024-05-27,2.236,2.336,2.221,2.303,15473093.5,87766.0,7550245.1,2.2776666666666663,2.367385714285714,2.27343,2.292953395589874,2.315706318495033,2.297692497908993,56.783502039583006,2.5305982807649494,2.0162617192350503,0.01935108803660457,0.01886127026526976,0.0004898177713348086,0.11499999999999977,0.18780714285714278,9000513046.689993,-0.04369999999999985,8.458133182631622,-55.276381909547744,44.723618090452256,41.28299153424782,2.9964221824686814,2.294,2.328,2.2,2.235,11156821.3,66518.0,4903499.0,-2.5719267654751596,52.604447180118484,2.5334577179735316,2.0166922820264688,0.021844533706334435,0.018738815822436056,0.003105717883898379,0.12799999999999967,0.19409285714285707,8985039953.189993,-0.04760000000000009,3.123702302403908,-64.51174792883337,35.48825207116663,41.599891348635076,2.28,2.282906791179748,2.3848285714285713,2.3199417579933774,2.275075,2.297133813478361,216567.0,5295016.533333333,1736739.0,13161642.314285714
2024-05-28,2.301,2.306,2.1772,2.235,16357746.7,97525.0,7827771.5,2.2576666666666663,2.3255000000000003,2.2775100000000004,2.263976697794937,2.2955297388712745,2.2917217838224224,59.17034005037784,2.5291908664287712,2.0258291335712295,0.011752507092666509,0.01743951763074911,-0.005687010538082602,0.12880000000000003,0.18577857142857135,8984155299.989992,-0.042300000000000004,11.63836163836165,-64.51174792883337,35.48825207116663,38.566707410928515,-2.8683181225554226,2.236,2.336,2.221,2.303,15473093.5,87766.0,7550245.1,2.9964221824686814,56.783502039583006,2.5305982807649494,2.0162617192350503,0.01935108803660457,0.01886127026526976,0.0004898177713348086,0.11499999999999977,0.18780714285714278,9000513046.689993,-0.04369999999999985,8.458133182631622,-55.276381909547744,44.723618090452256,41.28299153424782,2.2776666666666663,2.292953395589874,2.367385714285714,2.315706318495033,2.27343,2.297692497908993,210446.0,5633233.2,1486332.0,11772727.685714286
2024-05-29,2.235,2.347,2.184,2.195,23484733.3,118588.0,11595690.3,2.244333333333333,2.2764285714285712,2.27417,2.229488348897468,2.2703973041534558,2.282510185363144,47.07776830538978,2.5284878541655877,2.019852145834412,0.0024743880386677297,0.014446491712332834,-0.011972103673665104,0.1629999999999998,0.17591428571428563,8960670566.689993,-0.0045000000000001705,-2.7340807373598675,-93.63636363636368,6.36363636363631,28.85850217508508,-1.7897091722595095,2.301,2.306,2.1772,2.235,16357746.7,97525.0,7827771.5,-2.8683181225554226,59.17034005037784,2.5291908664287712,2.0258291335712295,0.011752507092666509,0.01743951763074911,-0.005687010538082602,0.12880000000000003,0.18577857142857135,8984155299.989992,-0.042300000000000004,11.63836163836165,-64.51174792883337,35.48825207116663,38.566707410928515,2.2576666666666663,2.263976697794937,2.3255000000000003,2.2955297388712745,2.2775100000000004,2.2917217838224224,251809.0,6760505.2,1199132.0,10104797.285714285
2024-05-30,2.194,2.295,2.1084,2.184,24137210.2,128217.0,11526218.6,2.2046666666666663,2.251,2.2729150000000002,2.206744174448734,2.2487979781150917,2.273128262947607,45.263259031514224,2.5288276024745246,2.017002397525476,-0.005700484588125221,0.010417096452241224,-0.016117581040366445,0.18659999999999988,0.1764357142857142,8936533356.489992,-0.24109999999999987,-4.319635503373343,-87.43351063829785,12.56648936170215,18.13945926550171,-0.4557885141294342,2.235,2.347,2.184,2.195,23484733.3,118588.0,11595690.3,-1.7897091722595095,47.07776830538978,2.5284878541655877,2.019852145834412,0.0024743880386677297,0.014446491712332834,-0.011972103673665104,0.1629999999999998,0.17591428571428563,8960670566.689993,-0.0045000000000001705,-2.7340807373598675,-93.63636363636368,6.36363636363631,28.85850217508508,2.244333333333333,2.229488348897468,2.2764285714285712,2.2703973041534558,2.27417,2.282510185363144,303879.0,8991235.633333333,785358.0,8425115.757142857
2024-05-31,2.185,2.21,2.066,2.138,16455689.1,87812.0,7822023.4,2.172333333333333,2.2264285714285714,2.270215,2.172372087224367,2.221098483586319,2.2602589045716446,39.79661679867019,2.5308185527083835,2.0096114472916162,-0.01570985220640342,0.005191706720512296,-0.020901558926915715,0.14400000000000013,0.17512857142857133,8920077667.389992,-0.3902000000000001,-8.893339583244552,-88.81987577639751,11.180124223602492,10.036749982980332,-2.1510297482837597,2.194,2.295,2.1084,2.184,24137210.2,128217.0,11526218.6,-0.4557885141294342,45.263259031514224,2.5288276024745246,2.017002397525476,-0.005700484588125221,0.010417096452241224,-0.016117581040366445,0.18659999999999988,0.1764357142857142,8936533356.489992,-0.24109999999999987,-4.319635503373343,-87.43351063829785,12.56648936170215,18.13945926550171,2.2046666666666663,2.206744174448734,2.251,2.2487979781150917,2.2729150000000002,2.273128262947607,344330.0,10316560.133333333,648663.0,7769282.157142857
2024-06-01,2.139,2.147,2.093,2.111,7856994.4,46027.0,3657126.8,2.1443333333333334,2.200142857142857,2.2674,2.1416860436121836,2.1935738626897394,2.2460437708029164,41.5179026828522,2.5338353145551955,2.000964685444804,-0.025526765842303067,-0.000951987792050777,-0.02457477805025229,0.053999999999999826,0.16729999999999987,8912220672.989992,-0.42749999999999977,-7.302507355201316,-93.0124223602484,6.987577639751609,10.244730408352098,-1.3090229079008688,2.185,2.21,2.066,2.138,16455689.1,87812.0,7822023.4,-2.1510297482837597,39.79661679867019,2.5308185527083835,2.0096114472916162,-0.01570985220640342,0.005191706720512296,-0.020901558926915715,0.14400000000000013,0.17512857142857133,8920077667.389992,-0.3902000000000001,-8.893339583244552,-88.81987577639751,11.180124223602492,10.036749982980332,2.172333333333333,2.172372087224367,2.2264285714285714,2.221098483586319,2.270215,2.2602589045716446,334617.0,10314644.1,642588.0,7953057.628571428
2024-06-02,2.11,2.138,2.042,2.085,9529048.7,59891.0,4530036.1,2.111333333333333,2.178714285714286,2.2654799999999997,2.1133430218060916,2.1664303970173044,2.2307062688216863,43.83414108777598,2.5367933639791906,1.994166636020809,-0.035001250704135956,-0.007761840374467813,-0.027239410329668142,0.09600000000000009,0.16499285714285702,8902691624.289991,-0.27700000000000014,-5.20572857467606,-93.56287425149699,6.437125748503014,8.201609203952385,-1.1848341232227448,2.139,2.147,2.093,2.111,7856994.4,46027.0,3657126.8,-1.3090229079008688,41.5179026828522,2.5338353145551955,2.000964685444804,-0.025526765842303067,-0.000951987792050777,-0.02457477805025229,0.053999999999999826,0.16729999999999987,8912220672.989992,-0.42749999999999977,-7.302507355201316,-93.0124223602484,6.987577639751609,10.244730408352098,2.1443333333333334,2.1416860436121836,2.200142857142857,2.1935738626897394,2.2674,2.2460437708029164,262056.0,7668456.266666667,632453.0,7840367.814285713
2024-06-03,2.085,2.196,2.049,2.139,16772182.6,100826.0,8498829.6,2.1116666666666664,2.1552857142857142,2.2723299999999997,2.1261715109030455,2.159572797762978,2.221972338457716,31.100541683181376,2.5216613170948072,2.0229986829051922,-0.03771771319469863,-0.01375301493851398,-0.023964698256184653,0.14700000000000024,0.15554285714285704,8919463806.889992,-0.17100000000000026,-11.797451651478298,-85.47904191616767,14.520958083832328,9.315220490695665,2.5899280575539483,2.11,2.138,2.042,2.085,9529048.7,59891.0,4530036.1,-1.1848341232227448,43.83414108777598,2.5367933639791906,1.994166636020809,-0.035001250704135956,-0.007761840374467813,-0.027239410329668142,0.09600000000000009,0.16499285714285702,8902691624.289991,-0.27700000000000014,-5.20572857467606,-93.56287425149699,6.437125748503014,8.201609203952385,2.111333333333333,2.1133430218060916,2.178714285714286,2.1664303970173044,2.2654799999999997,2.2307062688216863,193730.0,5336395.433333334,625826.0,7787015.971428571
2024-06-04,2.138,2.174,2.079,2.125,13100272.6,91126.0,6218697.1,2.116333333333333,2.1395714285714287,2.265745,2.1255857554515227,2.1509295983222336,2.2127368776522194,19.811320754716974,2.523624445314686,2.007865554685314,-0.04053297340018558,-0.019109006630848302,-0.021423966769337277,0.09499999999999975,0.14869285714285704,8906363534.289991,-0.16999999999999993,-15.948105371410492,-87.57485029940118,12.425149700598826,11.12774451097807,-0.6080449017773574,2.085,2.196,2.049,2.139,16772182.6,100826.0,8498829.6,2.5899280575539483,31.100541683181376,2.5216613170948072,2.0229986829051922,-0.03771771319469863,-0.01375301493851398,-0.023964698256184653,0.14700000000000024,0.15554285714285704,8919463806.889992,-0.17100000000000026,-11.797451651478298,-85.47904191616767,14.520958083832328,9.315220490695665,2.1116666666666664,2.1261715109030455,2.1552857142857142,2.159572797762978,2.2723299999999997,2.221972338457716,206744.0,5561997.499999999,638886.0,7922528.042857143
2024-06-05,2.125,2.221,2.125,2.156,17965963.3,114348.0,8793625.4,2.14,2.134,2.2594149999999997,2.1407928777257617,2.1521971987416753,2.2073333654948653,22.22222222222223,2.521729429845717,1.9971005701542828,-0.03980381289565038,-0.02324796788380872,-0.016555845011841663,0.09600000000000009,0.1387214285714285,8924329497.58999,-0.07899999999999974,-15.067953515855814,-78.0346820809248,21.9653179190752,16.303808567835464,1.4588235294117713,2.138,2.174,2.079,2.125,13100272.6,91126.0,6218697.1,-0.6080449017773574,19.811320754716974,2.523624445314686,2.007865554685314,-0.04053297340018558,-0.019109006630848302,-0.021423966769337277,0.09499999999999975,0.14869285714285704,8906363534.289991,-0.16999999999999993,-15.948105371410492,-87.57485029940118,12.425149700598826,11.12774451097807,2.116333333333333,2.1255857554515227,2.1395714285714287,2.1509295983222336,2.265745,2.2127368776522194,251843.0,6415854.266666666,632487.0,7692660.271428571
2024-06-06,2.156,2.17,2.013,2.044,14994804.3,96593.0,6773744.7,2.108333333333333,2.114,2.2442800000000003,2.092396438862881,2.1251478990562567,2.1917778068763067,24.51923076923076,2.5199784134120375,1.9685815865879628,-0.047713401527189614,-0.0281410546124849,-0.019572346914704716,0.15700000000000003,0.1254571428571428,8909334693.289991,-0.2589999999999999,-13.463166807790007,-92.21105527638188,7.788944723618123,14.059804114430731,-5.194805194805199,2.125,2.221,2.125,2.156,17965963.3,114348.0,8793625.4,1.4588235294117713,22.22222222222223,2.521729429845717,1.9971005701542828,-0.03980381289565038,-0.02324796788380872,-0.016555845011841663,0.09600000000000009,0.1387214285714285,8924329497.58999,-0.07899999999999974,-15.067953515855814,-78.0346820809248,21.9653179190752,16.303808567835464,2.14,2.1407928777257617,2.134,2.1521971987416753,2.2594149999999997,2.2073333654948653,306300.0,7837050.699999999,628247.0,7292365.285714285
2024-06-07,2.043,2.06,1.65,1.849,52672417.3,299105.0,25049094.2,2.0163333333333333,2.072714285714286,2.2228649999999996,1.9706982194314406,2.0561109242921924,2.1591323014595156,19.947848761408082,2.549580580637958,1.8961494193620414,-0.06892218576526465,-0.03629728084304085,-0.03262490492222381,0.41000000000000014,0.1432428571428571,8856662275.989992,-0.3859999999999999,-19.95670995670996,-72.12885154061624,27.871148459383765,19.208470367359045,-9.495839451786596,2.156,2.17,2.013,2.044,14994804.3,96593.0,6773744.7,-5.194805194805199,24.51923076923076,2.5199784134120375,1.9685815865879628,-0.047713401527189614,-0.0281410546124849,-0.019572346914704716,0.15700000000000003,0.1254571428571428,8909334693.289991,-0.2589999999999999,-13.463166807790007,-92.21105527638188,7.788944723618123,14.059804114430731,2.108333333333333,2.092396438862881,2.114,2.1251478990562567,2.2442800000000003,2.1917778068763067,302067.0,7262022.399999999,596623.0,6613440.4428571435
2024-06-08,1.85,1.866,1.7,1.745,22930493.0,136020.0,11166997.2,1.8793333333333333,2.0204285714285715,2.20014,1.8578491097157204,1.9783331932191444,2.1196911298919425,17.87383177570095,2.5906889006379257,1.8095910993620747,-0.09304961289463698,-0.04764774725336007,-0.045401865641276906,0.16600000000000015,0.14902857142857137,8833731782.989992,-0.44999999999999973,-23.965141612200426,-86.37015781922523,13.629842180774776,16.429978454592234,-5.6756756756756745,2.043,2.06,1.65,1.849,52672417.3,299105.0,25049094.2,-9.495839451786596,19.947848761408082,2.549580580637958,1.8961494193620414,-0.06892218576526465,-0.03629728084304085,-0.03262490492222381,0.41000000000000014,0.1432428571428571,8856662275.989992,-0.3859999999999999,-19.95670995670996,-72.12885154061624,27.871148459383765,19.208470367359045,2.0163333333333333,1.9706982194314406,2.072714285714286,2.0561109242921924,2.2228649999999996,2.1591323014595156,510046.0,13538821.433333332,807916.0,9074450.557142857
2024-06-09,1.745,1.774,1.716,1.737,11838881.7,75501.0,5662669.9,1.777,1.9707142857142856,2.165735,1.7974245548578602,1.9179998949143582,2.0832443556165194,19.02985074626865,2.5924057557232993,1.7390642442767013,-0.1115306499573121,-0.06042432779415048,-0.05110632216316162,0.05800000000000005,0.14402857142857142,8821892901.289991,-0.44700000000000006,-22.28187919463086,-87.51793400286941,12.482065997130585,17.99435221242972,-0.45845272206303767,1.85,1.866,1.7,1.745,22930493.0,136020.0,11166997.2,-5.6756756756756745,17.87383177570095,2.5906889006379257,1.8095910993620747,-0.09304961289463698,-0.04764774725336007,-0.045401865641276906,0.16600000000000015,0.14902857142857137,8833731782.989992,-0.44999999999999973,-23.965141612200426,-86.37015781922523,13.629842180774776,16.429978454592234,1.8793333333333333,1.8578491097157204,2.0204285714285715,1.9783331932191444,2.20014,2.1196911298919425,531718.0,14329945.366666667,897909.0,10147289.185714286
2024-06-10,1.738,1.75,1.6283,1.659,24125694.9,150819.0,11506574.7,1.7136666666666667,1.9021428571428571,2.1222749999999997,1.7282122774289301,1.8532499211857687,2.042840131272089,10.442260442260434,2.5700417949185095,1.6745082050814897,-0.13096131261374033,-0.07453172475806846,-0.05642958785567187,0.12169999999999992,0.14450714285714286,8797767206.389992,-0.47899999999999987,-27.963525835866253,-95.72839849728678,4.271601502713226,10.12783656020621,-4.545454545454543,1.745,1.774,1.716,1.737,11838881.7,75501.0,5662669.9,-0.45845272206303767,19.02985074626865,2.5924057557232993,1.7390642442767013,-0.1115306499573121,-0.06042432779415048,-0.05110632216316162,0.05800000000000005,0.14402857142857142,8821892901.289991,-0.44700000000000006,-22.28187919463086,-87.51793400286941,12.482065997130585,17.99435221242972,1.777,1.7974245548578602,1.9707142857142856,1.9179998949143582,2.165735,2.0832443556165194,510626.0,13959587.1,913519.0,10309094.014285713
2024-06-11,1.659,1.719,1.505,1.537,41142782.9,257802.0,19976310.3,1.6443333333333332,1.8181428571428573,2.0721999999999996,1.632606138714465,1.7741874408893266,1.9946648806747473,9.79262672811059,2.547152673542614,1.597247326457385,-0.15442452338314983,-0.09051028448308474,-0.06391423890006509,0.2140000000000002,0.15059285714285717,8756624423.489992,-0.5740000000000003,-31.230425055928414,-96.19952494061758,3.8004750593824257,6.851380853075426,-7.353827606992171,1.738,1.75,1.6283,1.659,24125694.9,150819.0,11506574.7,-4.545454545454543,10.442260442260434,2.5700417949185095,1.6745082050814897,-0.13096131261374033,-0.07453172475806846,-0.05642958785567187,0.12169999999999992,0.14450714285714286,8797767206.389992,-0.47899999999999987,-27.963525835866253,-95.72839849728678,4.271601502713226,10.12783656020621,1.7136666666666667,1.7282122774289301,1.9021428571428571,1.8532499211857687,2.1222749999999997,2.042840131272089,362340.0,9445413.933333332,963512.0,10738771.885714287
2024-06-12,1.536,1.756,1.465,1.717,42462791.6,261557.0,21455753.7,1.6376666666666664,1.7554285714285716,2.03995,1.6748030693572327,1.7598905806669949,1.9682206063247714,26.289682539682545,2.5196180760253992,1.560281923974601,-0.15668858283629827,-0.10374594415372745,-0.05294263868257082,0.2909999999999999,0.15973571428571431,8799087215.089993,-0.3679999999999999,-21.7767653758542,-69.63855421686746,30.361445783132535,12.811174115076076,11.78385416666667,1.659,1.719,1.505,1.537,41142782.9,257802.0,19976310.3,-7.353827606992171,9.79262672811059,2.547152673542614,1.597247326457385,-0.15442452338314983,-0.09051028448308474,-0.06391423890006509,0.2140000000000002,0.15059285714285717,8756624423.489992,-0.5740000000000003,-31.230425055928414,-96.19952494061758,3.8004750593824257,6.851380853075426,1.6443333333333332,1.632606138714465,1.8181428571428573,1.7741874408893266,2.0721999999999996,1.9946648806747473,484122.0,12381851.633333335,1130188.0,12704145.200000001
2024-06-13,1.716,1.73,1.562,1.588,19522282.3,151463.0,9216887.5,1.6139999999999999,1.6902857142857144,2.00385,1.6314015346786164,1.7169179355002462,1.9320091200081264,23.534635879218484,2.506088054270987,1.501611945729013,-0.16696739200516042,-0.11639023372401405,-0.05057715828114637,0.16799999999999993,0.15840714285714289,8779564932.789993,-0.5509999999999997,-27.289377289377292,-83.73015873015873,16.26984126984127,16.810587370785424,-7.4592074592074535,1.536,1.756,1.465,1.717,42462791.6,261557.0,21455753.7,11.78385416666667,26.289682539682545,2.5196180760253992,1.560281923974601,-0.15668858283629827,-0.10374594415372745,-0.05294263868257082,0.2909999999999999,0.15973571428571431,8799087215.089993,-0.3679999999999999,-21.7767653758542,-69.63855421686746,30.361445783132535,12.811174115076076,1.6376666666666664,1.6748030693572327,1.7554285714285716,1.7598905806669949,2.03995,1.9682206063247714,670178.0,17646212.900000002,1277397.0,14513020.671428572
2024-06-14,1.589,1.656,1.388,1.48,29745247.7,222547.0,14248935.3,1.595,1.6375714285714287,1.9631,1.5557007673393082,1.6576884516251846,1.8889606323883048,22.3063973063973,2.4971202637590393,1.4290797362409609,-0.1817332123852642,-0.12945882945626408,-0.05227438292900011,0.268,0.16726428571428573,8749819685.089993,-0.645,-30.77642656688494,-88.95558223289315,11.04441776710685,19.225234940026898,-6.85966016362492,1.716,1.73,1.562,1.588,19522282.3,151463.0,9216887.5,-7.4592074592074535,23.534635879218484,2.506088054270987,1.501611945729013,-0.16696739200516042,-0.11639023372401405,-0.05057715828114637,0.16799999999999993,0.15840714285714289,8779564932.789993,-0.5509999999999997,-27.289377289377292,-83.73015873015873,16.26984126984127,16.810587370785424,1.6139999999999999,1.6314015346786164,1.6902857142857144,1.7169179355002462,2.00385,1.9320091200081264,670822.0,16882983.833333332,1332267.0,14862041.07142857
2024-06-15,1.479,1.508,1.451,1.459,12637417.6,83287.0,6186757.1,1.5089999999999997,1.596714285714286,1.9243000000000001,1.507350383669654,1.6080163387188886,1.8480120007322758,22.41962774957699,2.48712598974892,1.36147401025108,-0.19290605499206603,-0.1421482745634245,-0.05075778042864154,0.05699999999999994,0.16747857142857145,8737182267.489992,-0.6970000000000001,-30.885836096636666,-91.47659063625449,8.523409363745516,11.945889466897894,-1.352265043948615,1.589,1.656,1.388,1.48,29745247.7,222547.0,14248935.3,-6.85966016362492,22.3063973063973,2.4971202637590393,1.4290797362409609,-0.1817332123852642,-0.12945882945626408,-0.05227438292900011,0.268,0.16726428571428573,8749819685.089993,-0.645,-30.77642656688494,-88.95558223289315,11.04441776710685,19.225234940026898,1.595,1.5557007673393082,1.6375714285714287,1.6576884516251846,1.9631,1.8889606323883048,635567.0,14973858.833333334,1255709.0,13319161.22857143
2024-06-16,1.46,1.494,1.424,1.473,10239787.2,75629.0,4942836.6,1.4706666666666666,1.559,1.8828000000000003,1.490175191834827,1.5742622540391664,1.8122965720911068,23.846153846153854,2.450433165456639,1.3151668345433616,-0.19834453788922368,-0.15338752722858434,-0.04495701066063934,0.07000000000000006,0.16562142857142859,8747422054.689993,-0.571,-29.352517985611502,-89.79591836734691,10.20408163265308,9.923969587835163,0.890410958904118,1.479,1.508,1.451,1.459,12637417.6,83287.0,6186757.1,-1.352265043948615,22.41962774957699,2.48712598974892,1.36147401025108,-0.19290605499206603,-0.1421482745634245,-0.05075778042864154,0.05699999999999994,0.16747857142857145,8737182267.489992,-0.6970000000000001,-30.885836096636666,-91.47659063625449,8.523409363745516,11.945889466897894,1.5089999999999997,1.507350383669654,1.596714285714286,1.6080163387188886,1.9243000000000001,1.8480120007322758,457297.0,9884193.300000003,1202976.0,12607698.357142856
2024-06-17,1.473,1.491,1.223,1.319,53278336.1,278920.0,25594905.9,1.4169999999999998,1.5104285714285715,1.8370000000000002,1.4045875959174134,1.5104466905293747,1.765315946177668,17.716535433070888,2.4321307684693796,1.2418692315306208,-0.21263002120877172,-0.16523602602462184,-0.047393995184149884,0.268,0.17426428571428573,8694143718.589993,-0.53,-38.33567087424029,-90.3807615230461,9.619238476953894,9.448909824450844,-10.454854039375434,1.46,1.494,1.424,1.473,10239787.2,75629.0,4942836.6,0.890410958904118,23.846153846153854,2.450433165456639,1.3151668345433616,-0.19834453788922368,-0.15338752722858434,-0.04495701066063934,0.07000000000000006,0.16562142857142859,8747422054.689993,-0.571,-29.352517985611502,-89.79591836734691,10.20408163265308,9.923969587835163,1.4706666666666666,1.490175191834827,1.559,1.5742622540391664,1.8828000000000003,1.8122965720911068,381463.0,8459509.666666668,1203104.0,12504865.028571429
2024-06-18,1.32,1.327,1.104,1.194,51723069.5,267683.0,25376643.9,1.3286666666666667,1.4614285714285715,1.7869500000000003,1.2992937979587067,1.431335017897031,1.7109049036845567,16.292541636495315,2.422318595880835,1.1515814041191652,-0.2313707272715657,-0.17846296627401065,-0.052907760997555064,0.22299999999999986,0.18340714285714288,8642420649.089993,-0.5510000000000002,-43.811764705882354,-91.94270367054612,8.057296329453882,9.2935388130203,-9.545454545454552,1.473,1.491,1.223,1.319,53278336.1,278920.0,25594905.9,-10.454854039375434,17.716535433070888,2.4321307684693796,1.2418692315306208,-0.21263002120877172,-0.16523602602462184,-0.047393995184149884,0.268,0.17426428571428573,8694143718.589993,-0.53,-38.33567087424029,-90.3807615230461,9.619238476953894,9.448909824450844,1.4169999999999998,1.4045875959174134,1.5104285714285715,1.5104466905293747,1.8370000000000002,1.765315946177668,437836.0,12241499.866666667,1331205.0,14517483.77142857
2024-06-19,1.194,1.515,1.175,1.505,67740145.4,350614.0,36337726.0,1.3393333333333333,1.4311428571428573,1.7530000000000001,1.4021468989793533,1.4497512634227732,1.6912949128574561,30.403371462974107,2.371374439452687,1.1346255605473132,-0.2186077963831956,-0.18649193229584765,-0.032115864087347956,0.33999999999999986,0.20083571428571428,8710160794.489992,-0.2320000000000002,-30.19480519480521,-62.38273921200752,37.617260787992485,18.431265198133435,26.046901172529306,1.32,1.327,1.104,1.194,51723069.5,267683.0,25376643.9,-9.545454545454552,16.292541636495315,2.422318595880835,1.1515814041191652,-0.2313707272715657,-0.17846296627401065,-0.052907760997555064,0.22299999999999986,0.18340714285714288,8642420649.089993,-0.5510000000000002,-43.811764705882354,-91.94270367054612,8.057296329453882,9.2935388130203,1.3286666666666667,1.2992937979587067,1.4614285714285715,1.431335017897031,1.7869500000000003,1.7109049036845567,622232.0,18638128.8,1341086.0,15288960.0
2024-06-20,1.505,1.748,1.472,1.608,104603800.1,582075.0,52406764.4,1.4356666666666664,1.434,1.7265000000000001,1.5050734494896767,1.48931344756708,1.683362064013889,36.803874092009686,2.320344388619392,1.132655611380608,-0.19790056795061828,-0.1887736594268018,-0.00912690852381648,0.276,0.20933571428571426,8814764594.589993,-0.050999999999999934,-21.330724070450092,-47.280334728033466,52.719665271966534,32.79807412980431,6.843853820598021,1.194,1.515,1.175,1.505,67740145.4,350614.0,36337726.0,26.046901172529306,30.403371462974107,2.371374439452687,1.1346255605473132,-0.2186077963831956,-0.18649193229584765,-0.032115864087347956,0.33999999999999986,0.20083571428571428,8710160794.489992,-0.2320000000000002,-30.19480519480521,-62.38273921200752,37.617260787992485,18.431265198133435,1.3393333333333333,1.4021468989793533,1.4311428571428573,1.4497512634227732,1.7530000000000001,1.6912949128574561,897217.0,29103091.933333334,1430143.0,17414956.042857144
2024-06-21,1.607,1.633,1.527,1.589,40815523.7,270626.0,18286806.6,1.5673333333333332,1.4495714285714283,1.7003999999999997,1.5470367247448382,1.5142350856753102,1.674375200774471,41.19241192411924,2.2684131206787037,1.1323868793212957,-0.1809373483188199,-0.18720639720520543,0.00626904888638552,0.1060000000000001,0.18762142857142858,8773949070.889992,0.052000000000000046,-14.061654948620872,-36.351706036745426,63.648293963254574,51.32840667440454,-1.120099564405726,1.505,1.748,1.472,1.608,104603800.1,582075.0,52406764.4,6.843853820598021,36.803874092009686,2.320344388619392,1.132655611380608,-0.19790056795061828,-0.1887736594268018,-0.00912690852381648,0.276,0.20933571428571426,8814764594.589993,-0.050999999999999934,-21.330724070450092,-47.280334728033466,52.719665271966534,32.79807412980431,1.4356666666666664,1.5050734494896767,1.434,1.48931344756708,1.7265000000000001,1.683362064013889,1200372.0,38040378.1,1860755.0,23584938.457142856
2024-06-22,1.589,1.59,1.46,1.471,22588581.1,165313.0,10723717.4,1.556,1.451285714285714,1.6697,1.5090183623724192,1.5034263142564828,1.6550061340340452,40.80536912751678,2.216151172759769,1.1232488272402308,-0.1749982178572249,-0.18476476133560932,0.009766543478384404,0.13000000000000012,0.18505,8751360489.789991,-0.246,-15.70200573065903,-45.22388059701492,54.77611940298508,57.04802621273541,-7.426054122089357,1.607,1.633,1.527,1.589,40815523.7,270626.0,18286806.6,-1.120099564405726,41.19241192411924,2.2684131206787037,1.1323868793212957,-0.1809373483188199,-0.18720639720520543,0.00626904888638552,0.1060000000000001,0.18762142857142858,8773949070.889992,0.052000000000000046,-14.061654948620872,-36.351706036745426,63.648293963254574,51.32840667440454,1.5673333333333332,1.5470367247448382,1.4495714285714283,1.5142350856753102,1.7003999999999997,1.674375200774471,1203315.0,35677099.0,1908834.0,24161777.214285713
2024-06-23,1.472,1.526,1.396,1.401,23304431.5,146707.0,11374637.5,1.4869999999999999,1.441,1.6328,1.4550091811862096,1.477819735692362,1.6308150736498503,39.175257731958766,2.1443749057670107,1.1212250942329893,-0.17393481686472478,-0.1825987724414324,0.008663955576707627,0.13000000000000012,0.19019285714285714,8728056058.289991,-0.18700000000000006,-19.34369602763385,-54.447852760736204,45.5521472392638,54.65885353516783,-4.823369565217388,1.589,1.59,1.46,1.471,22588581.1,165313.0,10723717.4,-7.426054122089357,40.80536912751678,2.216151172759769,1.1232488272402308,-0.1749982178572249,-0.18476476133560932,0.009766543478384404,0.13000000000000012,0.18505,8751360489.789991,-0.246,-15.70200573065903,-45.22388059701492,54.77611940298508,57.04802621273541,1.556,1.5090183623724192,1.451285714285714,1.5034263142564828,1.6697,1.6550061340340452,1018014.0,27139096.133333337,1990860.0,24809914.4
2024-06-24,1.401,1.707,1.345,1.633,55696802.8,370143.0,28597469.8,1.5016666666666667,1.4858571428571428,1.6082,1.5440045905931048,1.5166148017692713,1.631023161873674,49.2379835873388,2.0644439790518354,1.1519560209481647,-0.15261238227670115,-0.17660149440848616,0.023989112131785006,0.3620000000000001,0.20735714285714288,8783752861.08999,0.15300000000000002,-1.5672091621458772,-18.86503067484663,81.13496932515338,60.487745322467426,16.55960028551035,1.472,1.526,1.396,1.401,23304431.5,146707.0,11374637.5,-4.823369565217388,39.175257731958766,2.1443749057670107,1.1212250942329893,-0.17393481686472478,-0.1825987724414324,0.008663955576707627,0.13000000000000012,0.19019285714285714,8728056058.289991,-0.18700000000000006,-19.34369602763385,-54.447852760736204,45.5521472392638,54.65885353516783,1.4869999999999999,1.4550091811862096,1.441,1.477819735692362,1.6328,1.6308150736498503,582646.0,13461720.5,2061938.0,25728743.099999998
2024-06-25,1.632,1.715,1.569,1.587,42420286.1,284593.0,21143290.3,1.540333333333333,1.542,1.5797500000000002,1.5655022952965525,1.5342111013269535,1.626830479790467,51.533742331288344,1.9561399853245693,1.203360014675431,-0.1378371143541559,-0.16884861839762014,0.031011504043464228,0.14600000000000013,0.20249999999999999,8741332574.98999,0.1279999999999999,3.25309043591413,-25.920245398773016,74.079754601227,66.92229038854806,-2.7573529411764666,1.401,1.707,1.345,1.633,55696802.8,370143.0,28597469.8,16.55960028551035,49.2379835873388,2.0644439790518354,1.1519560209481647,-0.15261238227670115,-0.17660149440848616,0.023989112131785006,0.3620000000000001,0.20735714285714288,8783752861.08999,0.15300000000000002,-1.5672091621458772,-18.86503067484663,81.13496932515338,60.487745322467426,1.5016666666666667,1.5440045905931048,1.4858571428571428,1.5166148017692713,1.6082,1.631023161873674,682163.0,16898608.233333334,2153161.0,26157680.8
2024-06-26,1.588,1.86,1.582,1.773,56727953.9,385980.0,28475990.9,1.6643333333333332,1.5802857142857143,1.5662,1.6692511476482763,1.5939083259952151,1.640751386477089,51.71149144254277,1.8877342168907942,1.2446657831092058,-0.10985264957889518,-0.15704942463387517,0.04719677505497999,0.278,0.20157142857142857,8798060528.88999,0.2999999999999998,3.2615026208503206,-11.507936507936533,88.49206349206347,81.23559580614796,11.649874055415605,1.632,1.715,1.569,1.587,42420286.1,284593.0,21143290.3,-2.7573529411764666,51.533742331288344,1.9561399853245693,1.203360014675431,-0.1378371143541559,-0.16884861839762014,0.031011504043464228,0.14600000000000013,0.20249999999999999,8741332574.98999,0.1279999999999999,3.25309043591413,-25.920245398773016,74.079754601227,66.92229038854806,1.540333333333333,1.5655022952965525,1.542,1.5342111013269535,1.5797500000000002,1.626830479790467,801443.0,20371799.200000003,2170071.0,25552916.000000004
2024-06-27,1.772,1.784,1.492,1.546,67587506.2,407474.0,32511070.9,1.6353333333333333,1.5714285714285714,1.55105,1.607625573824138,1.5819312444964113,1.6317274449078425,48.78892733564014,1.8437387874787594,1.2583612125212407,-0.10478387917572607,-0.14659631554224536,0.041812436366519296,0.29200000000000004,0.21042857142857146,8730473022.68999,0.2270000000000001,-2.6448362720403074,-41.53439153439154,58.465608465608454,73.67914218629966,-12.75395033860045,1.588,1.86,1.582,1.773,56727953.9,385980.0,28475990.9,11.649874055415605,51.71149144254277,1.8877342168907942,1.2446657831092058,-0.10985264957889518,-0.15704942463387517,0.04719677505497999,0.278,0.20157142857142857,8798060528.88999,0.2999999999999998,3.2615026208503206,-11.507936507936533,88.49206349206347,81.23559580614796,1.6643333333333332,1.6692511476482763,1.5802857142857143,1.5939083259952151,1.5662,1.640751386477089,1040716.0,26072250.333333332,2205437.0,24429810.985714283
2024-06-28,1.545,1.56,1.386,1.41,45725612.4,278218.0,22398461.2,1.5763333333333331,1.545857142857143,1.5343,1.508812786912069,1.5389484333723085,1.61061054539281,48.01362088535755,1.8184734829660378,1.2501265170339622,-0.11046750488064205,-0.1393705534099247,0.02890304852928266,0.17400000000000015,0.20371428571428574,8684747410.28999,0.21599999999999997,-4.729729729729737,-59.52380952380955,40.47619047619045,62.47795414462081,-8.737864077669903,1.772,1.784,1.492,1.546,67587506.2,407474.0,32511070.9,-12.75395033860045,48.78892733564014,1.8437387874787594,1.2583612125212407,-0.10478387917572607,-0.14659631554224536,0.041812436366519296,0.29200000000000004,0.21042857142857146,8730473022.68999,0.2270000000000001,-2.6448362720403074,-41.53439153439154,58.465608465608454,73.67914218629966,1.6353333333333333,1.607625573824138,1.5714285714285714,1.5819312444964113,1.55105,1.6317274449078425,1078047.0,27376784.03333333,2030836.0,21587569.057142857
2024-06-29,1.409,1.449,1.343,1.346,22665075.9,123541.0,11450694.7,1.434,1.5280000000000002,1.51475,1.4274063934560346,1.4907113250292314,1.5854095410696851,46.86980609418283,1.7939630859548257,1.2355369140451744,-0.11876701214368857,-0.13524984515667748,0.016482833012988918,0.1060000000000001,0.20721428571428577,8662082334.38999,-0.1589999999999998,-7.7450308430431765,-67.98941798941799,32.01058201058201,43.65079365079365,-4.4712562100780655,1.545,1.56,1.386,1.41,45725612.4,278218.0,22398461.2,-8.737864077669903,48.01362088535755,1.8184734829660378,1.2501265170339622,-0.11046750488064205,-0.1393705534099247,0.02890304852928266,0.17400000000000015,0.20371428571428574,8684747410.28999,0.21599999999999997,-4.729729729729737,-59.52380952380955,40.47619047619045,62.47795414462081,1.5763333333333331,1.508812786912069,1.545857142857143,1.5389484333723085,1.5343,1.61061054539281,1071672.0,27795174.333333332,2038428.0,22174948.285714287
2024-06-30,1.346,1.457,1.324,1.431,34481485.1,216029.0,17139460.8,1.3956666666666664,1.5322857142857145,1.50335,1.4292031967280172,1.4757834937719236,1.5707038704916199,48.88059701492537,1.7763129047479098,1.2303870952520901,-0.11713537809458074,-0.13162695174425815,0.014491573649677403,0.133,0.21171428571428577,8696563819.48999,-0.17700000000000005,-2.851323828920571,-56.746031746031754,43.25396825396825,38.580246913580254,6.315007429420502,1.409,1.449,1.343,1.346,22665075.9,123541.0,11450694.7,-4.4712562100780655,46.86980609418283,1.7939630859548257,1.2355369140451744,-0.11876701214368857,-0.13524984515667748,0.016482833012988918,0.1060000000000001,0.20721428571428577,8662082334.38999,-0.1589999999999998,-7.7450308430431765,-67.98941798941799,32.01058201058201,43.65079365079365,1.434,1.4274063934560346,1.5280000000000002,1.4907113250292314,1.51475,1.5854095410696851,809233.0,22120075.599999998,1996656.0,22278802.185714282
2024-07-01,1.431,1.5,1.288,1.296,33839925.2,224788.0,16219885.6,1.3576666666666666,1.484142857142857,1.4913,1.3626015983640087,1.4308376203289428,1.5445415971114655,49.380721593968765,1.7788940852916344,1.2037059147083657,-0.12529138699519904,-0.13035983879444635,0.005068451799247309,0.21199999999999997,0.20771428571428574,8662723894.28999,-0.2929999999999999,-1.74374526156178,-74.60317460317462,25.39682539682539,33.553791887125236,-9.433962264150944,1.346,1.457,1.324,1.431,34481485.1,216029.0,17139460.8,6.315007429420502,48.88059701492537,1.7763129047479098,1.2303870952520901,-0.11713537809458074,-0.13162695174425815,0.014491573649677403,0.133,0.21171428571428577,8696563819.48999,-0.17700000000000005,-2.851323828920571,-56.746031746031754,43.25396825396825,38.580246913580254,1.3956666666666664,1.4292031967280172,1.5322857142857145,1.4757834937719236,1.50335,1.5707038704916199,617788.0,16996205.566666666,2065978.0,23102348.37142857
2024-07-02,1.295,1.37,1.257,1.32,24493490.6,161604.0,12661265.3,1.349,1.446,1.4714500000000001,1.3413007991820045,1.4031282152467073,1.5231566831008498,53.5876993166287,1.7480446873181517,1.1948553126818486,-0.12833907047009685,-0.12995568512957645,0.0016166146594795983,0.11300000000000021,0.19985714285714293,8687217384.88999,-0.15100000000000002,10.552763819095489,-78.83211678832117,21.167883211678834,29.939558954157505,1.9305019305019409,1.431,1.5,1.288,1.296,33839925.2,224788.0,16219885.6,-9.433962264150944,49.380721593968765,1.7788940852916344,1.2037059147083657,-0.12529138699519904,-0.13035983879444635,0.005068451799247309,0.21199999999999997,0.20771428571428574,8662723894.28999,-0.2929999999999999,-1.74374526156178,-74.60317460317462,25.39682539682539,33.553791887125236,1.3576666666666666,1.3626015983640087,1.484142857142857,1.4308376203289428,1.4913,1.5445415971114655,564358.0,14936680.366666667,1920623.0,21334122.057142857
2024-07-03,1.321,1.331,1.216,1.251,31543966.5,182906.0,15913852.1,1.289,1.3714285714285717,1.4546,1.2961503995910022,1.3650961614350305,1.497236998996007,41.611624834874505,1.7421423264037454,1.1670576735962543,-0.13476857666302156,-0.13091826343626548,-0.0038503132267560802,0.11499999999999999,0.18378571428571436,8655673418.38999,-0.15000000000000013,-16.877076411960136,-94.56521739130436,5.434782608695639,17.333163739066634,-5.2990158970476955,1.295,1.37,1.257,1.32,24493490.6,161604.0,12661265.3,1.9305019305019409,53.5876993166287,1.7480446873181517,1.1948553126818486,-0.12833907047009685,-0.12995568512957645,0.0016166146594795983,0.11300000000000021,0.19985714285714293,8687217384.88999,-0.15100000000000002,10.552763819095489,-78.83211678832117,21.167883211678834,29.939558954157505,1.349,1.3413007991820045,1.446,1.4031282152467073,1.4714500000000001,1.5231566831008498,602421.0,15340203.9,1797634.0,20122404.2
2024-07-04,1.251,1.294,1.157,1.231,39448223.1,197363.0,18848228.2,1.2673333333333332,1.3264285714285715,1.44215,1.2635751997955011,1.331572121076273,1.4718810943297205,36.82739343116701,1.7461529605118897,1.1381470394881104,-0.13986555642485143,-0.13270772203398268,-0.007157834390868756,0.137,0.17385714285714293,8616225195.28999,-0.4019999999999999,-23.44527363184079,-89.4736842105263,10.526315789473692,12.376327203282736,-1.5987210231814386,1.321,1.331,1.216,1.251,31543966.5,182906.0,15913852.1,-5.2990158970476955,41.611624834874505,1.7421423264037454,1.1670576735962543,-0.13476857666302156,-0.13091826343626548,-0.0038503132267560802,0.11499999999999999,0.18378571428571436,8655673418.38999,-0.15000000000000013,-16.877076411960136,-94.56521739130436,5.434782608695639,17.333163739066634,1.289,1.2961503995910022,1.3714285714285717,1.3650961614350305,1.4546,1.497236998996007,569298.0,14931667.666666666,1594560.0,18327812.942857143
2024-07-05,1.231,1.232,1.054,1.163,64619162.5,297200.0,31388703.1,1.2149999999999999,1.2911428571428571,1.4273500000000001,1.2132875998977506,1.2894290908072048,1.4424638472506996,35.60810810810811,1.7557414704963117,1.0989585295036886,-0.14768950858668561,-0.13570407934452328,-0.011985429242162338,0.17799999999999994,0.17900000000000005,8551606032.789989,-0.42399999999999993,-26.809314033983632,-86.47642679900744,13.523573200992553,9.82822386638731,-5.5239642567018725,1.251,1.294,1.157,1.231,39448223.1,197363.0,18848228.2,-1.5987210231814386,36.82739343116701,1.7461529605118897,1.1381470394881104,-0.13986555642485143,-0.13270772203398268,-0.007157834390868756,0.137,0.17385714285714293,8616225195.28999,-0.4019999999999999,-23.44527363184079,-89.4736842105263,10.526315789473692,12.376327203282736,1.2673333333333332,1.2635751997955011,1.3264285714285715,1.331572121076273,1.44215,1.4718810943297205,541873.0,15807781.866666665,1384449.0,16375978.271428572
2024-07-06,1.163,1.286,1.143,1.229,37974884.5,174975.0,19384912.2,1.2076666666666667,1.2744285714285712,1.4151500000000001,1.2211437999488752,1.2743218181054037,1.4221339570363474,41.5266106442577,1.7543523305530555,1.0759476694469448,-0.14687135704867305,-0.13793753488535324,-0.00893382216331981,0.14300000000000002,0.1799285714285715,8589580917.289989,-0.5439999999999998,-16.451393609789257,-78.287841191067,21.712158808933008,15.254015933133099,5.674978503869308,1.231,1.232,1.054,1.163,64619162.5,297200.0,31388703.1,-5.5239642567018725,35.60810810810811,1.7557414704963117,1.0989585295036886,-0.14768950858668561,-0.13570407934452328,-0.011985429242162338,0.17799999999999994,0.17900000000000005,8551606032.789989,-0.42399999999999993,-26.809314033983632,-86.47642679900744,13.523573200992553,9.82822386638731,1.2149999999999999,1.2132875998977506,1.2911428571428571,1.2894290908072048,1.4273500000000001,1.4424638472506996,677469.0,22050261.133333337,1403431.0,17660298.542857144
2024-07-07,1.23,1.24,1.107,1.115,28420717.9,132315.0,13507362.9,1.1689999999999998,1.2292857142857143,1.40495,1.1680718999744375,1.2344913635790529,1.3928831039852667,40.285326086956516,1.7677725461571985,1.0421274538428014,-0.15365062456676948,-0.1410801528216365,-0.012570471745132983,0.133,0.1801428571428572,8561160199.38999,-0.43100000000000005,-20.413990007137762,-92.4317617866005,7.568238213399496,14.267990074441698,-9.34959349593496,1.163,1.286,1.143,1.229,37974884.5,174975.0,19384912.2,5.674978503869308,41.5266106442577,1.7543523305530555,1.0759476694469448,-0.14687135704867305,-0.13793753488535324,-0.00893382216331981,0.14300000000000002,0.1799285714285715,8589580917.289989,-0.5439999999999998,-16.451393609789257,-78.287841191067,21.712158808933008,15.254015933133099,1.2076666666666667,1.2211437999488752,1.2744285714285712,1.2743218181054037,1.4151500000000001,1.4221339570363474,669538.0,23207281.166666668,1454865.0,18793758.185714286
2024-07-08,1.114,1.25,1.057,1.158,51046550.5,228732.0,25854207.2,1.1673333333333333,1.2095714285714287,1.40315,1.1630359499872187,1.2153685226842896,1.3705132845580985,31.488698363211213,1.7707053807179665,1.0355946192820333,-0.1537808127981355,-0.14362028481693628,-0.010160527981199208,0.19300000000000006,0.16807142857142862,8612206749.88999,-0.252,-29.087568891610537,-87.0967741935484,12.903225806451596,14.061207609594716,3.9497307001795163,1.23,1.24,1.107,1.115,28420717.9,132315.0,13507362.9,-9.34959349593496,40.285326086956516,1.7677725461571985,1.0421274538428014,-0.15365062456676948,-0.1410801528216365,-0.012570471745132983,0.133,0.1801428571428572,8561160199.38999,-0.43100000000000005,-20.413990007137762,-92.4317617866005,7.568238213399496,14.267990074441698,1.1689999999999998,1.1680718999744375,1.2292857142857143,1.2344913635790529,1.40495,1.3928831039852667,604490.0,21426992.73333333,1371151.0,18274887.057142857
2024-07-09,1.158,1.213,1.133,1.204,26222467.7,115669.0,12768777.1,1.1589999999999998,1.1929999999999998,1.3881000000000001,1.1835179749936093,1.2125263920132172,1.3546548765049462,35.074045206547154,1.7626784437555207,1.0135215562444795,-0.14846080856005317,-0.14458838956555967,-0.003872418994493504,0.08000000000000007,0.16335714285714292,8638429217.58999,-0.14200000000000013,-24.13358538122243,-81.38957816377173,18.610421836228277,13.027295285359804,3.9723661485319557,1.114,1.25,1.057,1.158,51046550.5,228732.0,25854207.2,3.9497307001795163,31.488698363211213,1.7707053807179665,1.0355946192820333,-0.1537808127981355,-0.14362028481693628,-0.010160527981199208,0.19300000000000006,0.16807142857142862,8612206749.88999,-0.252,-29.087568891610537,-87.0967741935484,12.903225806451596,14.061207609594716,1.1673333333333333,1.1630359499872187,1.2095714285714287,1.2153685226842896,1.40315,1.3705132845580985,536022.0,19582160.766666666,1375095.0,19651218.714285713
2024-07-10,1.205,1.243,1.175,1.193,33468465.2,123095.0,16875156.5,1.1849999999999998,1.1847142857142856,1.36735,1.1882589874968046,1.207644794009913,1.3392591739806656,23.826714801444055,1.7365780852635129,0.9981219147364874,-0.1434783458828086,-0.14436638082900946,0.0008880349462008497,0.06800000000000006,0.1483571428571429,8604960752.38999,-0.238,-32.712915961646914,-80.95890410958904,19.04109589041096,16.851581177696957,-0.9958506224066398,1.158,1.213,1.133,1.204,26222467.7,115669.0,12768777.1,3.9723661485319557,35.074045206547154,1.7626784437555207,1.0135215562444795,-0.14846080856005317,-0.14458838956555967,-0.003872418994493504,0.08000000000000007,0.16335714285714292,8638429217.58999,-0.14200000000000013,-24.13358538122243,-81.38957816377173,18.610421836228277,13.027295285359804,1.1589999999999998,1.1835179749936093,1.1929999999999998,1.2125263920132172,1.3881000000000001,1.3546548765049462,476716.0,17376782.4,1329160.0,19666577.54285714
2024-07-11,1.194,1.236,1.137,1.147,27583871.5,121514.0,13365076.5,1.1813333333333331,1.1727142857142856,1.34525,1.1676294937484024,1.1924835955074349,1.3209487764586973,28.47896440129449,1.7115175898416508,0.9789824101583493,-0.14160914183787,-0.14381493303078158,0.002205791192911588,0.09899999999999998,0.1345714285714286,8577376880.88999,-0.14900000000000002,-25.808538163001295,-81.6205533596838,18.3794466403162,18.676988122318495,-3.936348408710212,1.205,1.243,1.175,1.193,33468465.2,123095.0,16875156.5,-0.9958506224066398,23.826714801444055,1.7365780852635129,0.9981219147364874,-0.1434783458828086,-0.14436638082900946,0.0008880349462008497,0.06800000000000006,0.1483571428571429,8604960752.38999,-0.238,-32.712915961646914,-80.95890410958904,19.04109589041096,16.851581177696957,1.1849999999999998,1.1882589874968046,1.1847142857142856,1.207644794009913,1.36735,1.3392591739806656,467496.0,18499380.266666666,1269349.0,19803906.74285714
2024-07-12,1.146,1.192,1.101,1.189,25895076.3,111472.0,12880200.5,1.1763333333333332,1.1764285714285714,1.33115,1.1783147468742012,1.1916126966305762,1.3083822263197737,36.734693877551024,1.6987443273143297,0.9635556726856704,-0.13518045898969433,-0.14208803822256413,0.006907579232869804,0.09099999999999997,0.1286428571428572,8603271957.18999,-0.131,-15.673758865248221,-69.73094170403587,30.26905829596413,22.563200275563776,3.752181500872614,1.194,1.236,1.137,1.147,27583871.5,121514.0,13365076.5,-3.936348408710212,28.47896440129449,1.7115175898416508,0.9789824101583493,-0.14160914183787,-0.14381493303078158,0.002205791192911588,0.09899999999999998,0.1345714285714286,8577376880.88999,-0.14900000000000002,-25.808538163001295,-81.6205533596838,18.3794466403162,18.676988122318495,1.1813333333333331,1.1676294937484024,1.1727142857142856,1.1924835955074349,1.34525,1.3209487764586973,360278.0,14336336.700000001,1193500.0,19020599.35714286
2024-07-13,1.19,1.218,1.137,1.165,18021818.8,76660.0,8778358.8,1.1669999999999998,1.1672857142857143,1.31935,1.1716573734371005,1.1849595224729321,1.294726776194081,38.58764186633039,1.6926111756708,0.9460888243291999,-0.130517753521868,-0.1397739812824249,0.009256227760556901,0.08099999999999996,0.12685714285714286,8585250138.389989,-0.08599999999999985,-13.447251114413083,-75.11210762331838,24.887892376681613,24.512132437653992,-2.1008403361344463,1.146,1.192,1.101,1.189,25895076.3,111472.0,12880200.5,3.752181500872614,36.734693877551024,1.6987443273143297,0.9635556726856704,-0.13518045898969433,-0.14208803822256413,0.006907579232869804,0.09099999999999997,0.1286428571428572,8603271957.18999,-0.131,-15.673758865248221,-69.73094170403587,30.26905829596413,22.563200275563776,1.1763333333333332,1.1783147468742012,1.1764285714285714,1.1916126966305762,1.33115,1.3083822263197737,356081.0,14373477.833333334,1007772.0,16376527.557142857
2024-07-14,1.164,1.269,1.164,1.247,28365717.1,116101.0,14491793.4,1.2003333333333333,1.1861428571428572,1.30005,1.2093286867185502,1.2004696418546992,1.290181368937502,38.354430379746844,1.6437747828070866,0.9563252171929133,-0.11883594435451861,-0.13558637389684366,0.016750429542325057,0.10499999999999998,0.12485714285714287,8613615855.489988,0.016000000000000014,-12.858141160027948,-56.726457399103126,43.27354260089688,32.81016442451422,7.130584192439879,1.19,1.218,1.137,1.165,18021818.8,76660.0,8778358.8,-2.1008403361344463,38.58764186633039,1.6926111756708,0.9460888243291999,-0.130517753521868,-0.1397739812824249,0.009256227760556901,0.08099999999999996,0.12685714285714286,8585250138.389989,-0.08599999999999985,-13.447251114413083,-75.11210762331838,24.887892376681613,24.512132437653992,1.1669999999999998,1.1716573734371005,1.1672857142857143,1.1849595224729321,1.31935,1.294726776194081,309646.0,11674545.266666666,909457.0,14861305.642857144
2024-07-15,1.247,1.438,1.238,1.421,56030443.5,242975.0,28716927.9,1.2776666666666667,1.2237142857142858,1.29175,1.315164343359275,1.2556022313910244,1.3026402861815494,57.53920386007238,1.6136220733131976,0.9698779266868023,-0.09444893210825289,-0.1273588855391255,0.03290995343087261,0.19999999999999996,0.12400000000000001,8669646298.989988,0.258,9.645061728395055,-4.427083333333309,95.57291666666669,54.57811721474841,13.953488372093018,1.164,1.269,1.164,1.247,28365717.1,116101.0,14491793.4,7.130584192439879,38.354430379746844,1.6437747828070866,0.9563252171929133,-0.11883594435451861,-0.13558637389684366,0.016750429542325057,0.10499999999999998,0.12485714285714287,8613615855.489988,0.016000000000000014,-12.858141160027948,-56.726457399103126,43.27354260089688,32.81016442451422,1.2003333333333333,1.2093286867185502,1.1861428571428572,1.2004696418546992,1.30005,1.290181368937502,304233.0,12050117.566666668,893243.0,15001938.57142857
2024-07-16,1.421,1.49,1.314,1.43,56246780.4,289687.0,27490231.1,1.3659999999999999,1.256,1.2746,1.3725821716796376,1.2992016735432683,1.3147697827356875,56.756756756756744,1.514659992501851,1.034540007498149,-0.07354800875738099,-0.1165967101827766,0.043048701425395616,0.17599999999999993,0.1285,8725893079.389988,0.20099999999999985,8.333333333333325,-13.761467889908271,86.23853211009173,75.02833045921845,0.6333567909922516,1.247,1.438,1.238,1.421,56030443.5,242975.0,28716927.9,13.953488372093018,57.53920386007238,1.6136220733131976,0.9698779266868023,-0.09444893210825289,-0.1273588855391255,0.03290995343087261,0.19999999999999996,0.12400000000000001,8669646298.989988,0.258,9.645061728395055,-4.427083333333309,95.57291666666669,54.57811721474841,1.2776666666666667,1.315164343359275,1.2237142857142858,1.2556022313910244,1.29175,1.3026402861815494,435736.0,17329026.7,907486.0,15410898.671428574
2024-07-17,1.43,1.556,1.417,1.453,54877743.6,258284.0,26464575.6,1.4346666666666665,1.2931428571428571,1.2699500000000001,1.4127910858398187,1.3376512551574513,1.3279345653322885,63.15104166666668,1.4907013247262848,1.0491986752737155,-0.054499729678978426,-0.10417731408201697,0.049677584403038544,0.139,0.1302142857142857,8780770822.989988,0.3380000000000001,16.147082334132712,-20.517928286852584,79.48207171314742,87.09784016330195,1.6083916083916177,1.421,1.49,1.314,1.43,56246780.4,289687.0,27490231.1,0.6333567909922516,56.756756756756744,1.514659992501851,1.034540007498149,-0.07354800875738099,-0.1165967101827766,0.043048701425395616,0.17599999999999993,0.1285,8725893079.389988,0.20099999999999985,8.333333333333325,-13.761467889908271,86.23853211009173,75.02833045921845,1.3659999999999999,1.3725821716796376,1.256,1.2992016735432683,1.2746,1.3147697827356875,648763.0,23566317.46666667,1081504.0,17513963.52857143
2024-07-18,1.453,1.501,1.37,1.404,31922696.3,164523.0,15725103.7,1.4289999999999996,1.3298571428571428,1.26965,1.4083955429199093,1.3542384413680884,1.335178892443499,60.853199498117924,1.4896148536518818,1.049685146348118,-0.04286361667249228,-0.09191457460011204,0.049050957927619765,0.13099999999999978,0.12978571428571425,8748848126.68999,0.246,14.05361494719739,-30.278884462151424,69.72111553784858,78.48057312036259,-3.3723331039229287,1.43,1.556,1.417,1.453,54877743.6,258284.0,26464575.6,1.6083916083916177,63.15104166666668,1.4907013247262848,1.0491986752737155,-0.054499729678978426,-0.10417731408201697,0.049677584403038544,0.139,0.1302142857142857,8780770822.989988,0.3380000000000001,16.147082334132712,-20.517928286852584,79.48207171314742,87.09784016330195,1.4346666666666665,1.4127910858398187,1.2931428571428571,1.3376512551574513,1.2699500000000001,1.3279345653322885,790946.0,27557244.866666663,1216693.0,18883880.542857144
2024-07-19,1.403,1.495,1.362,1.472,32836942.6,161210.0,16278659.2,1.4429999999999998,1.3702857142857143,1.27595,1.4401977714599545,1.3836788310260664,1.3482094741155468,69.38519447929735,1.5117683734638727,1.0401316265361271,-0.02783402822954728,-0.0790984653259991,0.051264437096451815,0.133,0.12657142857142856,8781685069.28999,0.268,26.56921754084265,-16.83366733466935,83.16633266533066,77.45650663877556,4.9180327868852425,1.453,1.501,1.37,1.404,31922696.3,164523.0,15725103.7,-3.3723331039229287,60.853199498117924,1.4896148536518818,1.049685146348118,-0.04286361667249228,-0.09191457460011204,0.049050957927619765,0.13099999999999978,0.12978571428571425,8748848126.68999,0.246,14.05361494719739,-30.278884462151424,69.72111553784858,78.48057312036259,1.4289999999999996,1.4083955429199093,1.3298571428571428,1.3542384413680884,1.26965,1.335178892443499,712494.0,23226636.8,1259702.0,19221027.285714287
2024-07-20,1.473,1.509,1.427,1.46,20461711.1,102665.0,10130286.1,1.4453333333333331,1.4124285714285716,1.2773999999999999,1.4500988857299772,1.4027591232695498,1.3588561908664472,65.5450874831763,1.5175494271665242,1.0372505728334755,-0.016698777703256562,-0.0666185278014506,0.049919750098194035,0.08199999999999985,0.12221428571428568,8761223358.18999,0.2669999999999999,18.795768917819355,-19.238476953907828,80.76152304609218,77.88299041642382,-0.8825526137135182,1.403,1.495,1.362,1.472,32836942.6,161210.0,16278659.2,4.9180327868852425,69.38519447929735,1.5117683734638727,1.0401316265361271,-0.02783402822954728,-0.0790984653259991,0.051264437096451815,0.133,0.12657142857142856,8781685069.28999,0.268,26.56921754084265,-16.83366733466935,83.16633266533066,77.45650663877556,1.4429999999999998,1.4401977714599545,1.3702857142857143,1.3836788310260664,1.27595,1.3482094741155468,584017.0,19489446.166666668,1309440.0,19706521.385714285
2024-07-21,1.46,1.493,1.372,1.49,29375167.6,137435.0,14742974.0,1.4739999999999995,1.4471428571428573,1.2871000000000001,1.4700494428649886,1.4245693424521624,1.3713460774505952,78.45220030349012,1.5453988069740152,1.028801193025985,-0.005391116718803657,-0.05437304558492121,0.048981928866117554,0.121,0.12135714285714282,8790598525.78999,0.34299999999999997,33.632286995515706,-13.22645290581163,86.77354709418836,83.56713426853707,2.054794520547947,1.473,1.509,1.427,1.46,20461711.1,102665.0,10130286.1,-0.8825526137135182,65.5450874831763,1.5175494271665242,1.0372505728334755,-0.016698777703256562,-0.0666185278014506,0.049919750098194035,0.08199999999999985,0.12221428571428568,8761223358.18999,0.2669999999999999,18.795768917819355,-19.238476953907828,80.76152304609218,77.88299041642382,1.4453333333333331,1.4500988857299772,1.4124285714285716,1.4027591232695498,1.2773999999999999,1.3588561908664472,428398.0,14044683.0,1335445.0,19899653.85714286
2024-07-22,1.489,1.499,1.365,1.37,24059933.6,111292.0,11172378.4,1.4400000000000002,1.439857142857143,1.2895999999999999,1.4200247214324944,1.4109270068391218,1.3712178795981576,64.40217391304348,1.5501972088552503,1.0290027911447495,-0.006043050514815684,-0.044707046570900105,0.03866399605608442,0.13400000000000012,0.11714285714285712,8766538592.18999,0.18100000000000005,18.307426597582065,-40.87912087912086,59.120879120879145,75.55198308705324,-7.99194089993284,1.46,1.493,1.372,1.49,29375167.6,137435.0,14742974.0,2.054794520547947,78.45220030349012,1.5453988069740152,1.028801193025985,-0.005391116718803657,-0.05437304558492121,0.048981928866117554,0.121,0.12135714285714282,8790598525.78999,0.34299999999999997,33.632286995515706,-13.22645290581163,86.77354709418836,83.56713426853707,1.4739999999999995,1.4700494428649886,1.4471428571428573,1.4245693424521624,1.2871000000000001,1.3713460774505952,401310.0,13717306.433333332,1356779.0,19935536.8
2024-07-23,1.37,1.4,1.273,1.29,35531697.6,128196.0,16803227.1,1.3833333333333335,1.419857142857143,1.2915500000000002,1.3550123607162472,1.3806952551293412,1.363482843445952,55.58441558441559,1.5515139448684532,1.0315860551315472,-0.012866724565653742,-0.038338982169850835,0.025472257604197093,0.127,0.12049999999999995,8731006894.589989,0.125,7.14285714285714,-58.46153846153845,41.53846153846155,62.47762925117636,-5.839416058394165,1.489,1.499,1.365,1.37,24059933.6,111292.0,11172378.4,-7.99194089993284,64.40217391304348,1.5501972088552503,1.0290027911447495,-0.006043050514815684,-0.044707046570900105,0.03866399605608442,0.13400000000000012,0.11714285714285712,8766538592.18999,0.18100000000000005,18.307426597582065,-40.87912087912086,59.120879120879145,75.55198308705324,1.4400000000000002,1.4200247214324944,1.439857142857143,1.4109270068391218,1.2895999999999999,1.3712178795981576,351392.0,12015212.833333334,1225096.0,17429172.585714284
2024-07-24,1.289,1.305,1.198,1.214,27241976.2,101907.0,13154810.6,1.2913333333333332,1.385714285714286,1.2907,1.2845061803581235,1.3390214413470058,1.349246382165385,51.25748502994011,1.5516070009752208,1.0297929990247792,-0.024128956661715772,-0.03549697706822382,0.011368020406508049,0.10699999999999998,0.12328571428571425,8703764918.389988,-0.03300000000000014,1.7602682313495377,-75.16483516483518,24.83516483516483,41.83150183150185,-5.818463925523658,1.37,1.4,1.273,1.29,35531697.6,128196.0,16803227.1,-5.839416058394165,55.58441558441559,1.5515139448684532,1.0315860551315472,-0.012866724565653742,-0.038338982169850835,0.025472257604197093,0.127,0.12049999999999995,8731006894.589989,0.125,7.14285714285714,-58.46153846153845,41.53846153846155,62.47762925117636,1.3833333333333335,1.3550123607162472,1.419857142857143,1.3806952551293412,1.2915500000000002,1.363482843445952,376923.0,14239526.5,1063605.0,15902457.728571428
2024-07-25,1.213,1.222,1.15,1.198,29166912.5,111091.0,14314099.5,1.2339999999999998,1.3562857142857143,1.29245,1.2412530901790617,1.3037660810102545,1.3348419648163008,53.16770186335403,1.5502009814162534,1.0346990185837468,-0.03395402218812671,-0.0351883860922044,0.00123436390407769,0.07200000000000006,0.12135714285714284,8674598005.889988,-0.2230000000000001,4.446381865736693,-78.68131868131869,21.31868131868131,29.230769230769244,-1.2366034624897053,1.289,1.305,1.198,1.214,27241976.2,101907.0,13154810.6,-5.818463925523658,51.25748502994011,1.5516070009752208,1.0297929990247792,-0.024128956661715772,-0.03549697706822382,0.011368020406508049,0.10699999999999998,0.12328571428571425,8703764918.389988,-0.03300000000000014,1.7602682313495377,-75.16483516483518,24.83516483516483,41.83150183150185,1.2913333333333332,1.2845061803581235,1.385714285714286,1.3390214413470058,1.2907,1.349246382165385,341395.0,13710138.700000001,907228.0,14001062.72857143
2024-07-26,1.198,1.291,1.19,1.28,22628743.4,86920.0,12110272.2,1.2306666666666664,1.3288571428571427,1.2950000000000002,1.2606265450895309,1.2978245607576908,1.3296189205480817,55.38461538461538,1.5511118176849403,1.03888818231506,-0.03472347213402549,-0.035095403300568616,0.00037193116654312547,0.10099999999999998,0.12207142857142854,8697226749.289988,-0.1499999999999999,7.653490328006729,-65.8711217183771,34.12887828162291,26.760908145156364,6.844741235392327,1.213,1.222,1.15,1.198,29166912.5,111091.0,14314099.5,-1.2366034624897053,53.16770186335403,1.5502009814162534,1.0346990185837468,-0.03395402218812671,-0.0351883860922044,0.00123436390407769,0.07200000000000006,0.12135714285714284,8674598005.889988,-0.2230000000000001,4.446381865736693,-78.68131868131869,21.31868131868131,29.230769230769244,1.2339999999999998,1.2412530901790617,1.3562857142857143,1.3037660810102545,1.29245,1.3348419648163008,341194.0,14757379.066666668,853796.0,13799490.700000001
2024-07-27,1.279,1.348,1.242,1.275,27169842.4,95851.0,13401758.9,1.2509999999999997,1.3024285714285715,1.303,1.2678132725447653,1.292118420568268,1.3244171185911215,56.65859564164647,1.5450474072747125,1.0609525927252874,-0.035329468847945966,-0.035142216410044086,-0.0001872524379018803,0.1060000000000001,0.12385714285714282,8670056906.889988,-0.17800000000000016,9.4420600858369,-69.21182266009853,30.788177339901466,28.745245646735242,-0.3127443315089917,1.198,1.291,1.19,1.28,22628743.4,86920.0,12110272.2,6.844741235392327,55.38461538461538,1.5511118176849403,1.03888818231506,-0.03472347213402549,-0.035095403300568616,0.00037193116654312547,0.10099999999999998,0.12207142857142854,8697226749.289988,-0.1499999999999999,7.653490328006729,-65.8711217183771,34.12887828162291,26.760908145156364,1.2306666666666664,1.2606265450895309,1.3288571428571427,1.2978245607576908,1.2950000000000002,1.3296189205480817,299918.0,13193060.766666666,779506.0,13204006.842857143
2024-07-28,1.275,1.275,1.227,1.246,11219856.8,44966.0,5105677.4,1.2669999999999997,1.2675714285714286,1.3074,1.2569066362723826,1.280588815426201,1.3169488215824434,49.93531694695989,1.5414152041843932,1.0733847958156066,-0.03771502788195269,-0.03565677870442581,-0.00205824917752688,0.04799999999999982,0.11978571428571426,8658837050.089989,-0.15799999999999992,-0.0801924619085903,-76.35467980295564,23.64532019704435,29.520791939522923,-2.2745098039215623,1.279,1.348,1.242,1.275,27169842.4,95851.0,13401758.9,-0.3127443315089917,56.65859564164647,1.5450474072747125,1.0609525927252874,-0.035329468847945966,-0.035142216410044086,-0.0001872524379018803,0.1060000000000001,0.12385714285714282,8670056906.889988,-0.17800000000000016,9.4420600858369,-69.21182266009853,30.788177339901466,28.745245646735242,1.2509999999999997,1.2678132725447653,1.3024285714285715,1.292118420568268,1.303,1.3244171185911215,293862.0,13275376.866666665,772692.0,13671360.1
2024-07-29,1.246,1.319,1.212,1.213,24725321.7,94658.0,12165928.8,1.2446666666666664,1.245142857142857,1.30785,1.2349533181361914,1.2636916115696508,1.307048933812687,33.54430379746837,1.5410612437480575,1.0746387562519424,-0.04178673336008365,-0.03688276963555738,-0.00490396372452627,0.10699999999999998,0.11314285714285711,8634111728.389988,-0.2589999999999999,-14.637579169598869,-84.48275862068962,15.51724137931038,23.316912972085415,-2.648475120385226,1.275,1.275,1.227,1.246,11219856.8,44966.0,5105677.4,-2.2745098039215623,49.93531694695989,1.5414152041843932,1.0733847958156066,-0.03771502788195269,-0.03565677870442581,-0.00205824917752688,0.04799999999999982,0.11978571428571426,8658837050.089989,-0.15799999999999992,-0.0801924619085903,-76.35467980295564,23.64532019704435,29.520791939522923,1.2669999999999997,1.2569066362723826,1.2675714285714286,1.280588815426201,1.3074,1.3169488215824434,227737.0,10205902.833333334,680223.0,12294603.442857144
2024-07-30,1.214,1.248,1.163,1.19,16260564.4,68906.0,7805470.3,1.2163333333333333,1.2308571428571429,1.3077,1.2124766590680958,1.245268708677238,1.2959014163067166,31.424148606811173,1.5412259255301786,1.0741740744698216,-0.04633537174482916,-0.03877329005741174,-0.00756208168741742,0.08499999999999996,0.10664285714285711,8617851163.989988,-0.27,-16.78321678321678,-90.14778325123152,9.852216748768479,16.338259441707752,-1.9769357495881403,1.246,1.319,1.212,1.213,24725321.7,94658.0,12165928.8,-2.648475120385226,33.54430379746837,1.5410612437480575,1.0746387562519424,-0.04178673336008365,-0.03688276963555738,-0.00490396372452627,0.10699999999999998,0.11314285714285711,8634111728.389988,-0.2589999999999999,-14.637579169598869,-84.48275862068962,15.51724137931038,23.316912972085415,1.2446666666666664,1.2349533181361914,1.245142857142857,1.2636916115696508,1.30785,1.307048933812687,235475.0,10224455.033333333,663589.0,12436539.214285715
2024-07-31,1.191,1.211,1.139,1.155,19729468.2,78872.0,9498715.3,1.1859999999999997,1.2224285714285712,1.3081,1.183738329534048,1.2227015315079286,1.282482233801315,27.35562310030396,1.5404915932893628,1.0757084067106373,-0.0521631041346462,-0.04145125287285863,-0.010711851261787572,0.07200000000000006,0.10185714285714284,8598121695.789988,-0.33499999999999996,-20.50929112181693,-95.67567567567568,4.324324324324329,9.89792748413441,-3.0226700251889196,1.214,1.248,1.163,1.19,16260564.4,68906.0,7805470.3,-1.9769357495881403,31.424148606811173,1.5412259255301786,1.0741740744698216,-0.04633537174482916,-0.03877329005741174,-0.00756208168741742,0.08499999999999996,0.10664285714285711,8617851163.989988,-0.27,-16.78321678321678,-90.14778325123152,9.852216748768479,16.338259441707752,1.2163333333333333,1.2124766590680958,1.2308571428571429,1.245268708677238,1.3077,1.2959014163067166,208530.0,8359025.5,604299.0,11151145.385714287
2024-08-01,1.155,1.16,1.068,1.143,26720861.7,110684.0,12594864.3,1.1626666666666665,1.2145714285714286,1.3058,1.163369164767024,1.2027761486309465,1.269198211534523,28.985507246376827,1.543992845356314,1.067607154643686,-0.05709180496274047,-0.044579363290835,-0.012512441671905468,0.09199999999999986,0.09907142857142857,8571400834.089988,-0.2270000000000001,-18.58974358974358,-82.99319727891157,17.006802721088434,10.394447931393762,-1.0389610389610398,1.191,1.211,1.139,1.155,19729468.2,78872.0,9498715.3,-3.0226700251889196,27.35562310030396,1.5404915932893628,1.0757084067106373,-0.0521631041346462,-0.04145125287285863,-0.010711851261787572,0.07200000000000006,0.10185714285714284,8598121695.789988,-0.33499999999999996,-20.50929112181693,-95.67567567567568,4.324324324324329,9.89792748413441,1.1859999999999997,1.183738329534048,1.2224285714285712,1.2227015315079286,1.3081,1.282482233801315,242436.0,9823371.466666667,581264.0,10628846.057142857
2024-08-02,1.143,1.154,1.057,1.068,28781876.5,123636.0,13406626.8,1.1219999999999999,1.1842857142857142,1.30095,1.115684582383512,1.1690821114732097,1.2500364771026637,17.834394904458605,1.5546588882952062,1.047241111704794,-0.06628560982848097,-0.048920612598364194,-0.01736499723011678,0.09699999999999998,0.0965,8542618957.589988,-0.22199999999999998,-27.44565217391304,-97.5663716814159,2.433628318584098,7.921585121332302,-6.5616797900262425,1.155,1.16,1.068,1.143,26720861.7,110684.0,12594864.3,-1.0389610389610398,28.985507246376827,1.543992845356314,1.067607154643686,-0.05709180496274047,-0.044579363290835,-0.012512441671905468,0.09199999999999986,0.09907142857142857,8571400834.089988,-0.2270000000000001,-18.58974358974358,-82.99319727891157,17.006802721088434,10.394447931393762,1.1626666666666665,1.163369164767024,1.2145714285714286,1.2027761486309465,1.3058,1.269198211534523,258462.0,9966349.966666667,580857.0,10383241.028571429
2024-08-03,1.067,1.087,0.968,0.991,29138088.5,105160.0,13330496.6,1.0673333333333332,1.1437142857142857,1.2881500000000001,1.053342291191756,1.1245615836049072,1.2253663364262197,16.16161616161618,1.5767511817461117,0.9995488182538884,-0.07887579187624372,-0.0549116484539401,-0.023964143422303616,0.119,0.09914285714285713,8513480869.089988,-0.22299999999999998,-32.12328767123288,-95.66854990583803,4.331450094161961,7.923960377944844,-7.122774133083408,1.143,1.154,1.057,1.068,28781876.5,123636.0,13406626.8,-6.5616797900262425,17.834394904458605,1.5546588882952062,1.047241111704794,-0.06628560982848097,-0.048920612598364194,-0.01736499723011678,0.09699999999999998,0.0965,8542618957.589988,-0.22199999999999998,-27.44565217391304,-97.5663716814159,2.433628318584098,7.921585121332302,1.1219999999999999,1.115684582383512,1.1842857142857142,1.1690821114732097,1.30095,1.2500364771026637,313192.0,11833402.133333335,617573.0,10568434.542857144
2024-08-04,0.991,1.018,0.874,0.925,45456525.6,111733.0,22147066.5,0.9946666666666665,1.0978571428571429,1.26335,0.989171145595878,1.0746711877036803,1.1967600186713416,11.248285322359408,1.5869997619666063,0.9397002380333936,-0.09310598246208346,-0.06255051525556878,-0.030555467206514683,0.14400000000000002,0.10078571428571428,8468024343.489987,-0.2729999999999999,-37.91946308724832,-91.84,8.160000000000005,4.975026137582035,-6.6599394550958575,1.067,1.087,0.968,0.991,29138088.5,105160.0,13330496.6,-7.122774133083408,16.16161616161618,1.5767511817461117,0.9995488182538884,-0.07887579187624372,-0.0549116484539401,-0.023964143422303616,0.119,0.09914285714285713,8513480869.089988,-0.22299999999999998,-32.12328767123288,-95.66854990583803,4.331450094161961,7.923960377944844,1.0673333333333332,1.053342291191756,1.1437142857142857,1.1245615836049072,1.2881500000000001,1.2253663364262197,339480.0,13110662.566666668,626882.0,10558254.214285715
2024-08-05,0.925,0.934,0.702,0.79,167792992.9,406936.0,84920397.7,0.9019999999999998,1.0374285714285714,1.23135,0.889585572797939,1.0035033907777602,1.158020969274071,11.02150537634408,1.6078621232408803,0.8548378767591196,-0.11396318611238998,-0.07283304942693303,-0.04113013668545695,0.2320000000000001,0.10778571428571428,8300231350.589988,-0.49,-42.33576642335767,-87.39255014326646,12.607449856733535,8.366299983631848,-14.594594594594595,0.991,1.018,0.874,0.925,45456525.6,111733.0,22147066.5,-6.6599394550958575,11.248285322359408,1.5869997619666063,0.9397002380333936,-0.09310598246208346,-0.06255051525556878,-0.030555467206514683,0.14400000000000002,0.10078571428571428,8468024343.489987,-0.2729999999999999,-37.91946308724832,-91.84,8.160000000000005,4.975026137582035,0.9946666666666665,0.989171145595878,1.0978571428571429,1.0746711877036803,1.26335,1.1967600186713416,340529.0,16294729.966666669,693649.0,12992738.371428574
2024-08-06,0.79,0.9,0.788,0.848,61475425.2,209760.0,31075994.2,0.8543333333333333,0.9885714285714285,1.2010999999999998,0.8687927863989695,0.9646275430833201,1.1284951626765405,19.390581717451525,1.5992255554403954,0.8029744445596043,-0.12437879368898486,-0.0831421982793434,-0.04123659540964146,0.11199999999999999,0.10671428571428572,8361706775.789988,-0.42699999999999994,-34.26356589147287,-77.39938080495357,22.600619195046438,14.456023017260009,7.341772151898726,0.925,0.934,0.702,0.79,167792992.9,406936.0,84920397.7,-14.594594594594595,11.02150537634408,1.6078621232408803,0.8548378767591196,-0.11396318611238998,-0.07283304942693303,-0.04113013668545695,0.2320000000000001,0.10778571428571428,8300231350.589988,-0.49,-42.33576642335767,-87.39255014326646,12.607449856733535,8.366299983631848,0.9019999999999998,0.889585572797939,1.0374285714285714,1.0035033907777602,1.23135,1.158020969274071,623829.0,40132653.6,1005927.0,23386233.92857143
2024-08-07,0.847,0.926,0.794,0.805,52234597.8,191766.0,25497595.0,0.8143333333333332,0.9385714285714286,1.17115,0.8368963931994848,0.9247206573124901,1.097686099564489,20.319303338171267,1.5943410231860415,0.7479589768139583,-0.1345519472753316,-0.09342414807854105,-0.04112779919679055,0.132,0.10850000000000001,8309472177.989987,-0.44099999999999995,-33.69028006589785,-84.05572755417955,15.944272445820445,17.050780499200155,-4.958677685950405,0.79,0.9,0.788,0.848,61475425.2,209760.0,31075994.2,7.341772151898726,19.390581717451525,1.5992255554403954,0.8029744445596043,-0.12437879368898486,-0.0831421982793434,-0.04123659540964146,0.11199999999999999,0.10671428571428572,8361706775.789988,-0.42699999999999994,-34.26356589147287,-77.39938080495357,22.600619195046438,14.456023017260009,0.8543333333333333,0.8687927863989695,0.9885714285714285,0.9646275430833201,1.2010999999999998,1.1284951626765405,728429.0,46047819.46666667,1146781.0,26710594.485714287
2024-08-08,0.806,0.893,0.784,0.887,65136552.3,175510.0,35253590.4,0.8466666666666666,0.902,1.1419000000000001,0.8619481965997424,0.9152904929843676,1.0776207567488234,29.403973509933778,1.55835112179233,0.7254488782076702,-0.1344477006859981,-0.10162885860003246,-0.03281884208596564,0.10899999999999999,0.11114285714285714,8374608730.289988,-0.32600000000000007,-25.959933222036724,-71.36222910216719,28.63777089783282,22.39422084623325,10.049627791563271,0.847,0.926,0.794,0.805,52234597.8,191766.0,25497595.0,-4.958677685950405,20.319303338171267,1.5943410231860415,0.7479589768139583,-0.1345519472753316,-0.09342414807854105,-0.04112779919679055,0.132,0.10850000000000001,8309472177.989987,-0.44099999999999995,-33.69028006589785,-84.05572755417955,15.944272445820445,17.050780499200155,0.8143333333333332,0.8368963931994848,0.9385714285714286,0.9247206573124901,1.17115,1.097686099564489,808462.0,47164662.300000004,1259675.0,28996148.728571426
2024-08-09,0.888,0.898,0.83,0.852,41880099.6,122028.0,19321908.7,0.8479999999999999,0.8711428571428571,1.1115,0.8569740982998713,0.8994678697382756,1.0561330656298877,19.774011299435017,1.5188459670134087,0.7041540329865911,-0.13562588127058295,-0.10842826313414256,-0.027197618136440393,0.06800000000000006,0.10878571428571429,8332728630.689987,-0.33799999999999997,-33.4375,-76.78018575851394,23.219814241486066,22.60061919504646,-4.054054054054058,0.806,0.893,0.784,0.887,65136552.3,175510.0,35253590.4,10.049627791563271,29.403973509933778,1.55835112179233,0.7254488782076702,-0.1344477006859981,-0.10162885860003246,-0.03281884208596564,0.10899999999999999,0.11114285714285714,8374608730.289988,-0.32600000000000007,-25.959933222036724,-71.36222910216719,28.63777089783282,22.39422084623325,0.8466666666666666,0.8619481965997424,0.902,0.9152904929843676,1.1419000000000001,1.0776207567488234,577036.0,30609059.86666667,1324501.0,32233109.599999998
2024-08-10,0.851,0.919,0.833,0.899,30232996.1,78794.0,16094985.4,0.8793333333333332,0.858,1.08195,0.8779870491499356,0.8993509023037067,1.0411680117603745,24.933333333333337,1.458248020191421,0.705651979808579,-0.1312540753893251,-0.11299342558517907,-0.01826064980414603,0.08600000000000008,0.10735714285714283,8362961626.789988,-0.256,-29.490196078431364,-68.07131280388978,31.92868719611022,27.92875744514305,5.6404230317273845,0.888,0.898,0.83,0.852,41880099.6,122028.0,19321908.7,-4.054054054054058,19.774011299435017,1.5188459670134087,0.7041540329865911,-0.13562588127058295,-0.10842826313414256,-0.027197618136440393,0.06800000000000006,0.10878571428571429,8332728630.689987,-0.33799999999999997,-33.4375,-76.78018575851394,23.219814241486066,22.60061919504646,0.8479999999999999,0.8569740982998713,0.8711428571428571,0.8994678697382756,1.1115,1.0561330656298877,489304.0,26691031.36666667,1322893.0,33078149.87142857
2024-08-11,0.898,0.947,0.812,0.815,47589736.4,125478.0,22105912.8,0.8553333333333332,0.8422857142857144,1.0542000000000002,0.8464935245749678,0.8782631767277801,1.0196282011165294,23.229813664596264,1.4228359493563767,0.6855640506436238,-0.13303395311324762,-0.11700153109079278,-0.016032422022454834,0.1349999999999999,0.11357142857142857,8315371890.389988,-0.32800000000000007,-34.59069020866774,-81.68557536466776,18.31442463533225,24.487642024309526,-9.242761692650342,0.851,0.919,0.833,0.899,30232996.1,78794.0,16094985.4,5.6404230317273845,24.933333333333337,1.458248020191421,0.705651979808579,-0.1312540753893251,-0.11299342558517907,-0.01826064980414603,0.08600000000000008,0.10735714285714283,8362961626.789988,-0.256,-29.490196078431364,-68.07131280388978,31.92868719611022,27.92875744514305,0.8793333333333332,0.8779870491499356,0.858,0.8993509023037067,1.08195,1.0411680117603745,376332.0,23556828.166666668,1296527.0,33473076.842857145
2024-08-12,0.816,0.897,0.8,0.863,51847708.1,137217.0,25134153.8,0.8589999999999999,0.8527142857142858,1.03285,0.8547467622874839,0.8744473825458351,1.0047112295816218,28.65853658536585,1.393355069677445,0.672344930322555,-0.12908332793269417,-0.11941789045917306,-0.00966543747352111,0.09699999999999998,0.11285714285714286,8367219598.489988,-0.20500000000000007,-28.854080791426217,-70.51282051282051,29.487179487179493,26.576763772874003,5.759803921568633,0.898,0.947,0.812,0.815,47589736.4,125478.0,22105912.8,-9.242761692650342,23.229813664596264,1.4228359493563767,0.6855640506436238,-0.13303395311324762,-0.11700153109079278,-0.016032422022454834,0.1349999999999999,0.11357142857142857,8315371890.389988,-0.32800000000000007,-34.59069020866774,-81.68557536466776,18.31442463533225,24.487642024309526,0.8553333333333332,0.8464935245749678,0.8422857142857144,0.8782631767277801,1.0542000000000002,1.0196282011165294,326300.0,19174268.966666672,1310272.0,33467197.74285714
2024-08-13,0.863,0.889,0.826,0.878,29489444.1,97312.0,15093064.7,0.8519999999999999,0.8570000000000001,1.0160500000000001,0.866373381143742,0.8753355369093764,0.9926434934309911,30.78817733990148,1.3723015226190651,0.659798477380935,-0.12332049250140364,-0.12019841086761918,-0.003122081633784468,0.06300000000000006,0.11128571428571431,8396709042.589989,-0.11299999999999999,-26.21848739495798,-65.42239685658153,34.577603143418465,27.45973575531009,1.7381228273464673,0.816,0.897,0.8,0.863,51847708.1,137217.0,25134153.8,5.759803921568633,28.65853658536585,1.393355069677445,0.672344930322555,-0.12908332793269417,-0.11941789045917306,-0.00966543747352111,0.09699999999999998,0.11285714285714286,8367219598.489988,-0.20500000000000007,-28.854080791426217,-70.51282051282051,29.487179487179493,26.576763772874003,0.8589999999999999,0.8547467622874839,0.8527142857142858,0.8744473825458351,1.03285,1.0047112295816218,341489.0,21111684.000000004,1040553.0,24926305.757142853
2024-08-14,0.879,0.924,0.856,0.875,38610840.6,116253.0,19440022.3,0.8719999999999999,0.867,0.9999,0.870686690571871,0.8752516526820323,0.9814393511994682,32.051282051282044,1.3506645184000254,0.6491354815999746,-0.11763940499823988,-0.11968660969374333,0.0020472046955034434,0.06800000000000006,0.11100000000000002,8358098201.989988,-0.050000000000000044,-24.242424242424242,-62.22707423580785,37.77292576419215,33.94590279826338,-0.45506257110352716,0.863,0.889,0.826,0.878,29489444.1,97312.0,15093064.7,1.7381228273464673,30.78817733990148,1.3723015226190651,0.659798477380935,-0.12332049250140364,-0.12019841086761918,-0.003122081633784468,0.06300000000000006,0.11128571428571431,8396709042.589989,-0.11299999999999999,-26.21848739495798,-65.42239685658153,34.577603143418465,27.45973575531009,0.8519999999999999,0.866373381143742,0.8570000000000001,0.8753355369093764,1.0160500000000001,0.9926434934309911,360007.0,20777710.433333337,928105.0,22643030.114285715
2024-08-15,0.875,0.889,0.813,0.828,38901030.2,143566.0,19031757.9,0.8603333333333332,0.8585714285714285,0.9773,0.8493433452859355,0.8634387395115242,0.9668260796566618,30.67484662576686,1.3098493869139172,0.6447506130860827,-0.11559707826501175,-0.11886870340799702,0.0032716251429852627,0.07600000000000007,0.10985714285714288,8319197171.7899885,0.03799999999999992,-27.559055118110244,-72.12389380530973,27.87610619469027,33.408878367433644,-5.371428571428576,0.879,0.924,0.856,0.875,38610840.6,116253.0,19440022.3,-0.45506257110352716,32.051282051282044,1.3506645184000254,0.6491354815999746,-0.11763940499823988,-0.11968660969374333,0.0020472046955034434,0.06800000000000006,0.11100000000000002,8358098201.989988,-0.050000000000000044,-24.242424242424242,-62.22707423580785,37.77292576419215,33.94590279826338,0.8719999999999999,0.870686690571871,0.867,0.8752516526820323,0.9999,0.9814393511994682,350782.0,19889080.26666667,852592.0,21777662.585714284
2024-08-16,0.827,0.876,0.806,0.827,34806832.5,139273.0,16144419.2,0.8433333333333332,0.8549999999999999,0.9549,0.8381716726429678,0.8543290546336431,0.9535093101655512,33.738191632928476,1.262429305407127,0.647370694592873,-0.1127593911861009,-0.1176468409636178,0.0048874497775169,0.06999999999999995,0.10792857142857144,8284390339.2899885,-0.02100000000000002,-22.565543071161052,-67.53246753246754,32.467532467532465,32.70552147547165,0.0,0.875,0.889,0.813,0.828,38901030.2,143566.0,19031757.9,-5.371428571428576,30.67484662576686,1.3098493869139172,0.6447506130860827,-0.11559707826501175,-0.11886870340799702,0.0032716251429852627,0.07600000000000007,0.10985714285714288,8319197171.7899885,0.03799999999999992,-27.559055118110244,-72.12389380530973,27.87610619469027,33.408878367433644,0.8603333333333332,0.8493433452859355,0.8585714285714285,0.8634387395115242,0.9773,0.9668260796566618,357131.0,17854948.30000001,820648.0,19460257.942857143
2024-08-17,0.827,0.853,0.817,0.84,16037535.3,59853.0,8236154.3,0.8316666666666664,0.8465714285714286,0.9346,0.8390858363214839,0.8507467909752322,0.9426988996735939,38.84785819793205,1.213488319470036,0.6557116805299638,-0.10821408773469077,-0.1157602903178324,0.007546202583141634,0.03600000000000003,0.10200000000000002,8300427874.589989,0.03499999999999992,-15.23713420787084,-56.32911392405063,43.67088607594936,34.671508246057385,1.571946795646918,0.827,0.876,0.806,0.827,34806832.5,139273.0,16144419.2,0.0,33.738191632928476,1.262429305407127,0.647370694592873,-0.1127593911861009,-0.1176468409636178,0.0048874497775169,0.06999999999999995,0.10792857142857144,8284390339.2899885,-0.02100000000000002,-22.565543071161052,-67.53246753246754,32.467532467532465,32.70552147547165,0.8433333333333332,0.8381716726429678,0.8549999999999999,0.8543290546336431,0.9549,0.9535093101655512,399092.0,18205399.800000004,837893.0,19006330.87142857
2024-08-18,0.84,0.849,0.815,0.816,21267010.6,71071.0,9958388.5,0.8276666666666666,0.8467142857142858,0.9147500000000001,0.8275429181607419,0.8420600932314242,0.9306323377999183,41.41732283464566,1.1652769183981706,0.6642230816018295,-0.10533427348945834,-0.1136750869521576,0.008340813462699256,0.03400000000000003,0.09414285714285717,8279160863.989988,-0.07100000000000006,-11.783783783783797,-53.46938775510205,46.53061224489796,40.889676929459945,-2.85714285714286,0.827,0.853,0.817,0.84,16037535.3,59853.0,8236154.3,1.571946795646918,38.84785819793205,1.213488319470036,0.6557116805299638,-0.10821408773469077,-0.1157602903178324,0.007546202583141634,0.03600000000000003,0.10200000000000002,8300427874.589989,0.03499999999999992,-15.23713420787084,-56.32911392405063,43.67088607594936,34.671508246057385,0.8316666666666664,0.8390858363214839,0.8465714285714286,0.8507467909752322,0.9346,0.9426988996735939,342692.0,14470777.133333335,818952.0,17883640.714285713
2024-08-19,0.817,0.926,0.804,0.914,49194354.4,168038.0,25696957.9,0.8566666666666665,0.854,0.9009499999999999,0.870771459080371,0.8600450699235681,0.9290483056284975,60.36789297658863,1.1154540546788385,0.6864459453211613,-0.09405995436866998,-0.10975206043546008,0.0156921060667901,0.122,0.0862857142857143,8328355218.389988,0.062000000000000055,15.696202531645564,-20.245398773006094,79.7546012269939,56.65203318261376,11.872705018359865,0.84,0.849,0.815,0.816,21267010.6,71071.0,9958388.5,-2.85714285714286,41.41732283464566,1.1652769183981706,0.6642230816018295,-0.10533427348945834,-0.1136750869521576,0.008340813462699256,0.03400000000000003,0.09414285714285717,8279160863.989988,-0.07100000000000006,-11.783783783783797,-53.46938775510205,46.53061224489796,40.889676929459945,0.8276666666666666,0.8275429181607419,0.8467142857142858,0.8420600932314242,0.9147500000000001,0.9306323377999183,270197.0,11446320.666666672,764545.0,16148280.099999998
2024-08-20,0.914,0.927,0.863,0.872,46866745.8,154496.0,22994124.1,0.8673333333333332,0.8531428571428571,0.8868,0.8713857295401854,0.863033802442676,0.9236151336638787,52.06185567010309,1.0650069760580854,0.7085930239419146,-0.08750531740088807,-0.10530271182854568,0.017797394427657612,0.06400000000000006,0.08285714285714287,8281488472.589988,-0.027000000000000024,2.8301886792452935,-46.0122699386503,53.9877300613497,60.0909811777472,-4.595185995623637,0.817,0.926,0.804,0.914,49194354.4,168038.0,25696957.9,11.872705018359865,60.36789297658863,1.1154540546788385,0.6864459453211613,-0.09405995436866998,-0.10975206043546008,0.0156921060667901,0.122,0.0862857142857143,8328355218.389988,0.062000000000000055,15.696202531645564,-20.245398773006094,79.7546012269939,56.65203318261376,0.8566666666666665,0.870771459080371,0.854,0.8600450699235681,0.9009499999999999,0.9290483056284975,298962.0,14630500.23333334,795366.0,16228680.685714286
2024-08-21,0.871,0.977,0.862,0.961,46593699.6,194225.0,24388152.5,0.9156666666666665,0.8654285714285714,0.8777000000000001,0.9161928647700928,0.887525351832007,0.9271755971244617,62.42038216560508,1.0146288712779412,0.740771128722059,-0.07427299137312848,-0.09909676773746225,0.024823776364333763,0.11499999999999999,0.08164285714285716,8328082172.189988,0.14600000000000002,19.37888198757762,-8.290155440414518,91.70984455958549,75.15072528264305,10.33295063145809,0.914,0.927,0.863,0.872,46866745.8,154496.0,22994124.1,-4.595185995623637,52.06185567010309,1.0650069760580854,0.7085930239419146,-0.08750531740088807,-0.10530271182854568,0.017797394427657612,0.06400000000000006,0.08285714285714287,8281488472.589988,-0.027000000000000024,2.8301886792452935,-46.0122699386503,53.9877300613497,60.0909811777472,0.8673333333333332,0.8713857295401854,0.8531428571428571,0.863033802442676,0.8868,0.9236151336638787,393605.0,19549823.500000004,852550.0,17357403.457142856
2024-08-22,0.961,1.05,0.943,1.015,69015224.2,276617.0,34017482.8,0.9493333333333331,0.8921428571428571,0.8750499999999999,0.9655964323850463,0.9193940138740051,0.9355398259697512,60.66666666666665,0.9977880179594275,0.7523119820405723,-0.05875167620752619,-0.09102774943147504,0.03227607322394885,0.1070000000000001,0.08150000000000002,8397097396.389988,0.1519999999999999,14.430665163472355,-14.000000000000057,85.99999999999994,77.23252487364506,5.619146722164406,0.871,0.977,0.862,0.961,46593699.6,194225.0,24388152.5,10.33295063145809,62.42038216560508,1.0146288712779412,0.740771128722059,-0.07427299137312848,-0.09909676773746225,0.024823776364333763,0.11499999999999999,0.08164285714285716,8328082172.189988,0.14600000000000002,19.37888198757762,-8.290155440414518,91.70984455958549,75.15072528264305,0.9156666666666665,0.9161928647700928,0.8654285714285714,0.887525351832007,0.8777000000000001,0.9271755971244617,516759.0,24359744.83333334,930522.0,18064279.2
2024-08-23,1.015,1.22,1.011,1.206,81358951.6,443442.0,41692994.0,1.0606666666666664,0.9462857142857141,0.8858,1.085798216192523,0.9910455104055038,0.9612979377821559,73.4126984126984,1.0723640570109862,0.6992359429890137,-0.030685099639518376,-0.07895921947308371,0.04827411983356533,0.20900000000000007,0.09157142857142861,8478456347.989988,0.32799999999999996,41.549295774647874,-3.3333333333333366,96.66666666666667,91.45883707541738,18.817733990147794,0.961,1.05,0.943,1.015,69015224.2,276617.0,34017482.8,5.619146722164406,60.66666666666665,0.9977880179594275,0.7523119820405723,-0.05875167620752619,-0.09102774943147504,0.03227607322394885,0.1070000000000001,0.08150000000000002,8397097396.389988,0.1519999999999999,14.430665163472355,-14.000000000000057,85.99999999999994,77.23252487364506,0.9493333333333331,0.9655964323850463,0.8921428571428571,0.9193940138740051,0.8750499999999999,0.9355398259697512,625338.0,27133253.133333337,1063573.0,20205097.042857144
2024-08-24,1.207,1.301,1.2,1.265,62265211.9,360841.0,28734984.9,1.162,1.007,0.9027999999999998,1.1753991080962614,1.059534132804128,0.9902219437076649,73.82812499999999,1.154867326010499,0.6507326739895007,-0.00363937612168308,-0.06389525080280359,0.06025587468112051,0.10099999999999998,0.09264285714285715,8540721559.889988,0.3899999999999999,40.71190211345939,-7.185628742514978,92.81437125748502,91.82701264138389,4.805302402651187,1.015,1.22,1.011,1.206,81358951.6,443442.0,41692994.0,18.817733990147794,73.4126984126984,1.0723640570109862,0.6992359429890137,-0.030685099639518376,-0.07895921947308371,0.04827411983356533,0.20900000000000007,0.09157142857142861,8478456347.989988,0.32799999999999996,41.549295774647874,-3.3333333333333366,96.66666666666667,91.45883707541738,1.0606666666666664,1.085798216192523,0.9462857142857141,0.9910455104055038,0.8858,0.9612979377821559,914284.0,33366209.76666667,1367742.0,23854893.442857143
2024-08-25,1.265,1.4,1.168,1.363,79083796.1,520734.0,37983015.5,1.2779999999999998,1.085142857142857,0.9314499999999999,1.2691995540481307,1.1354005996030958,1.0257246157355062,85.03836317135548,1.2508075623522288,0.6120924376477711,0.02540943149054331,-0.04603431434413421,0.07144374583467752,0.23199999999999998,0.0995714285714286,8619805355.989988,0.535,67.239263803681,-6.166666666666655,93.83333333333334,94.43812375249503,7.747035573122537,1.207,1.301,1.2,1.265,62265211.9,360841.0,28734984.9,4.805302402651187,73.82812499999999,1.154867326010499,0.6507326739895007,-0.00363937612168308,-0.06389525080280359,0.06025587468112051,0.10099999999999998,0.09264285714285715,8540721559.889988,0.3899999999999999,40.71190211345939,-7.185628742514978,92.81437125748502,91.82701264138389,1.162,1.1753991080962614,1.007,1.059534132804128,0.9027999999999998,0.9902219437076649,1080900.0,34815153.900000006,1668730.0,26783297.814285714
2024-08-26,1.364,1.391,1.292,1.334,66383317.3,554770.0,32236022.1,1.3206666666666667,1.1451428571428572,0.9557500000000001,1.3015997770240655,1.185050449702322,1.0550841761416485,80.86500655307995,1.3192770930321434,0.592222906967857,0.04556551230934702,-0.027714349013437962,0.07327986132278498,0.09899999999999998,0.09971428571428574,8553422038.689988,0.5070000000000001,54.57705677867904,-11.07382550335568,88.92617449664432,91.85795969582091,-2.1994134897360724,1.265,1.4,1.168,1.363,79083796.1,520734.0,37983015.5,7.747035573122537,85.03836317135548,1.2508075623522288,0.6120924376477711,0.02540943149054331,-0.04603431434413421,0.07144374583467752,0.23199999999999998,0.0995714285714286,8619805355.989988,0.535,67.239263803681,-6.166666666666655,93.83333333333334,94.43812375249503,1.2779999999999998,1.2691995540481307,1.085142857142857,1.1354005996030958,0.9314499999999999,1.0257246157355062,1325017.0,36136998.13333333,2118393.0,30786815.957142856
2024-08-27,1.335,1.477,1.246,1.287,115407398.6,775239.0,54885473.3,1.328,1.2044285714285714,0.9798500000000001,1.2942998885120327,1.2105378372767415,1.0771713974614916,75.72327044025155,1.3645868341853007,0.5951131658146995,0.0570887606738304,-0.01075372707598429,0.06784248774981469,0.2310000000000001,0.11171428571428574,8438014640.089988,0.44699999999999995,46.58314350797266,-28.23179791976228,71.76820208023771,84.8425699700718,-3.595505617977531,1.364,1.391,1.292,1.334,66383317.3,554770.0,32236022.1,-2.1994134897360724,80.86500655307995,1.3192770930321434,0.592222906967857,0.04556551230934702,-0.027714349013437962,0.07327986132278498,0.09899999999999998,0.09971428571428574,8553422038.689988,0.5070000000000001,54.57705677867904,-11.07382550335568,88.92617449664432,91.85795969582091,1.3206666666666667,1.3015997770240655,1.1451428571428572,1.185050449702322,0.9557500000000001,1.0550841761416485,1436345.0,32984674.16666667,2505125.0,31720967.985714287
